يَد	اليَدِ	N;NHUM;GEN;DEF;FEM;SG
مُساهِم	المُساهِمِينَ	N;HUM;GEN;DEF;MASC;PL
عَرَبِيّ	العَرَبِ	N;HUM;GEN;DEF;MASC;PL
سُلْطَة	السُّلُطاتُ	N;NHUM;NOM;DEF;FEM;PL
سَماوِيّ	السَّماوِيَّةِ	ADJ;GEN;DEF;FEM;SG
فَرَنْسِيّ	فَرَنْسِيَّةً	ADJ;ACC;INDF;FEM;SG
لِيبِرالِيّ	اللِّيبِرالِيُّ	ADJ;NOM;DEF;MASC;SG
أَفْضَل	أَفْضَلَ	ADJ;ACC;CMPR;FEM;SG;PSSD
جانِب	جانِبِ	N;NHUM;GEN;MASC;SG;PSSD
مَرْكَزِيّ	المَرْكَزِيِّ	ADJ;GEN;DEF;MASC;SG
أَهَمِّيَّة	الأَهَمِّيَّةِ	N;NHUM;GEN;DEF;FEM;SG
ساكِن	سُكّانُ	N;HUM;NOM;MASC;PL;PSSD
وَجَب	يَجِبُ	V;IPFV;MASC;IND;SG;3;ACT
تِلْمِيذ	تَلامِذَةِ	N;HUM;GEN;MASC;PL;PSSD
لُبْنانِيّ	اللُّبْنانِيَّةِ	ADJ;GEN;DEF;FEM;SG
مُنْتَشِر	مُنْتَشِراً	ADJ;ACC;INDF;MASC;SG
عَمَلِيَّة	عَمَلِيّاتِ	N;NHUM;GEN;FEM;PL;PSSD
ٱِسْتَمَرّ	اِسْتَمَرَّ	V;PFV;MASC;IND;SG;3;ACT
مُقاوَمَة	مُقاوَمَةِ	N;NHUM;GEN;FEM;SG;PSSD
سائِر	سائِرِ	ADJ;GEN;MASC;SG;PSSD
حال	حالٌ	N;NHUM;NOM;INDF;MASC;SG
بُحَيْرَة	بُحَيْرَةُ	N;NHUM;NOM;FEM;SG;PSSD
عُضْوِيّ	عُضْوِيَّةٍ	ADJ;GEN;INDF;FEM;SG
أَصْل	أَصْلاً	N;NHUM;ACC;INDF;MASC;SG
يَوْم	يَوْمَ	N;NHUM;ACC;MASC;SG;PSSD
تَوَجَّه	تَتَوَجَّهُ	V;IPFV;FEM;IND;SG;3;ACT
مُوجَب	المُوجَبَةِ	ADJ;GEN;DEF;FEM;SG
أَتاح	أَتاحَ	V;PFV;MASC;IND;SG;3;ACT
تَوافَر	تَوافَرَت	V;PFV;FEM;IND;SG;3;ACT
أَحَد	أَحَدَ	N;NHUM;ACC;MASC;SG;PSSD
داعِي	داعِياً	ADJ;ACC;INDF;MASC;SG
قِمَّة	قِمَّةَ	N;NHUM;ACC;FEM;SG;PSSD
إِسْلامِيّ	إِسْلامِيَّةٌ	ADJ;NOM;INDF;FEM;SG
صَمِيم	الصَّمِيمِ	N;NHUM;GEN;DEF;MASC;SG
أَحَد	أَحَدٍ	N;NHUM;GEN;INDF;MASC;SG
جِهَة	الجِهاتُ	N;NHUM;NOM;DEF;FEM;PL
حِفاظ	الحِفاظِ	N;NHUM;GEN;DEF;MASC;SG
ذَهَب	ذَهَبْنا	V;PFV;IND;PL;1;ACT
مُنْحَلّ	المُنْحَلِّ	ADJ;GEN;DEF;MASC;SG
مَخْلُوق	مَخْلُوقٌ	N;NHUM;NOM;INDF;MASC;SG
كُلِّيّ	الكُلِّيَّةِ	N;NHUM;GEN;DEF;FEM;SG
خَبِير	خُبَراءِ	N;HUM;GEN;MASC;PL;PSSD
حُكْم	الحُكْمِ	N;NHUM;GEN;DEF;MASC;SG
إِسْرائِيلِيّ	الإِسْرائِيلِيِّينَ	ADJ;GEN;DEF;MASC;PL
دُكْتُور	الدُّكْتُورُ	N;HUM;NOM;DEF;MASC;SG
قَضِيَّة	قَضِيَّةِ	N;NHUM;GEN;FEM;SG;PSSD
صَرْف	صَرْفٍ	N;NHUM;GEN;INDF;MASC;SG
ٱِجْتَمَع	اِجْتَمَعَ	V;PFV;MASC;IND;SG;3;ACT
تَقَدُّمِيّ	التَّقَدُّمِيِّ	ADJ;GEN;DEF;MASC;SG
بَلَد	بَلَدٍ	N;NHUM;GEN;INDF;MASC;SG
مُسْتَشْفَى	المُسْتَشْفَى	N;NHUM;DEF;MASC;SG
كامِل	الكامِلَ	ADJ;ACC;DEF;MASC;SG
مُناقَشَة	مُناقَشَةِ	N;NHUM;GEN;FEM;SG;PSSD
كَمَن	يَكْمُنُ	V;IPFV;MASC;IND;SG;3;ACT
تَعْبِير	التَّعابِيرُ	N;NHUM;NOM;DEF;MASC;PL
مُنَظَّمَة	المُنَظَّمَةُ	N;NHUM;NOM;DEF;FEM;SG
مُتَوَقَّع	المُتَوَقَّعِ	N;NHUM;GEN;DEF;MASC;SG
مَفْرُوض	المَفْرُوضَةِ	ADJ;GEN;DEF;FEM;SG
مُحْتَرِص	المُحْتَرِصِينَ	N;NHUM;ACC;DEF;MASC;PL
آلِيَّة	الآلِيّاتِ	N;NHUM;GEN;DEF;FEM;PL
مُتَكافِئ	مُتَكافِئَةٍ	ADJ;GEN;INDF;FEM;SG
مَعْرُوف	مَعْرُوفٌ	ADJ;NOM;INDF;MASC;SG
نِعْمَة	نِعْمَةً	N;NHUM;ACC;INDF;FEM;SG
رابِع	الرّابِعَةِ	ADJ;GEN;DEF;FEM;SG
بِضْع	بِضْعَ	N;ACC;FEM;SG;PSSD
تَغْيِير	التَّغْيِيرِ	N;NHUM;GEN;DEF;MASC;SG
مَرَّة	مَرّاتٍ	N;NHUM;ACC;INDF;FEM;PL
ٱِجْتِماع	الاِجْتِماعِ	N;NHUM;GEN;DEF;MASC;SG
مَفْتُوح	المَفْتُوحَةَ	ADJ;ACC;DEF;FEM;SG
فارِق	الفارِقِ	N;NHUM;GEN;DEF;MASC;SG
قَضِيَّة	قَضِيَّةُ	N;NHUM;NOM;FEM;SG;PSSD
حَقّ	حَقِّ	N;NHUM;GEN;MASC;SG;PSSD
زال	يَزالُ	V;IPFV;MASC;IND;SG;3;ACT
خَطّ	خَطِّ	N;NHUM;GEN;MASC;SG;PSSD
فَرْعِيّ	فَرْعِيَّةٍ	ADJ;GEN;INDF;FEM;SG
أَب	أَب	N;HUM;INDF;MASC;SG
أَرْبِعاء	الأَرْبِعاءِ	N;NHUM;GEN;DEF;MASC;SG
خَطْوَة	الخَطْوَةَ	N;NHUM;ACC;DEF;FEM;SG
أَوْسَط	الأَوْسَطِ	ADJ;GEN;CMPR;DEF;MASC;SG
ٱِفْتِتاحِيَّة	اِفْتِتاحِيَّةِ	N;NHUM;GEN;FEM;SG;PSSD
أَوْضَح	أَوْضَحَ	V;PFV;MASC;IND;SG;3;ACT
باقِي	الباقِي	ADJ;DEF;MASC;SG
مَرْكَزِيّ	المَرْكَزِيَّةِ	ADJ;GEN;DEF;FEM;SG
إِسْلامِيّ	الإِسْلامِيِّ	ADJ;GEN;DEF;MASC;SG
مُسْبَق	المُسْبَقِ	ADJ;GEN;DEF;MASC;SG
قَبَع	تَقْبَعُ	V;IPFV;FEM;IND;SG;3;ACT
عَدْل	العَدْلِ	N;NHUM;GEN;DEF;MASC;SG
عاهِل	العاهِلِ	N;HUM;GEN;DEF;MASC;SG
عَرَبِيّ	العَرَبِيَّةُ	ADJ;NOM;DEF;FEM;SG
عالَمِيّ	العالَمِيَّةِ	ADJ;GEN;DEF;FEM;SG
مُرَشَّح	المُرَشَّحِينَ	N;HUM;GEN;DEF;MASC;PL
طَيَران	الطَّيَرانِ	N;NHUM;GEN;DEF;MASC;SG
جُزْء	جُزْءٌ	N;NHUM;NOM;INDF;MASC;SG
ناقِلَة	ناقِلَةِ	N;NHUM;GEN;FEM;SG;PSSD
أَمْكَن	يُمْكِنُ	V;IPFV;MASC;IND;SG;3;ACT
تَأْكِيد	تَأْكِيدُ	N;NHUM;NOM;MASC;SG;PSSD
لُبْنانِيّ	اللُّبْنانِيِّ	ADJ;GEN;DEF;MASC;SG
وَزِير	وَزِيرَةُ	N;HUM;NOM;FEM;SG;PSSD
فِلَسْطِينِيّ	فِلَسْطِينِيٍّ	ADJ;GEN;INDF;MASC;SG
تَحْوِير	تَحْوِيرُ	N;NHUM;NOM;MASC;SG;PSSD
مَسْؤُول	المَسْؤُولِينَ	N;HUM;GEN;DEF;MASC;PL
أَزْرَق	الأَزْرَقِ	N;NHUM;GEN;DEF;MASC;SG
عام	عامٌ	N;NHUM;NOM;INDF;MASC;SG
ٱِقْتِحام	اِقْتِحامِ	N;NHUM;GEN;MASC;SG;PSSD
أُرْدُنِّيّ	الأُرْدُنِّيَّةُ	ADJ;NOM;DEF;FEM;SG
تَأْيِيد	التَّأْيِيدِ	N;NHUM;GEN;DEF;MASC;SG
بَلْوَرَة	بَلْوَرَةِ	N;NHUM;GEN;FEM;SG;PSSD
مَحَلِّيّ	مَحَلِّيٌّ	ADJ;NOM;INDF;MASC;SG
أَكْبَر	أَكْبَرِ	ADJ;GEN;CMPR;FEM;SG;PSSD
بَدا	بَدا	V;PFV;MASC;IND;SG;3;ACT
طالَب	طالَبْنا	V;PFV;IND;PL;1;ACT
دَوْلِيّ	الدَّوْلِيِّ	ADJ;GEN;DEF;MASC;SG
طائِفِيّ	الطّائِفِيِّ	ADJ;GEN;DEF;MASC;SG
كُولُونِيل	كُولُونِيلٌ	N;HUM;NOM;INDF;MASC;SG
أَلْقَى	يُلْقِيَ	V;IPFV;MASC;SBJV;SG;3;ACT
تَصَلُّب	تَصَلُّبَ	N;NHUM;ACC;MASC;SG;PSSD
إِعْمار	الإِعْمارِ	N;NHUM;GEN;DEF;MASC;SG
إِمْبِراطُورِيَّة	إِمْبِراطُورِيَّةِ	N;NHUM;GEN;FEM;SG;PSSD
تَشْجِيع	تَشْجِيعِ	N;NHUM;GEN;MASC;SG;PSSD
شَقّ	الشَّقِّ	N;NHUM;GEN;DEF;MASC;SG
غِرار	غِرارِ	N;NHUM;GEN;MASC;SG;PSSD
ٱِسْتَقْبَل	أُسْتُقْبِلَت	V;PFV;FEM;IND;SG;3;PASS
صِناعَة	الصِّناعَةِ	N;NHUM;GEN;DEF;FEM;SG
مَجْمُوعَة	مَجْمُوعَةِ	N;NHUM;GEN;FEM;SG;PSSD
صِدْقِيَّة	صِدْقِيَّةٍ	N;NHUM;GEN;INDF;FEM;SG
نَفْسِيّ	النَّفْسِيَّ	ADJ;ACC;DEF;MASC;SG
بَنْك	البَنْكَ	N;NHUM;ACC;DEF;MASC;SG
فُنْدُق	فُنْدُقِ	N;NHUM;GEN;MASC;SG;PSSD
أَراد	أَرادَت	V;PFV;FEM;IND;SG;3;ACT
بَرِيء	بَرِيئَةً	ADJ;ACC;INDF;FEM;SG
مَلْعَب	مَلاعِبِ	N;NHUM;GEN;MASC;PL;PSSD
تَعاوُن	التَّعاوُنِ	N;NHUM;GEN;DEF;MASC;SG
أَصْل	الأُصُولِ	N;NHUM;GEN;DEF;MASC;PL
مُعَوَّق	المُعَوَّقِينَ	ADJ;GEN;DEF;MASC;PL
صَهْيُونِيّ	الصَّهْيُونِيَّةِ	ADJ;GEN;DEF;FEM;SG
جَزائِيّ	جَزائِيَّةٍ	ADJ;GEN;INDF;FEM;SG
أَوْسَطِيّ	أَوْسَطِيَّةٍ	ADJ;GEN;INDF;FEM;SG
ٱِنْفِجار	اِنْفِجارُ	N;NHUM;NOM;MASC;SG;PSSD
إِنْشاء	إِنْشاءُ	N;NHUM;NOM;MASC;SG;PSSD
أَدَّى	أَدَّى	V;PFV;MASC;IND;SG;3;ACT
بَراءَة	البَراءَةِ	N;NHUM;GEN;DEF;FEM;SG
رَئِيس	الرَّئِيسُ	N;HUM;NOM;DEF;MASC;SG
نارِيّ	النّارِيَّةِ	ADJ;GEN;DEF;FEM;SG
إِعْلامِيّ	إِعْلامِيٌّ	ADJ;NOM;INDF;MASC;SG
هَجْمَة	الهَجَماتِ	N;NHUM;ACC;DEF;FEM;PL
أَتْقَن	أَتْقَنُوا	V;PFV;MASC;IND;PL;3;ACT
ٱِسْتِكْشاف	اِسْتِكْشافِ	N;NHUM;GEN;MASC;SG;PSSD
سِياسِيّ	السِّياسِيَّةُ	ADJ;NOM;DEF;FEM;SG
كُرْدِيّ	كُرْدِيٍّ	ADJ;GEN;INDF;MASC;SG
أَخْفَى	يُخْفِي	V;IPFV;MASC;IND;SG;3;ACT
مَسْؤُول	مَسْؤُولِي	N;HUM;GEN;MASC;PL;PSSD
كَأْس	كَأْسِ	N;NHUM;GEN;MASC;SG;PSSD
بَعْض	بَعْضَ	N;ACC;FEM;SG;PSSD
وَسِيلَة	وَسائِلِ	N;NHUM;GEN;FEM;PL;PSSD
تَقْوِيم	تَقْوِيمِ	N;NHUM;GEN;MASC;SG;PSSD
ٱِنْفَجَر	اِنْفَجَرَت	V;PFV;FEM;IND;SG;3;ACT
أَدَّى	أَدَّت	V;PFV;FEM;IND;SG;3;ACT
وَضْع	وَضْعُ	N;NHUM;NOM;MASC;SG;PSSD
فَرِيق	فَرِيقٍ	N;NHUM;GEN;INDF;MASC;SG
تَصَرُّف	تَصَرُّفِ	N;NHUM;GEN;MASC;SG;PSSD
شَكْل	أَشْكالِ	N;NHUM;GEN;MASC;PL;PSSD
قِطاع	قِطاعِ	N;NHUM;GEN;MASC;SG;PSSD
إِغْلاق	إِغْلاقِ	N;NHUM;GEN;MASC;SG;PSSD
نائِب	نائِبِ	N;HUM;GEN;MASC;SG;PSSD
عِراقِيّ	العِراقِيَّةِ	ADJ;GEN;DEF;FEM;SG
ٱِسْتَعْصَى	تَسْتَعْصِي	V;IPFV;FEM;IND;SG;3;ACT
أَمِير	الأَمِيرُ	N;HUM;NOM;DEF;MASC;SG
مَعْلُوماتِيّ	المَعْلُوماتِيَّةِ	ADJ;GEN;DEF;FEM;SG
سَنّ	تَسُنُّ	V;IPFV;FEM;IND;SG;3;ACT
فَرَنْسِيّ	الفَرَنْسِيَّةِ	ADJ;GEN;DEF;FEM;SG
عام	العامِ	N;NHUM;GEN;DEF;MASC;SG
زال	تَزالُ	V;IPFV;FEM;IND;SG;3;ACT
تَرَك	تَرَكَ	V;PFV;MASC;IND;SG;3;ACT
تَأْهِيل	تَأْهِيلِ	N;NHUM;GEN;MASC;SG;PSSD
شَخْص	أَشْخاصٍ	N;HUM;GEN;INDF;MASC;PL
مِساحَة	المِساحاتِ	N;NHUM;GEN;DEF;FEM;PL
شَرِيك	شُرَكاءِ	N;HUM;GEN;MASC;PL;PSSD
سُورِيّ	سُورِيَّةٌ	ADJ;NOM;INDF;FEM;SG
فِعْل	الفِعْلِ	N;NHUM;GEN;DEF;MASC;SG
كَنِيسَة	الكَنِيسَةُ	N;NHUM;NOM;DEF;FEM;SG
عَقْلِيّ	العَقْلِيَّةِ	ADJ;GEN;DEF;FEM;SG
جَمْعِيَّة	جَمْعِيَّةِ	N;NHUM;GEN;FEM;SG;PSSD
زِيارَة	الزِّيارَةُ	N;NHUM;NOM;DEF;FEM;SG
بَحْث	بَحْثِ	N;NHUM;GEN;MASC;SG;PSSD
نُقْطَة	نُقْطَةِ	N;NHUM;GEN;FEM;SG;PSSD
شَهادَة	شَهادَةٌ	N;NHUM;NOM;INDF;FEM;SG
صِراع	صِراعٍ	N;NHUM;GEN;INDF;MASC;SG
لاح	تَلُوحُ	V;IPFV;FEM;IND;SG;3;ACT
تَعْلِيب	تَعْلِيبَ	N;NHUM;ACC;MASC;SG;PSSD
فَتَح	فَتَحُوا	V;PFV;MASC;IND;PL;3;ACT
تَقْدِير	تَقْدِيرٌ	N;NHUM;NOM;INDF;MASC;SG
قَتْل	قَتْلٍ	N;NHUM;GEN;INDF;MASC;SG
شَأْن	الشَّأْنِ	N;NHUM;GEN;DEF;MASC;SG
ٱِقْتِصاد	اِقْتِصادِ	N;NHUM;GEN;MASC;SG;PSSD
سِلاح	أَسْلِحَةٍ	N;NHUM;GEN;INDF;MASC;PL
حَوْل	حَوْلَ	N;NHUM;ACC;MASC;SG;PSSD
مَصْرَف	المَصارِفُ	N;NHUM;NOM;DEF;MASC;PL
ذَهَب	ذَهَبْتُ	V;PFV;IND;SG;1;ACT
مُناهِض	مُناهِضَةٍ	ADJ;GEN;INDF;FEM;SG
شُرْطَة	الشُّرْطَةُ	N;NHUM;NOM;DEF;FEM;SG
جُهْد	جُهْدٍ	N;NHUM;GEN;INDF;MASC;SG
قَدَم	القَدَمِ	N;NHUM;GEN;DEF;MASC;SG
نَظِير	نَظِيرَيْ	N;HUM;GEN;MASC;DU;PSSD
جارِي	الجارِيَةَ	ADJ;ACC;DEF;FEM;SG
مُقْبِل	المُقْبِلَيْنِ	ADJ;GEN;DEF;MASC;DU
مُعَسْكَر	مُعَسْكَرٍ	N;NHUM;GEN;INDF;MASC;SG
غَرْب	غَرْبِ	N;NHUM;GEN;MASC;SG;PSSD
دَعْوَة	دَعَواتٌ	N;NHUM;NOM;INDF;FEM;PL
مُهِين	مُهِينٍ	ADJ;GEN;INDF;MASC;SG
تَجْدِيد	التَّجْدِيدِ	N;NHUM;GEN;DEF;MASC;SG
ٱِسْتِقْبال	اِسْتِقْبالِ	N;NHUM;GEN;MASC;SG;PSSD
رَجُل	رِجالُ	N;HUM;NOM;MASC;PL;PSSD
حُكْم	الأَحْكامَ	N;NHUM;ACC;DEF;MASC;PL
مُسْتَوَى	مُسْتَوَى	N;NHUM;INDF;MASC;SG
ثُغْرَة	ثُغَراتٍ	N;NHUM;ACC;INDF;FEM;PL
جَمِيل	الجَمِيلَةِ	ADJ;GEN;DEF;FEM;SG
عالَمِيَّة	عالَمِيَّةِ	N;NHUM;GEN;FEM;SG;PSSD
رِبْح	الرِّبْحِ	N;NHUM;GEN;DEF;MASC;SG
ٱِنْفَصَل	يَنْفَصِلُ	V;IPFV;MASC;IND;SG;3;ACT
مِثْل	مِثْلِ	N;NHUM;GEN;MASC;SG;PSSD
أَجْرَى	نُجْرِي	V;IPFV;IND;PL;1;ACT
قانُون	قانُونٍ	N;NHUM;GEN;INDF;MASC;SG
مَجال	مَجالِ	N;NHUM;GEN;MASC;SG;PSSD
نِعْمَة	نِعْمَةٍ	N;NHUM;GEN;INDF;FEM;SG
راهِن	الرّاهِنِ	ADJ;GEN;DEF;MASC;SG
دُولار	دُولارٍ	N;NHUM;GEN;INDF;MASC;SG
بَيْنَ	بَيْنَ	N;NHUM;ACC;MASC;SG;PSSD
خَمِيس	الخَمِيسُ	N;NHUM;NOM;DEF;MASC;SG
إِرْهابِيّ	الإِرْهابِيَّةِ	ADJ;GEN;DEF;FEM;SG
دِينار	دِينارٍ	N;NHUM;GEN;INDF;MASC;SG
تَذْكِير	التَّذْكِيرِ	N;NHUM;GEN;DEF;MASC;SG
فَصِيل	فَصائِلِ	N;NHUM;GEN;MASC;PL;PSSD
مُعْتَبِر	مُعْتَبِراً	ADJ;ACC;INDF;MASC;SG
آخِر	آخِرَ	ADJ;ACC;CMPR;MASC;SG;PSSD
تَأَكَّد	تَتَأَكَّدْ	V;IPFV;FEM;JUS;SG;3;ACT
بِضْع	بِضْعَةُ	N;NOM;FEM;SG;PSSD
زَعامَة	الزَّعامَةِ	N;NHUM;GEN;DEF;FEM;SG
دَعْم	دَعْمِ	N;NHUM;GEN;MASC;SG;PSSD
ضَرْبَة	ضَرْبَةٍ	N;NHUM;GEN;INDF;FEM;SG
مِنْطَقَة	المِنْطَقَةِ	N;NHUM;GEN;DEF;FEM;SG
دَوْرَة	دَوْرَةٍ	N;NHUM;GEN;INDF;FEM;SG
تَرَشَّح	يَتَرَشَّحَ	V;IPFV;MASC;SBJV;SG;3;ACT
ٱِعْتِقال	اِعْتِقالِ	N;NHUM;GEN;MASC;SG;PSSD
هَدَف	هَدَفَيْ	N;NHUM;ACC;MASC;DU;PSSD
سِينَما	السِّينَما	N;NHUM;DEF;FEM;SG
أَدْنَى	أَدْنَى	ADJ;CMPR;INDF;FEM;SG
فَنّ	فُنُونَ	N;NHUM;ACC;MASC;PL;PSSD
أَثار	تُثِيرَ	V;IPFV;FEM;SBJV;SG;3;ACT
دام	يَدُمْ	V;IPFV;MASC;JUS;SG;3;ACT
شَرْعِيّ	شَرْعِيٍّ	ADJ;GEN;INDF;MASC;SG
خاض	خاضَ	V;PFV;MASC;IND;SG;3;ACT
تَكَرَّس	يَتَكَرَّسُ	V;IPFV;MASC;IND;SG;3;ACT
باقِي	باقِي	N;NHUM;GEN;MASC;PL;PSSD
أَحَد	إِحْدَى	N;NHUM;INDF;FEM;SG
مُسْتَوْطَنَة	مُسْتَوْطَناتِ	N;NHUM;GEN;FEM;PL;PSSD
خاف	يَخافُ	V;IPFV;MASC;IND;SG;3;ACT
قادِر	قادِرَةً	ADJ;ACC;INDF;FEM;SG
سَجَّل	سَجَّلْنا	V;PFV;IND;PL;1;ACT
تَشَدُّد	التَّشَدُّدِ	N;NHUM;GEN;DEF;MASC;SG
نُقْطَة	نِقاطٍ	N;NHUM;GEN;INDF;FEM;PL
خَلِيج	الخَلِيجِ	N;NHUM;GEN;DEF;MASC;SG
آخَر	الآخَرِينَ	ADJ;ACC;DEF;MASC;PL
مُشْكِلَة	مَشاكِلَ	N;NHUM;ACC;FEM;PL;PSSD
طائِرَة	الطّائِرَةُ	N;NHUM;NOM;DEF;FEM;SG
إِصْلاح	الإِصْلاحِ	N;NHUM;GEN;DEF;MASC;SG
ٱِنْقِطاع	اِنْقِطاعِ	N;NHUM;GEN;MASC;SG;PSSD
مَصْلَحَة	المَصْلَحَةِ	N;NHUM;GEN;DEF;FEM;SG
شَكَر	نَشْكُرُ	V;IPFV;IND;PL;1;ACT
سُنِّيّ	السُّنِّيَّةِ	ADJ;GEN;DEF;FEM;SG
عَدَم	عَدَمَ	N;NHUM;ACC;MASC;SG;PSSD
جَبَل	جَبَلِ	N;NHUM;GEN;MASC;SG;PSSD
حَقِيبَة	حَقائِبِ	N;NHUM;GEN;FEM;PL;PSSD
طَرِيقَة	طَرِيقَةَ	N;NHUM;ACC;FEM;SG;PSSD
شَكَّل	يُشَكِّلُ	V;IPFV;MASC;IND;SG;3;ACT
ٱِعْتَقَل	اِعْتَقَلَت	V;PFV;FEM;IND;SG;3;ACT
خُطَّة	خُطَّةِ	N;NHUM;GEN;FEM;SG;PSSD
خَلَّف	خَلَّفَ	V;PFV;MASC;IND;SG;3;ACT
جانِب	الجانِبَيْنِ	N;NHUM;GEN;DEF;MASC;DU
كُورِيّ	الكُورِيَّتَيْنِ	N;HUM;GEN;DEF;FEM;DU
آخَر	آخَرِ	ADJ;GEN;MASC;SG;PSSD
خَوْض	خَوْضِ	N;NHUM;GEN;MASC;SG;PSSD
بَرْنامَج	بَرْنامَجِ	N;NHUM;GEN;MASC;SG;PSSD
ماء	المِياهِ	N;NHUM;GEN;DEF;MASC;PL
كافِيِين	الكافِيِينَ	N;NHUM;ACC;DEF;MASC;SG
أَحْيَى	يُحْيِي	V;IPFV;MASC;IND;SG;3;ACT
ٱِعْتِصام	اِعْتِصامٌ	N;NHUM;NOM;INDF;MASC;SG
مَطار	مَطارِ	N;NHUM;GEN;MASC;SG;PSSD
ٱِنْشَقّ	اِنْشَقَّ	V;PFV;MASC;IND;SG;3;ACT
مُوازَنَة	المُوازَنَةَ	N;NHUM;ACC;DEF;FEM;SG
لُغَة	اللُّغَةِ	N;NHUM;GEN;DEF;FEM;SG
صادِر	الصّادِرَةِ	ADJ;GEN;DEF;FEM;SG
مَرَّة	مَرَّةً	N;NHUM;ACC;INDF;FEM;SG
فِلَسْطِينِيّ	فِلَسْطِينِيُّونَ	N;HUM;NOM;INDF;MASC;PL
حَدّ	حُدُودِ	N;NHUM;GEN;MASC;PL;PSSD
بَيان	بَياناً	N;NHUM;ACC;INDF;MASC;SG
إِنْتاج	إِنْتاجِ	N;NHUM;GEN;MASC;SG;PSSD
نِسْبَة	النِّسْبَةِ	N;NHUM;GEN;DEF;FEM;SG
طِبِّيّ	الطِّبِّيَّةِ	ADJ;GEN;DEF;FEM;SG
مِيزان	مَوازِينِ	N;NHUM;GEN;MASC;PL;PSSD
رِسالَة	رِسالَةٍ	N;NHUM;GEN;INDF;FEM;SG
سُورِيّ	السُّورِيِّ	ADJ;GEN;DEF;MASC;SG
لَجْنَة	لَجْنَةُ	N;NHUM;NOM;FEM;SG;PSSD
رَئِيس	الرَّئِيسَ	N;HUM;ACC;DEF;MASC;SG
مُسْتَقِلّ	مُسْتَقِلٍّ	ADJ;GEN;INDF;MASC;SG
مَحَطَّة	مَحَطَّةِ	N;NHUM;GEN;FEM;SG;PSSD
رَدّ	رَدٍّ	N;NHUM;GEN;INDF;MASC;SG
دَخَل	يَدْخُلُ	V;IPFV;MASC;IND;SG;3;ACT
شَمِل	يَشْمَلُ	V;IPFV;MASC;IND;SG;3;ACT
أَيّ	أَيَّ	N;ACC;MASC;SG;PSSD
بَرِيد	البَرِيدِ	N;NHUM;GEN;DEF;MASC;SG
مَوْج	المَوْجِ	N;NHUM;GEN;DEF;MASC;SG
هَدَف	تَهْدِفُ	V;IPFV;FEM;IND;SG;3;ACT
عام	عاماً	N;NHUM;ACC;INDF;MASC;SG
أَثار	أَثارَت	V;PFV;FEM;IND;SG;3;ACT
تَنْمِيَة	التَّنْمِيَةِ	N;NHUM;GEN;DEF;FEM;SG
فَهِم	يَفْهَمُ	V;IPFV;MASC;IND;SG;3;ACT
أَمْر	الأَمْرُ	N;NHUM;NOM;DEF;MASC;SG
أَمْس	أَمْسِ	N;NHUM;GEN;MASC;SG;PSSD
مُعارَضَة	المُعارَضَةِ	N;NHUM;GEN;DEF;FEM;SG
أَثَّر	تُؤَثِّرُ	V;IPFV;FEM;IND;SG;3;ACT
جُمْلَة	جُمْلَةً	N;NHUM;ACC;INDF;FEM;SG
عَرَبِيّ	عَرَبِيٍّ	N;HUM;GEN;INDF;MASC;SG
فِلَسْطِينِيّ	الفِلَسْطِينِيَّةَ	ADJ;ACC;DEF;FEM;SG
جِذْر	جُذُورِ	N;NHUM;GEN;MASC;PL;PSSD
آخَر	آخَر	ADJ;INDF;MASC;SG
أَحَقِّيَّة	أَحَقِّيَّةَ	N;NHUM;ACC;FEM;SG;PSSD
نِداء	نِداءً	N;NHUM;ACC;INDF;MASC;SG
تَطَلَّب	يَتَطَلَّبُ	V;IPFV;MASC;IND;SG;3;ACT
إِسْبانِيّ	الإِسْبانِيَّةُ	ADJ;NOM;DEF;FEM;SG
عَقَب	تَعْقُبَ	V;IPFV;FEM;SBJV;SG;3;ACT
بَلَغ	بَلَغَت	V;PFV;FEM;IND;SG;3;ACT
مُساعَدَة	المُساعَداتِ	N;NHUM;GEN;DEF;FEM;PL
قُوَّة	القُوّاتِ	N;NHUM;GEN;DEF;FEM;PL
مُطْران	المُطْرانِ	N;HUM;GEN;DEF;MASC;SG
بَعِيد	بَعِيداً	N;NHUM;ACC;INDF;MASC;SG
مُؤَكِّد	مُؤَكِّدَةً	ADJ;ACC;INDF;FEM;SG
مَسار	مَسارَ	N;NHUM;ACC;MASC;SG;PSSD
حِزْب	الحِزْبُ	N;NHUM;NOM;DEF;MASC;SG
أَوَّل	الأَوَّلِ	ADJ;GEN;DEF;MASC;SG
حاجِز	حاجِزٍ	N;NHUM;GEN;INDF;MASC;SG
تَدْقِيق	تَدْقِيقاتٍ	N;NHUM;GEN;INDF;MASC;PL
مَدّ	مَدِّ	N;NHUM;GEN;MASC;SG;PSSD
مِنْطَقَة	مَناطِقِ	N;NHUM;GEN;FEM;PL;PSSD
ثانِي	الثّانِيَةَ	ADJ;ACC;DEF;FEM;SG
تارِيخِيّ	التّارِيخِيَّةِ	ADJ;GEN;DEF;FEM;SG
مُمَثِّل	مُمَثِّلُ	N;HUM;NOM;MASC;SG;PSSD
أَمْن	الأَمْنِ	N;NHUM;GEN;DEF;MASC;SG
قال	يُقالُ	V;IPFV;MASC;IND;SG;3;PASS
نائِب	النّائِبُ	N;HUM;NOM;DEF;MASC;SG
ٱِغْتِنام	اِغْتِنامِ	N;NHUM;GEN;MASC;SG;PSSD
فَتْرَة	فَتْرَةِ	N;NHUM;GEN;FEM;SG;PSSD
إِرْث	إِرْثَ	N;NHUM;ACC;MASC;SG;PSSD
عالَم	العالَمَ	N;NHUM;ACC;DEF;MASC;SG
دَوْلَة	دُوَلٍ	N;NHUM;GEN;INDF;FEM;PL
جَيّاش	جَيّاشَةٌ	N;NHUM;NOM;INDF;FEM;SG
عَرَبِيّ	العَرَبِيَّةِ	ADJ;GEN;DEF;FEM;SG
رَأَى	رَأَى	V;PFV;MASC;IND;SG;3;ACT
دَقِيق	الدَّقِيقَةِ	ADJ;GEN;DEF;FEM;SG
جَدِيد	جَدِيدٍ	ADJ;GEN;INDF;MASC;SG
مُقْبِل	المُقْبِلِ	ADJ;GEN;DEF;MASC;SG
جُنَيْه	الجُنَيْهِ	N;NHUM;GEN;DEF;MASC;SG
إِسْبانِيّ	الإِسْبانِيَّةِ	ADJ;GEN;DEF;FEM;SG
أَبْدَى	أَبْدَت	V;PFV;FEM;IND;SG;3;ACT
ظاهِرَة	الظّاهِرَةِ	N;NHUM;GEN;DEF;FEM;SG
بِنْزِين	البِنْزِينِ	N;NHUM;GEN;DEF;MASC;SG
تَقْرِير	التَّقْرِيرَ	N;NHUM;ACC;DEF;MASC;SG
خاصّ	الخاصِّ	ADJ;GEN;DEF;MASC;SG
نَصّ	النَّصُّ	N;NHUM;NOM;DEF;MASC;SG
مُهاجِم	المُهاجِمُ	N;HUM;NOM;DEF;MASC;SG
مَعْنَى	مَعانِي	N;NHUM;INDF;MASC;PL
سِعْر	الأَسْعارِ	N;NHUM;GEN;DEF;MASC;PL
طَبَقَة	طَبَقَتَيْنِ	N;NHUM;GEN;INDF;FEM;DU
أَكْثَر	الأَكْثَرِ	ADJ;GEN;CMPR;DEF;MASC;SG
إِسْلامِيّ	إِسْلامِيُّونَ	N;HUM;NOM;INDF;MASC;PL
مَفْتُوح	المَفْتُوحَةِ	ADJ;GEN;DEF;FEM;SG
تَوافُق	التَّوافُقِ	N;NHUM;GEN;DEF;MASC;SG
عَقَد	عُقِدَ	V;PFV;MASC;IND;SG;3;PASS
تَعْلِيمِيّ	التَّعْلِيمِيَّةِ	ADJ;GEN;DEF;FEM;SG
شَخْصِيَّة	الشَّخْصِيّاتِ	N;NHUM;GEN;DEF;FEM;PL
ٱِرْتَفَع	اِرْتَفَعَت	V;PFV;FEM;IND;SG;3;ACT
وَسَّع	تُوَسِّعَ	V;IPFV;FEM;SBJV;SG;3;ACT
ٱِبْن	اِبْنِ	N;HUM;GEN;MASC;SG;PSSD
رِئاسَة	رِئاسَةِ	N;NHUM;GEN;FEM;SG;PSSD
مُسْتَوْرَد	المُسْتَوْرَدَةِ	ADJ;GEN;DEF;FEM;SG
مُؤَسَّسَة	المُؤَسَّساتِ	N;NHUM;ACC;DEF;FEM;PL
قِمَّة	قِمَّةِ	N;NHUM;GEN;FEM;SG;PSSD
هَدَف	هَدَفُ	N;NHUM;NOM;MASC;SG;PSSD
مُهاجِم	مُهاجِمِ	N;HUM;GEN;MASC;SG;PSSD
سِلْعَة	السِّلَعِ	N;NHUM;GEN;DEF;FEM;PL
شَيْء	الأَشْياءَ	N;NHUM;ACC;DEF;MASC;PL
عادَة	عادَةً	N;NHUM;ACC;INDF;FEM;SG
أَهَمِّيَّة	أَهَمِّيَّةِ	N;NHUM;GEN;FEM;SG;PSSD
قَدِيم	القَدِيمَةِ	ADJ;GEN;DEF;FEM;SG
مِلَفّ	المِلَفِّ	N;NHUM;GEN;DEF;MASC;SG
وَطَنِيّ	الوَطَنِيُّ	ADJ;NOM;DEF;MASC;SG
كَلَّف	تُكَلِّفَ	V;IPFV;FEM;SBJV;SG;3;ACT
تَمَسُّك	التَّمَسُّكُ	N;NHUM;NOM;DEF;MASC;SG
مُسْتَقْبَل	مُسْتَقْبَلِ	N;NHUM;GEN;MASC;SG;PSSD
غَيْر	غَيْرِ	N;NHUM;GEN;MASC;SG;PSSD
رَأْس	رَأْسِ	N;NHUM;GEN;MASC;SG;PSSD
