holen	holst	V;IND;SG;2;PRS
Frosch	Frosch	N;ACC;MASC;SG
Schwein	Schwein	N;NOM;NEUT;SG
brauchen	brauchst	V;IND;SG;2;PRS
Banane	Bananen	N;DAT;FEM;PL
machen	mache	V;IND;SG;1;PRS
ärgern	ärgern	V;IND;PL;1;PRS
liegen	liege	V;IND;SG;1;PRS
Boden	Boden	N;DAT;MASC;SG
überlegen	überleg	V;IMP;SG;2
transportieren	transportiert	V;IND;SG;3;PRS
grillen	grillen	V;IND;PL;1;PRS
treffen	trifft	V;IND;SG;3;PRS
helfen	helfe	V;IND;SG;1;PRS
Ferkel	Ferkel	N;NOM;NEUT;PL
Rübe	Rübe	N;NOM;FEM;SG
Flugzeug	Flugzeuge	N;DAT;NEUT;SG
funktionieren	funktionieren	V;IND;PL;3;PRS
schicken	schicken	V;IND;PL;3;PRS
haben	haben	V;IND;PL;3;PRS
Fenster	Fenster	N;DAT;NEUT;SG
Mixer	Mixer	N;DAT;MASC;SG
ablegen	legen ab	V;IND;PL;1;PRS
Fliege	Fliegen	N;DAT;FEM;PL
Brücke	Brücke	N;NOM;FEM;SG
Löffel	Löffel	N;ACC;MASC;SG
klagen	klagt	V;IND;SG;3;PRS
Foto	Fotos	N;GEN;NEUT;SG
passen	passe	V;IND;SG;1;PRS
warten	wartet	V;IND;SG;3;PRS
gehen	geht	V;IMP;PL;2
bauen	baust	V;IND;SG;2;PRS
Po	Po	N;ACC;MASC;SG
fassen	fass	V;IMP;SG;2
fahren	fahren	V;IND;PL;3;PRS
Fahne	Fahnen	N;DAT;FEM;PL
Dach	Dach	N;DAT;NEUT;SG
Papa	Papa	N;ACC;MASC;SG
gießen	gießt	V;IND;SG;3;PRS
Rest	Rest	N;NOM;MASC;SG
Magen	Magen	N;NOM;MASC;SG
abreißen	reißen ab	V;IND;PL;1;PRS
Frühstück	Frühstück	N;NOM;NEUT;SG
drücken	drückst	V;IND;SG;2;PRS
verlieren	verloren	V;IND;PL;3;PST
Putzen	Putzen	N;DAT;NEUT;SG
Weg	Weg	N;ACC;MASC;SG
mögen	möge	V;SBJV;SG;3;PRS
helfen	helfen	V;IND;PL;3;PRS
Bäcker	Bäcker	N;ACC;MASC;SG
erkennen	erkennt	V;IND;SG;3;PRS
Meister	Meister	N;ACC;MASC;SG
stellen	stellt	V;IND;SG;3;PRS
Bauch	Bauch	N;DAT;MASC;SG
Messer	Messer	N;DAT;MASC;SG
Tanne	Tannen	N;DAT;FEM;PL
Nuss	Nüssen	N;DAT;FEM;PL
Leipziger	Leipziger	N;DAT;MASC;SG
Arzt	Arzt	N;NOM;MASC;SG
Parkett	Parkett	N;NOM;NEUT;SG
Kindergarten	Kindergarten	N;DAT;MASC;SG
Freund	Freund	N;NOM;MASC;SG
fragen	fragt	V;IND;SG;3;PRS
Regel	Regel	N;GEN;FEM;SG
zeigen	zeigen	V;IND;PL;1;PRS
scheinen	scheint	V;IND;SG;3;PRS
fühlen	fühl	V;IMP;SG;2
Ball	Ball	N;ACC;MASC;SG
versuchen	versuch	V;IMP;SG;2
müssen	müssest	V;SBJV;SG;2;PRS
Elster	Elster	N;GEN;FEM;SG
wissen	wisse	V;SBJV;SG;1;PRS
versuchen	versuchen	V;IND;PL;1;PRS
Kaninchen	Kaninchens	N;GEN;NEUT;SG
Signal	Signal	N;NOM;NEUT;SG
kommen	kommen	V;IND;PL;3;PRS
abschälen	schälen ab	V;IND;PL;3;PRS
austrinken	trinken aus	V;IND;PL;3;PRS
helfen	hilfst	V;IND;SG;2;PRS
sagen	sagtest	V;SBJV;SG;2;PST
Rücken	Rücken	N;DAT;MASC;SG
Flagge	Flagge	N;GEN;FEM;SG
schneiden	schneidest	V;IND;SG;2;PRS
Wäsche	Wäsche	N;GEN;FEM;SG
Kreuzung	Kreuzung	N;GEN;FEM;SG
Glas	Glase	N;DAT;NEUT;SG
kaufen	kauft	V;IND;SG;3;PRS
singen	singst	V;IND;SG;2;PRS
Achterbahn	Achterbahn	N;GEN;FEM;SG
blanchieren	blanchieren	V;IND;PL;3;PRS
Krokodil	Krokodil	N;DAT;NEUT;SG
Häuschen	Häuschen	N;DAT;NEUT;SG
schälen	schäl	V;IMP;SG;2
Schnuller	Schnuller	N;ACC;MASC;SG
Kern	Kern	N;ACC;MASC;SG
Lautsprecher	Lautsprecher	N;ACC;MASC;SG
füttern	fütterte	V;SBJV;SG;1;PST
schmieren	schmieren	V;IND;PL;3;PRS
rollen	rollt	V;IND;SG;3;PRS
Rücklicht	Rücklicht	N;NOM;NEUT;SG
Pille	Pillen	N;DAT;FEM;PL
wärmen	wärmen	V;IND;PL;3;PRS
fürchten	fürchte	V;IND;SG;1;PRS
Optimist	Optimist	N;NOM;MASC;SG
komplizieren	kompliziert	V;IND;SG;3;PRS
trinken	trinkt	V;IND;SG;3;PRS
mögen	mögen	V;SBJV;PL;1;PRS
Mikrofon	Mikrofon	N;NOM;NEUT;SG
Loch	Loch	N;DAT;NEUT;SG
Mitte	Mitte	N;GEN;FEM;SG
umfallen	fallen um	V;IND;PL;3;PRS
meinen	meinst	V;IND;SG;2;PRS
Koffer	Koffer	N;ACC;MASC;SG
laden	lädt 	V;IND;SG;3;PRS
haben	hattest	V;IND;SG;2;PST
Ruhe	Ruhe	N;NOM;FEM;SG
kriechen	kriechen	V;IND;PL;1;PRS
Spielplatz	Spielplatz	N;DAT;MASC;SG
Blume	Blumen	N;DAT;FEM;PL
wollen	will	V;IND;SG;1;PRS
kosten	kostet	V;IND;PL;2;PRS
ausziehen	ziehen aus	V;IND;PL;1;PRS
Berliner	Berliner	N;NOM;MASC;PL
Hand	Händen	N;DAT;FEM;PL
müssen	müssen	V;SBJV;PL;3;PRS
Telefon	Telefon	N;DAT;NEUT;SG
Spezialität	Spezialität	N;NOM;FEM;SG
Art	Art	N;NOM;FEM;SG
Zauberer	Zauberer	N;NOM;MASC;PL
legen	legen	V;IND;PL;1;PRS
fangen	fangen	V;IND;PL;3;PRS
stellen	stell	V;IMP;SG;2
Belohnung	Belohnung	N;NOM;FEM;SG
Kerlchen	Kerlchen	N;NOM;NEUT;SG
Hut	Hut	N;ACC;MASC;SG
helfen	hilf	V;IMP;SG;2
wohnen	wohnt	V;IND;SG;3;PRS
Honig	Honig	N;NOM;MASC;SG
geben	gab	V;IND;SG;3;PST
Brand	Brand	N;NOM;MASC;SG
sollen	sollte	V;SBJV;SG;3;PST
Akku	Akku	N;NOM;MASC;SG
ziehen	ziehe	V;IND;SG;1;PRS
stechen	sticht	V;IND;SG;3;PRS
wollen	wolltest	V;SBJV;SG;2;PST
gefallen	gefallen	V;IND;PL;1;PRS
Ende	Ende	N;NOM;NEUT;SG
frieren	friert	V;IND;SG;3;PRS
geben	gab	V;IND;SG;1;PST
Lieferung	Lieferung	N;NOM;FEM;SG
landen	landet	V;IND;PL;2;PRS
Leiter	Leiter	N;NOM;MASC;SG
können	können	V;SBJV;PL;1;PRS
parken	parken	V;IND;PL;1;PRS
würfeln	würfelt	V;IND;SG;3;PRS
Bär	Bär	N;NOM;MASC;SG
Kommode	Kommode	N;GEN;FEM;SG
ausladen	laden aus	V;IND;PL;1;PRS
Schiene	Schienen	N;DAT;FEM;PL
abheben	heben ab	V;IND;PL;3;PRS
Giraffe	Giraffen	N;DAT;FEM;PL
Besen	Besen	N;ACC;MASC;SG
Hang	Hang	N;ACC;MASC;SG
Frau	Frau	N;NOM;FEM;SG
orientieren	orientieren	V;IND;PL;3;PRS
Netz	Netz	N;NOM;NEUT;SG
Puppe	Puppe	N;NOM;FEM;SG
Gesellschaft	Gesellschaft	N;NOM;FEM;SG
beschweren	beschwerst	V;IND;SG;2;PRS
Fahne	Fahne	N;NOM;FEM;SG
abfahren	fahren ab	V;IND;PL;3;PRS
Öse	Öse	N;NOM;FEM;SG
liegen	liegen	V;IND;PL;3;PRS
bleiben	bleiben	V;IND;PL;3;PRS
qualmen	qualmt	V;IND;SG;3;PRS
Halle	Halle	N;NOM;FEM;SG
ziehen	ziehst	V;IND;SG;2;PRS
Landebahn	Landebahn	N;GEN;FEM;SG
strecken	streckt	V;IND;SG;3;PRS
lecken	leckt	V;IND;SG;3;PRS
Becher	Becher	N;ACC;MASC;SG
gewinnen	gewinne	V;IND;SG;1;PRS
Schaukel	Schaukel	N;NOM;FEM;SG
freuen	freut	V;IND;SG;3;PRS
Maßnahme	Maßnahme	N;NOM;FEM;SG
Bahnhof	Bahnhofe	N;DAT;MASC;SG
wohnen	wohnen	V;IND;PL;1;PRS
essen	isst	V;IND;SG;3;PRS
hängen	hängen	V;IND;PL;1;PRS
angeln	angeln	V;IND;PL;3;PRS
setzen	setze	V;IND;SG;1;PRS
bauen	bauen	V;IND;PL;3;PRS
Nase	Nase	N;NOM;FEM;SG
Treppe	Treppen	N;DAT;FEM;PL
schlabbern	schlabberst	V;IND;SG;2;PRS
vergessen	vergessen	V;IND;PL;1;PRS
haben	habe	V;SBJV;SG;1;PRS
dürfen	darf	V;IND;SG;1;PRS
Jahr	Jahren	N;DAT;NEUT;PL
halten	hält	V;IND;SG;3;PRS
rollen	rollen	V;IND;PL;1;PRS
enden	endet	V;IND;PL;2;PRS
winden	windet	V;IND;PL;2;PRS
drehen	dreh	V;IMP;SG;2
können	kann	V;IND;SG;3;PRS
verlieren	verliert	V;IND;SG;3;PRS
Zahl	Zahlen	N;NOM;FEM;PL
Klo	Klo	N;NOM;NEUT;SG
Mond	Mond	N;NOM;MASC;SG
Pumpe	Pumpe	N;NOM;FEM;SG
umklappen	klappen um	V;IND;PL;1;PRS
turnen	turnen	V;IND;PL;1;PRS
kommen	komme	V;IND;SG;1;PRS
liegen	liegt	V;IND;SG;3;PRS
Fall	Falle	N;DAT;MASC;SG
Birne	Birne	N;NOM;FEM;SG
denken	dachte	V;IND;SG;1;PST
Pfanne	Pfanne	N;NOM;FEM;SG
Sache	Sache	N;NOM;FEM;SG
tragen	tragen	V;IND;PL;3;PRS
Weiche	Weichen	N;DAT;FEM;PL
abspülen	spülen ab	V;IND;PL;1;PRS
kommen	kommst	V;IND;SG;2;PRS
Fuchs	Fuchs	N;NOM;MASC;SG
Ampel	Ampel	N;NOM;FEM;SG
heißen	heiße	V;IND;SG;1;PRS
kaufen	kaufen	V;IND;PL;1;PRS
Blume	Blume	N;NOM;FEM;SG
Hut	Hut	N;NOM;MASC;SG
Ding	Dinge	N;DAT;NEUT;SG
absaugen	saugt ab	V;IND;SG;3;PRS
anbeißen	beißt an	V;IND;SG;3;PRS
schicken	schickt	V;IND;SG;3;PRS
Blödsinn	Blödsinn	N;ACC;MASC;SG
Frosch	Frosch	N;NOM;MASC;SG
küssen	küss	V;IMP;SG;2
lächeln	lächelt	V;IND;SG;3;PRS
Güterwagen	Güterwagens	N;GEN;MASC;SG
Stamm	Stamm	N;NOM;MASC;SG
Zirkus	Zirkus	N;DAT;MASC;SG
sieben	sieben	V;IND;PL;1;PRS
schlagen	schlagen	V;IND;PL;3;PRS
läuten	läuten	V;IND;PL;1;PRS
ausmalen	malen aus	V;IND;PL;1;PRS
können	konnte	V;IND;SG;3;PST
schneiden	schneiden	V;IND;PL;3;PRS
müssen	müsse	V;SBJV;SG;1;PRS
Film	Filme	N;DAT;MASC;SG
kriegen	kriege	V;IND;SG;1;PRS
singen	singen	V;IND;PL;3;PRS
radeln	radeln	V;IND;PL;1;PRS
Heuschrecke	Heuschrecke	N;NOM;FEM;SG
heilen	heile	V;IND;SG;1;PRS
Schuh	Schuh	N;DAT;MASC;PL
kleben	kleben	V;IND;PL;1;PRS
Zug	Zügen	N;DAT;MASC;PL
Herz	Herz	N;NOM;NEUT;SG
kleben	kleb	V;IMP;SG;2
Glockenturm	Glockenturm	N;ACC;MASC;SG
Klappe	Klappe	N;NOM;FEM;SG
schrauben	schrauben	V;IND;PL;1;PRS
Pflanze	Pflanzen	N;DAT;FEM;PL
Wasserfarbe	Wasserfarben	N;DAT;FEM;PL
Tochter	Tochter	N;NOM;FEM;SG
Frau	Frau	N;GEN;FEM;SG
schönen	schön	V;IMP;SG;2
rutschen	rutscht	V;IND;SG;3;PRS
gucken	gucke	V;IND;SG;1;PRS
suchen	suchst	V;IND;SG;2;PRS
Auge	Augen	N;NOM;NEUT;PL
Brot	Brote	N;NOM;NEUT;PL
verhandeln	verhandelst	V;IND;SG;2;PRS
baden	baden	V;IND;PL;3;PRS
sitzen	sitzen	V;IND;PL;3;PRS
putzen	putzt	V;IND;SG;3;PRS
anprobieren	probiert an	V;IND;SG;3;PRS
schummeln	schummelt	V;IND;SG;3;PRS
nehmen	nimmt	V;IND;SG;3;PRS
heißen	heißen	V;IND;PL;1;PRS
Osterei	Osterei	N;NOM;NEUT;SG
riechen	riechen	V;IND;PL;1;PRS
haben	hatten	V;IND;PL;1;PST
Karte	Karte	N;NOM;FEM;SG
Verbinden	Verbinden	N;DAT;NEUT;SG
schauen	schaut	V;IND;SG;3;PRS
verbrennen	verbrennt	V;IND;SG;3;PRS
Helm	Helm	N;ACC;MASC;SG
stechen	stechen	V;IND;PL;3;PRS
Anfang	Anfange	N;DAT;MASC;SG
Geschirr	Geschirre	N;DAT;MASC;SG
sagen	sagen	V;IND;PL;3;PRS
bringen	bringst	V;IND;SG;2;PRS
Lokführer	Lokführer	N;NOM;MASC;SG
Schwein	Schweine	N;DAT;NEUT;SG
Platz	Platze	N;DAT;MASC;SG
grauen	grauen	V;IND;PL;3;PRS
versuchen	versuchst	V;IND;SG;2;PRS
tanzen	tanzte	V;SBJV;SG;3;PST
helfen	helfen	V;IND;PL;1;PRS
Distel	Disteln	N;DAT;FEM;PL
Bahn	Bahn	N;NOM;FEM;SG
Schiff	Schiffe	N;DAT;NEUT;SG
Reihe	Reihe	N;NOM;FEM;SG
Opa	Opas	N;GEN;MASC;SG
steigen	steigen	V;IND;PL;1;PRS
aussetzen	setzen aus	V;IND;PL;3;PRS
sagen	sage	V;IND;SG;1;PRS
Doktor	Doktor	N;NOM;MASC;SG
biegen	biegen	V;IND;PL;3;PRS
warnen	warne	V;IND;SG;1;PRS
Kaulquappe	Kaulquappen	N;DAT;FEM;PL
stimmen	stimmt	V;IND;SG;3;PRS
Laterne	Laterne	N;NOM;FEM;SG
füttern	füttern	V;IND;PL;1;PRS
laufen	lauf	V;IMP;SG;2
gewöhnen	gewöhnt	V;IND;SG;3;PRS
reißen	reißt	V;IND;SG;3;PRS
Meer	Meere	N;DAT;NEUT;SG
müssen	müssen	V;IND;PL;3;PRS
Montag	Montage	N;DAT;MASC;SG
Fisch	Fische	N;NOM;MASC;PL
laden	lade 	V;IND;SG;1;PRS
Eins	Eins	N;NOM;FEM;SG
packen	packt	V;IND;SG;3;PRS
Sonne	Sonne	N;GEN;FEM;SG
schälen	schälst	V;IND;SG;2;PRS
Fledermaus	Fledermaus	N;NOM;FEM;SG
angeln	angeln	V;IND;PL;1;PRS
Eichhörnchen	Eichhörnchen	N;NOM;NEUT;PL
reparieren	reparieren	V;IND;PL;1;PRS
machen	machen	V;IND;PL;3;PRS
merken	merk	V;IMP;SG;2
stören	stört	V;IND;SG;3;PRS
Gespenst	Gespenst	N;NOM;NEUT;SG
Eimer	Eimer	N;DAT;MASC;SG
fehlen	fehlte	V;SBJV;SG;3;PST
wollen	wollte	V;SBJV;SG;3;PST
Tasche	Tasche	N;NOM;FEM;SG
heben	heb	V;IMP;SG;2
Heizung	Heizung	N;NOM;FEM;SG
Null	Null	N;NOM;FEM;SG
machen	machen	V;IND;PL;1;PRS
Buch	Bücher	N;NOM;NEUT;PL
Hafen	Hafen	N;NOM;MASC;SG
falten	falten	V;IND;PL;1;PRS
jucken	juckt	V;IND;SG;3;PRS
sehen	sehe	V;IND;SG;1;PRS
Pony	Ponys	N;GEN;NEUT;SG
brauchen	brauchen	V;IND;PL;1;PRS
Pfeil	Pfeil	N;ACC;MASC;SG
verlaufen	verläuft	V;IND;SG;3;PRS
Brust	Brust	N;NOM;FEM;SG
Kühlschrank	Kühlschranke	N;DAT;MASC;SG
Zeiger	Zeiger	N;NOM;MASC;PL
wollen	wollen	V;IND;PL;3;PRS
runterfallen	fällt runter	V;IND;SG;3;PRS
Mistgabel	Mistgabel	N;NOM;FEM;SG
lernen	lernt	V;IND;SG;3;PRS
schlüpfen	schlüpft	V;IND;SG;3;PRS
Schaffner	Schaffner	N;NOM;MASC;PL
Pfote	Pfote	N;NOM;FEM;SG
gleichen	gleiche	V;IND;SG;1;PRS
inszenieren	inszenierst	V;IND;SG;2;PRS
grauen	graue	V;IND;SG;1;PRS
fahren	fahren	V;IND;PL;1;PRS
Strumpf	Strümpfen	N;DAT;MASC;PL
Eule	Eule	N;GEN;FEM;SG
räumen	räume	V;IND;SG;1;PRS
abgeben	geben ab	V;IND;PL;1;PRS
Haus	Hause	N;DAT;NEUT;SG
Aufzug	Aufzug	N;DAT;MASC;SG
Kürbissuppe	Kürbissuppe	N;NOM;FEM;SG
Dienstag	Dienstag	N;DAT;MASC;SG
schrauben	schraub	V;IMP;SG;2
Zug	Züge	N;NOM;MASC;PL
umfallen	fällt um	V;IND;SG;3;PRS
sollen	sollt	V;IND;PL;2;PRS
heulen	heulen	V;IND;PL;3;PRS
Hydrant	Hydrant	N;NOM;MASC;SG
finden	findet	V;IND;PL;2;PRS
hauen	hau	V;IMP;SG;2
Pferd	Pferd	N;NOM;NEUT;SG
Fuchs	Fuchs	N;ACC;MASC;SG
Roboter	Roboter	N;NOM;MASC;SG
Ergebnis	Ergebnis	N;NOM;NEUT;SG
Pfanne	Pfanne	N;GEN;FEM;SG
Gondel	Gondel	N;NOM;FEM;SG
Schiff	Schiffen	N;DAT;NEUT;PL
kneten	kneten	V;IND;PL;1;PRS
wundern	wundern	V;IND;PL;3;PRS
hängen	hängt	V;IND;SG;3;PRS
Auto	Auto	N;DAT;NEUT;SG
Energie	Energien	N;DAT;FEM;PL
Gracht	Gracht	N;NOM;FEM;SG
Seife	Seife	N;NOM;FEM;SG
finden	fand	V;IND;SG;1;PST
Teller	Teller	N;ACC;MASC;SG
Dame	Damen	N;DAT;FEM;PL
Mütze	Mützen	N;DAT;FEM;PL
rutschen	rutschen	V;IND;PL;3;PRS
