feiern	feierten	V;SBJV;PL;1;PST
Glas	Glas	N;NOM;NEUT;SG
Mandel	Mandeln	N;DAT;MASC;PL
Teil	Teil	N;NOM;NEUT;SG
Sonne	Sonne	N;NOM;FEM;SG
knicken	knickst	V;IND;SG;2;PRS
legen	legen	V;IND;PL;1;PRS
Motorrad	Motorrade	N;DAT;NEUT;SG
Wand	Wand	N;NOM;FEM;SG
rollen	roll	V;IMP;SG;2
brauchen	brauch	V;IMP;SG;2
torkeln	torkelt	V;IND;SG;3;PRS
Zeitung	Zeitung	N;NOM;FEM;SG
essen	iss	V;IMP;SG;2
packen	packt	V;IND;SG;3;PRS
probieren	probieren	V;IND;PL;1;PRS
falten	falten	V;IND;PL;3;PRS
geben	geben	V;IND;PL;3;PRS
langweilen	langweilt	V;IND;SG;3;PRS
putzen	putzen	V;IND;PL;3;PRS
müssen	muss	V;IND;SG;3;PRS
Tisch	Tisch	N;ACC;MASC;SG
Koch	Köche	N;NOM;MASC;PL
ausgraben	graben aus	V;IND;PL;1;PRS
krähen	krähen	V;IND;PL;3;PRS
ausmachen	machen aus	V;IND;PL;1;PRS
legen	legt	V;IND;SG;3;PRS
Rad	Rädern	N;DAT;NEUT;PL
interessieren	interessiert	V;IND;SG;3;PRS
Schlafzimmer	Schlafzimmer	N;DAT;NEUT;SG
Lautsprecher	Lautsprecher	N;NOM;MASC;SG
haben	hatte	V;IND;SG;1;PST
brennen	brennt	V;IND;SG;3;PRS
Anziehen	Anziehen	N;DAT;NEUT;SG
Scheibe	Scheibe	N;NOM;FEM;SG
Schlange	Schlange	N;NOM;FEM;SG
abräumen	räumen ab	V;IND;PL;1;PRS
Arm	Arme	N;DAT;MASC;SG
Ketchup	Ketchup	N;NOM;MASC;SG
Kaffee	Kaffee	N;NOM;MASC;SG
sitzen	sitz	V;IMP;SG;2
klingeln	klingeln	V;IND;PL;1;PRS
sollen	soll	V;IND;SG;3;PRS
Reh	Rehen	N;DAT;MASC;PL
Kopf	Kopf	N;ACC;MASC;SG
Teil	Teile	N;NOM;NEUT;PL
bringen	bringst	V;IND;SG;2;PRS
Kirsche	Kirschen	N;DAT;FEM;PL
Bahn	Bahn	N;GEN;FEM;SG
putzen	putzen	V;IND;PL;1;PRS
Auto	Autos	N;NOM;NEUT;PL
gewinnen	gewinnen	V;IND;PL;1;PRS
Einsatz	Einsatz	N;ACC;MASC;SG
demontieren	demontiert	V;IND;SG;3;PRS
merken	merken	V;IND;PL;3;PRS
Bus	Bus	N;DAT;MASC;SG
Supermarkt	Supermarkt	N;DAT;MASC;SG
rausfliegen	fliegt raus	V;IND;SG;3;PRS
dauern	dauert	V;IND;SG;3;PRS
können	können	V;IND;PL;1;PRS
Motor	Motor	N;NOM;MASC;SG
Spiel	Spiel	N;NOM;NEUT;SG
Kapitel	Kapitel	N;DAT;NEUT;SG
liegen	liegen	V;IND;PL;1;PRS
Kugelfisch	Kugelfisch	N;NOM;MASC;SG
müssen	muss	V;IND;SG;1;PRS
entfernen	entfern	V;IMP;SG;2
Ball	Balle	N;DAT;MASC;SG
grünen	grünen	V;IND;PL;1;PRS
können	kann	V;IND;SG;1;PRS
tragen	tragen	V;IND;PL;1;PRS
Bonbon	Bonbons	N;GEN;NEUT;SG
Augenblick	Augenblicke	N;DAT;MASC;SG
schwingen	schwinge	V;IND;SG;1;PRS
Herbst	Herbste	N;DAT;MASC;SG
Baum	Bäume	N;NOM;MASC;PL
Kofferraum	Kofferraum	N;NOM;MASC;SG
Jahr	Jahren	N;DAT;NEUT;PL
Tolle	Tolle	N;GEN;NEUT;SG
Käfer	Käfers	N;GEN;MASC;SG
Gefallen	Gefallen	N;ACC;MASC;SG
Leiter	Leiter	N;NOM;MASC;SG
merken	merkst	V;IND;SG;2;PRS
Schlacht	Schlacht	N;NOM;MASC;SG
sprechen	sprich	V;IMP;SG;2
Punkt	Punkte	N;NOM;MASC;PL
Ball	Ball	N;NOM;MASC;SG
bedienen	bediene	V;IND;SG;1;PRS
Maus	Maus	N;GEN;FEM;SG
Stunde	Stunde	N;NOM;FEM;SG
Welt	Welt	N;NOM;FEM;SG
trinken	trink	V;IMP;SG;2
Stock	Stock	N;DAT;MASC;SG
lauschen	lauscht	V;IND;SG;3;PRS
bitten	bitten	V;IND;PL;1;PRS
kleben	kleben	V;IND;PL;3;PRS
Bein	Bein	N;DAT;NEUT;SG
klären	klärst	V;IND;SG;2;PRS
Kind	Kinder	N;NOM;NEUT;PL
reparieren	reparier	V;IMP;SG;2
Zucker	Zucker	N;ACC;MASC;SG
weinen	weint	V;IND;SG;3;PRS
Echse	Echsen	N;DAT;FEM;PL
hopsen	hopsen	V;IND;PL;1;PRS
Hahn	Hahn	N;NOM;MASC;SG
pusten	pusten	V;IND;PL;1;PRS
wollen	wollten	V;SBJV;PL;1;PST
anziehen	ziehen an	V;IND;PL;1;PRS
Bus	Bus	N;ACC;MASC;SG
auspacken	packen aus	V;IND;PL;1;PRS
Schwein	Schwein	N;NOM;NEUT;SG
Bauch	Bauch	N;NOM;MASC;SG
Uhr	Uhr	N;NOM;FEM;SG
packen	packen	V;IND;PL;1;PRS
sieben	sieben	V;IND;PL;1;PRS
greifen	greifen	V;IND;PL;3;PRS
meinen	meinte	V;SBJV;SG;3;PST
Mitte	Mitte	N;NOM;FEM;SG
Schaf	Schaf	N;NOM;NEUT;SG
Besuch	Besuch	N;NOM;MASC;SG
Blümchen	Blümchen	N;NOM;NEUT;PL
schmeißen	schmeißen	V;IND;PL;1;PRS
Rose	Rosen	N;DAT;FEM;PL
rutschen	rutscht	V;IND;SG;3;PRS
wachsen	wachsen	V;IND;PL;3;PRS
füttern	füttert	V;IND;SG;3;PRS
Weg	Weg	N;ACC;MASC;SG
Schild	Schild	N;NOM;NEUT;SG
Kürbissuppe	Kürbissuppe	N;NOM;FEM;SG
rühren	rührst	V;IND;SG;2;PRS
Werkzeug	Werkzeug	N;NOM;NEUT;SG
lesen	lese	V;IND;SG;1;PRS
suchen	such	V;IMP;SG;2
Tomate	Tomaten	N;DAT;FEM;PL
kriechen	kriechen	V;IND;PL;1;PRS
Rucksack	Rucksack	N;DAT;MASC;SG
Glück	Glücke	N;DAT;NEUT;SG
frühstücken	frühstücken	V;IND;PL;3;PRS
ausschütten	schütten aus	V;IND;PL;1;PRS
Klo	Klo	N;NOM;NEUT;SG
freuen	freut	V;IND;SG;3;PRS
meinen	meine	V;IND;SG;1;PRS
Operation	Operation	N;NOM;FEM;SG
Tasse	Tassen	N;DAT;FEM;PL
Hauptstraße	Hauptstraße	N;GEN;FEM;SG
Rückweg	Rückweg	N;ACC;MASC;SG
Nudel	Nudeln	N;DAT;FEM;PL
schreiben	schreibt	V;IND;SG;3;PRS
können	kann	V;IND;SG;3;PRS
Maul	Maul	N;NOM;NEUT;SG
können	könnest	V;SBJV;SG;2;PRS
süßen	süßen	V;IND;PL;3;PRS
Pizza	Pizza	N;NOM;FEM;SG
Himmel	Himmel	N;ACC;MASC;SG
Turm	Turm	N;ACC;MASC;SG
sagen	sagte	V;SBJV;SG;3;PST
putzen	putzt	V;IND;SG;3;PRS
hören	hören	V;IND;PL;3;PRS
verlieren	verloren	V;IND;PL;1;PST
Wort	Wort	N;NOM;NEUT;SG
Maultasche	Maultaschen	N;DAT;FEM;PL
lassen	lassen	V;IND;PL;3;PRS
Wochenende	Wochenende	N;DAT;NEUT;SG
Kamera	Kamera	N;NOM;FEM;SG
schauen	schauen	V;IND;PL;3;PRS
knallen	knall	V;IMP;SG;2
Hälfte	Hälfte	N;GEN;FEM;SG
bügeln	bügelt	V;IND;SG;3;PRS
weitergehen	geht weiter	V;IMP;PL;2
Sirene	Sirene	N;NOM;FEM;SG
Frage	Frage	N;NOM;FEM;SG
verkaufen	verkaufen	V;IND;PL;3;PRS
Kreis	Kreis	N;NOM;MASC;SG
überlegen	überlegst	V;IND;SG;2;PRS
pusten	pustest	V;IND;SG;2;PRS
gucken	guck	V;IMP;SG;2
Arbeit	Arbeit	N;GEN;FEM;SG
Friseur	Friseur	N;DAT;MASC;SG
bleiben	bleibt	V;IND;SG;3;PRS
langweilen	langweilen	V;IND;PL;1;PRS
Sieger	Sieger	N;ACC;MASC;SG
richten	richte	V;IND;SG;1;PRS
Party	Party	N;GEN;FEM;SG
starten	starten	V;IND;PL;1;PRS
schreiben	schreibst	V;IND;SG;2;PRS
stapfen	stapfte	V;SBJV;SG;1;PST
verwandeln	verwandeln	V;IND;PL;3;PRS
Fackel	Fackel	N;GEN;FEM;SG
Kinderwagen	Kinderwagen	N;DAT;MASC;SG
fließen	fließt	V;IND;SG;3;PRS
Schluss	Schluss	N;DAT;MASC;SG
Mal	Mal	N;NOM;NEUT;SG
Stein	Steinen	N;DAT;MASC;PL
Westen	Westen	N;DAT;MASC;SG
sollen	sollst	V;IND;SG;2;PRS
Stunde	Stunden	N;DAT;FEM;PL
herausholen	holen heraus	V;IND;PL;1;PRS
Blau	Blau	N;NOM;NEUT;SG
Christkind	Christkind	N;NOM;NEUT;SG
Ziege	Ziegen	N;DAT;FEM;PL
Rand	Rand	N;DAT;MASC;SG
Pullover	Pullover	N;ACC;MASC;SG
unterbrechen	unterbrechen	V;IND;PL;1;PRS
Papierkorb	Papierkorbe	N;DAT;MASC;SG
Dachs	Dachs	N;NOM;MASC;SG
quengeln	quengelt	V;IND;SG;3;PRS
beschäftigen	beschäftigt	V;IND;SG;3;PRS
Weiche	Weichen	N;DAT;FEM;PL
Schiff	Schiffes	N;GEN;NEUT;SG
Papa	Papa	N;ACC;MASC;SG
schaukeln	schaukeln	V;IND;PL;1;PRS
vorstellen	stellen vor	V;IND;PL;3;PRS
Kasse	Kasse	N;NOM;FEM;SG
Kaulquappe	Kaulquappe	N;NOM;FEM;SG
leben	lebt	V;IND;SG;3;PRS
Quark	Quark	N;ACC;MASC;SG
raufen	rauf	V;IMP;SG;2
Tiger	Tigers	N;GEN;MASC;SG
Weide	Weide	N;GEN;FEM;SG
brauchen	brauche	V;IND;SG;1;PRS
Spruch	Spruch	N;NOM;MASC;SG
kommen	kommt	V;IND;SG;3;PRS
Treppe	Treppen	N;DAT;FEM;PL
vorlesen	lesen vor	V;IND;PL;1;PRS
langen	langen	V;IND;PL;1;PRS
rufen	rufst	V;IND;SG;2;PRS
lernen	lernen	V;IND;PL;1;PRS
anheben	hebst an	V;IND;SG;2;PRS
tauchen	tauchen	V;IND;PL;1;PRS
stampfen	stampfen	V;IND;PL;1;PRS
Sorte	Sorte	N;NOM;FEM;SG
leiden	leide	V;IMP;SG;2
simulieren	simulieren	V;IND;PL;1;PRS
Mäusespeck	Mäusespeck	N;NOM;MASC;SG
liefern	liefert	V;IND;SG;3;PRS
Haltestelle	Haltestelle	N;GEN;FEM;SG
stinken	stinkt	V;IND;SG;3;PRS
Tor	Tor	N;NOM;NEUT;SG
sehen	sehen	V;IND;PL;1;PRS
Nadel	Nadeln	N;DAT;FEM;PL
Bauch	Bauch	N;ACC;MASC;SG
wischen	wischen	V;IND;PL;3;PRS
können	konnte	V;IND;SG;1;PST
Eule	Eule	N;GEN;FEM;SG
ankern	ankern	V;IND;PL;1;PRS
hocken	hockst	V;IND;SG;2;PRS
fahren	fahren	V;IND;PL;1;PRS
Holz	Holz	N;NOM;NEUT;SG
Auto	Auto	N;DAT;NEUT;SG
fragen	fragen	V;IND;PL;3;PRS
Kajüte	Kajüte	N;NOM;FEM;SG
ziehen	ziehe	V;IND;SG;1;PRS
Freund	Freund	N;ACC;MASC;SG
malen	mal	V;IMP;SG;2
Haus	Hause	N;DAT;NEUT;SG
streichen	streichen	V;IND;PL;3;PRS
bleiben	bleib	V;IMP;SG;2
nehmen	nimmt	V;IND;SG;3;PRS
Bein	Beinen	N;DAT;NEUT;PL
Ofen	Ofen	N;DAT;MASC;SG
Mondfisch	Mondfisch	N;ACC;MASC;SG
handeln	handelt	V;IND;SG;3;PRS
Bagger	Bagger	N;DAT;MASC;PL
Gras	Gras	N;NOM;NEUT;SG
holen	holst	V;IND;SG;2;PRS
stellen	stelle	V;IND;SG;1;PRS
bringen	bringt	V;IND;SG;3;PRS
wohnen	wohnen	V;IND;PL;3;PRS
müssen	musste	V;IND;SG;1;PST
Dose	Dose	N;GEN;FEM;SG
finden	finden	V;IND;PL;1;PRS
haben	hatten	V;IND;PL;1;PST
Bauer	Bauern	N;DAT;MASC;PL
probieren	probieren	V;IND;PL;3;PRS
Rad	Rad	N;NOM;NEUT;SG
Raumfähre	Raumfähre	N;NOM;FEM;SG
müssen	musstest	V;IND;SG;2;PST
stempeln	stempeln	V;IND;PL;1;PRS
rausfinden	finden raus	V;IND;PL;1;PRS
Tiger	Tiger	N;NOM;MASC;SG
fangen	fangen	V;IND;PL;1;PRS
Fahrplan	Fahrplan	N;ACC;MASC;SG
Eingang	Eingang	N;NOM;MASC;SG
aussehen	sehen aus	V;IND;PL;1;PRS
dürfen	darf	V;IND;SG;1;PRS
schnäuzen	schnäuzen	V;IND;PL;1;PRS
frieren	froren	V;IND;PL;3;PST
Erbse	Erbsen	N;DAT;FEM;PL
fallen	fallen	V;IND;PL;1;PRS
anstoßen	stößt an	V;IND;SG;2;PRS
hängen	hängen	V;IND;PL;1;PRS
krabbeln	krabbeln	V;IND;PL;3;PRS
lächeln	lächelt	V;IND;SG;3;PRS
anschließen	schließ an	V;IMP;SG;2
Tunnel	Tunnel	N;DAT;MASC;SG
Ende	Ende	N;NOM;NEUT;SG
setzen	setz	V;IMP;SG;2
runterfallen	fällt runter	V;IND;SG;3;PRS
Kopf	Köpfe	N;NOM;MASC;PL
fahren	fuhr	V;IND;SG;1;PST
rühren	rühren	V;IND;PL;1;PRS
entscheiden	entscheide	V;IND;SG;1;PRS
Hand	Händen	N;DAT;FEM;PL
achten	achten	V;IND;PL;3;PRS
Linse	Linsen	N;DAT;FEM;PL
gehen	geh	V;IMP;SG;2
nutzen	nutzt	V;IND;SG;3;PRS
wollen	willst	V;IND;SG;2;PRS
heulen	heul	V;IMP;SG;2
Menge	Menge	N;NOM;FEM;SG
antworten	antworten	V;IND;PL;3;PRS
Po	Po	N;ACC;MASC;SG
Angel	Angel	N;NOM;FEM;SG
kaufen	kauft	V;IND;SG;3;PRS
Rauch	Rauch	N;NOM;MASC;SG
Chance	Chance	N;NOM;FEM;SG
tauchen	taucht	V;IND;SG;3;PRS
Kiste	Kiste	N;GEN;FEM;SG
interessieren	interessieren	V;IND;PL;1;PRS
parken	parken	V;IND;PL;3;PRS
meinen	meinen	V;IND;PL;3;PRS
Blume	Blume	N;NOM;FEM;SG
können	konntest	V;IND;SG;2;PST
Schöpfkelle	Schöpfkelle	N;GEN;FEM;SG
sitzen	sitzen	V;IND;PL;1;PRS
Weg	Wege	N;DAT;MASC;SG
geben	gab	V;IND;SG;3;PST
kraulen	kraulst	V;IND;SG;2;PRS
Wolle	Wollen	N;DAT;FEM;PL
denken	dachte	V;IND;SG;3;PST
starten	starten	V;IND;PL;3;PRS
Rest	Rest	N;ACC;MASC;SG
wollen	wolltest	V;SBJV;SG;2;PST
behandeln	behandelt	V;IND;SG;3;PRS
Boden	Boden	N;ACC;MASC;SG
Globus	Globus	N;ACC;MASC;SG
Landebahn	Landebahn	N;NOM;FEM;SG
Strumpfhose	Strumpfhose	N;NOM;FEM;SG
treffen	trifft	V;IND;SG;3;PRS
Weiche	Weiche	N;NOM;FEM;SG
Bank	Bank	N;NOM;FEM;SG
gewinnen	gewinnt	V;IND;SG;3;PRS
abladen	laden ab	V;IND;PL;1;PRS
Leberwurst	Leberwurst	N;NOM;FEM;SG
passen	passte	V;SBJV;SG;1;PST
krachen	krachen	V;IND;PL;1;PRS
fühlen	fühl	V;IMP;SG;2
setzen	setzen	V;IND;PL;3;PRS
Haut	Haut	N;NOM;FEM;SG
Buch	Büchern	N;DAT;NEUT;PL
brüllen	brüllt	V;IND;SG;3;PRS
Fluss	Fluss	N;NOM;MASC;SG
landen	landete	V;SBJV;SG;3;PST
Dach	Dach	N;DAT;NEUT;SG
stecken	stecke	V;IND;SG;1;PRS
Früchtchen	Früchtchen	N;NOM;NEUT;SG
Monat	Monaten	N;DAT;MASC;PL
Badewanne	Badewanne	N;GEN;FEM;SG
servieren	servieren	V;IND;PL;3;PRS
heißen	heißen	V;IND;PL;1;PRS
Maus	Mäusen	N;DAT;FEM;PL
Eindringling	Eindringling	N;ACC;MASC;SG
Pfanne	Pfanne	N;GEN;FEM;SG
Hinterkopf	Hinterkopf	N;DAT;MASC;SG
Affäre	Affäre	N;GEN;FEM;SG
Samstag	Samstage	N;DAT;MASC;SG
Turnen	Turnen	N;NOM;NEUT;SG
Haus	Haus	N;NOM;NEUT;SG
wünschen	wünscht	V;IND;SG;3;PRS
Antenne	Antenne	N;NOM;FEM;SG
Forelle	Forelle	N;NOM;FEM;SG
dürfen	darfst	V;IND;SG;2;PRS
Affe	Affe	N;NOM;MASC;SG
Essen	Essen	N;DAT;NEUT;SG
tanzen	tanzt	V;IND;SG;3;PRS
ziehen	ziehst	V;IND;SG;2;PRS
Bagger	Bagger	N;DAT;MASC;SG
mögen	mögen	V;IND;PL;1;PRS
bleiben	bleiben	V;IND;PL;1;PRS
gucken	gucken	V;IND;PL;3;PRS
schenken	schenken	V;IND;PL;3;PRS
Tisch	Tische	N;DAT;MASC;SG
gelingen	gelingt	V;IND;SG;3;PRS
Fahrrad	Fahrrade	N;DAT;NEUT;SG
bestreichen	bestreiche	V;IND;SG;1;PRS
Milchflasche	Milchflasche	N;NOM;FEM;SG
lassen	lassen	V;IND;PL;1;PRS
lenken	lenken	V;IND;PL;3;PRS
Abgabe	Abgabe	N;NOM;FEM;SG
verstehen	verstehst 	V;IND;SG;2;PRS
werden	wird	V;IND;SG;3;PRS
Ziel	Ziel	N;NOM;NEUT;SG
Hecht	Hecht	N;ACC;MASC;SG
Kuchen	Kuchen	N;ACC;MASC;SG
Abteilung	Abteilung	N;NOM;FEM;SG
Tag	Tag	N;NOM;MASC;SG
ärgern	ärger	V;IND;SG;1;PRS
Aal	Aal	N;NOM;MASC;SG
machen	mache	V;IND;SG;1;PRS
ausreißen	reißen aus	V;IND;PL;3;PRS
