hospital	hospital	N;SG
pee	pee	N;SG
o	o	N;SG
jacket	jacket	N;SG
favorite	favorite	N;SG
eye	eye	N;SG
monkey	monkey	N;SG
bite	bite	N;SG
tapioca	tapioca	N;SG
strength	strength	N;SG
favor	favor	N;SG
jack	jack	N;SG
cone	cone	N;SG
quiet	quiet	V;NFIN
queen	queen	N;SG
ask	asked	V;V.PTCP;PST
switch	switch	V;NFIN
end	end	N;SG
moo	moo	V;NFIN
neck	neck	N;SG
draw	drawing	V;V.PTCP;PRS
scallop	scallop	V;NFIN
movie	movie	N;SG
worm	worm	N;SG
cow	cow	N;SG
tremble	tremble	V;NFIN
follow	following	V;V.PTCP;PRS
here	here	N;SG
fat	fat	N;SG
field	field	N;SG
sing	singing	V;V.PTCP;PRS
catch	catch	V;NFIN
scream	screaming	V;V.PTCP;PRS
pig	pigs	N;PL
rooster	rooster	N;SG
find	found	V;V.PTCP;PST
alphabet	alphabet	N;SG
play	played	V;PST
ship	ship	N;SG
excite	excited	V;PST
sign	sign	V;NFIN
chimney	chimneys	N;PL
bat	bat	N;SG
yum	yum	N;SG
work	working	V;V.PTCP;PRS
today	today	N;SG
pumpkin	pumpkin	N;SG
plumber	plumber	N;SG
pinch	pinch	V;NFIN
pink	pinks	N;PL
nipple	nipple	N;SG
tower	tower	N;SG
state	state	V;NFIN
crib	crib	N;SG
point	point	V;NFIN
pad	pad	V;NFIN
snow	snowing	V;V.PTCP;PRS
need	need	N;SG
shark	shark	N;SG
protect	protect	V;NFIN
fuss	fussing	V;V.PTCP;PRS
save	saving	V;V.PTCP;PRS
worm	worms	N;PL
fetch	fetch	V;NFIN
sneak	sneaked	V;PST
firework	fireworks	N;PL
push	pushed	V;PST
werewolf	werewolf	N;SG
sound	countable	N;PL
farm	farms	N;PL
termite	termite	N;SG
bubble	bubble	V;NFIN
down	down	N;SG
glass	glass	N;SG
save	save	V;NFIN
make	making	V;V.PTCP;PRS
blow	blew	V;PST
magic	magic	N;SG
rattle	rattle	N;SG
swing	swing	V;NFIN
ass	ass	N;SG
safari	safari	N;SG
marble	marble	N;SG
sweat	sweat	V;NFIN
hat	hats	N;PL
tooth	tooth	N;SG
break	break	V;NFIN
fix	fixing	V;V.PTCP;PRS
daddy	daddy	N;SG
dominate	dominate	V;NFIN
help	help	N;SG
wardrobe	wardrobe	N;SG
eat	eating	V;V.PTCP;PRS
half	half	N;SG
spout	spout	N;SG
swim	swim	N;SG
spoon	spoon	V;NFIN
face	face	N;SG
nose	nose	N;SG
stop	stop	N;SG
punch	punch	N;SG
suppose	supposed	V;PST
tie	tie	N;SG
sausage	sausage	N;SG
windmill	windmill	N;SG
effect	effect	N;SG
sleep	slept	V;PST
ribbit	ribbit	V;NFIN
splash	splash	V;NFIN
phonograph	phonograph	N;SG
paint	paint	N;SG
hear	heard	V;PST
feed	feed	V;NFIN
try	trying	V;V.PTCP;PRS
cape	cape	N;SG
dance	dancing	V;V.PTCP;PRS
cockatoo	cockatoos	N;PL
meal	meals	N;PL
pop	pop	V;NFIN
boot	countable	N;PL
decide	decide	V;NFIN
toe	toe	N;SG
whisper	whispering	V;V.PTCP;PRS
take	taking	V;V.PTCP;PRS
bark	bark	N;SG
shoe	shoe	N;SG
panda	panda	N;SG
bounce	bouncing	V;V.PTCP;PRS
shape	shaped	V;V.PTCP;PST
wax	wax	N;SG
lunch	lunch	N;SG
shake	shook	V;PST
catch	caught	V;PST
bed	beds	N;PL
kayak	kayak	N;SG
pompom	pompoms	N;PL
piece	piece	N;SG
ask	ask	V;NFIN
bring	bring	V;NFIN
peek	peek	N;SG
potato	potato	N;SG
think	think	V;NFIN
pretend	pretend	V;NFIN
squeeze	squeeze	N;SG
tv	tv	N;SG
dirt	dirt	N;SG
pool	pool	N;SG
iron	ironing	V;V.PTCP;PRS
acorn	acorn	N;SG
shore	shore	N;SG
bout	bout	N;SG
dog	dog	N;SG
koala	koala	N;SG
picture	picture	N;SG
stool	stool	N;SG
squeak	squeak	N;SG
have	had	V;PST
dish	dishes	N;PL
town	town	N;SG
go	go	V;NFIN
ladder	ladder	N;SG
lightning	lightning	N;SG
pocket	pocket	N;SG
cookbook	cookbook	N;SG
knee	knees	N;PL
wet	wet	V;V.PTCP;PST
use	use	V;NFIN
drive	drive	V;NFIN
bang	bang	V;NFIN
king	king	N;SG
shovel	shovel	N;SG
tank	tank	N;SG
cherry	cherry	N;SG
wolf	wolf	N;SG
poo	poo	N;SG
spring	spring	V;NFIN
feed	feed	N;SG
scare	scare	V;NFIN
data	data	N;SG
candy	countable	N;PL
preschool	preschool	N;SG
gross	gross	N;SG
close	closed	V;V.PTCP;PST
watch	watch	N;SG
pear	pear	N;SG
witch	witch	N;SG
risk	risk	N;SG
nut	nut	N;SG
bee	bee	N;SG
get	got	V;PST
pirate	pirate	N;SG
friend	friend	N;SG
police	police	N;SG
fly	flying	V;V.PTCP;PRS
set	set	V;NFIN
ginger	ginger	N;SG
sack	sacks	N;PL
hog	hog	N;SG
answer	answer	V;NFIN
step	stepped	V;PST
rip	rip	V;NFIN
snap	snap	N;SG
waffle	waffle	N;SG
spoon	spoon	N;SG
bird	birds	N;PL
count	count	V;NFIN
proof	proof	N;SG
look	looking	V;V.PTCP;PRS
throw	throwing	V;V.PTCP;PRS
matey	matey	N;SG
color	coloring	V;V.PTCP;PRS
plop	plop	V;NFIN
decide	decided	V;PST
like	like	V;NFIN
drop	dropping	V;V.PTCP;PRS
roll	roll	V;NFIN
tent	tents	N;PL
kleenex	kleenex	N;SG
story	stories	N;PL
key	keys	N;PL
shoulder	shoulders	N;PL
shake	shaking	V;V.PTCP;PRS
butter	butter	N;SG
sock	socks	N;PL
kitty	kitties	N;PL
wig	wig	N;SG
lab	lab	N;SG
step	step	V;NFIN
point	point	N;SG
dad	dad	N;SG
describe	describe	V;NFIN
clock	clock	N;SG
bite	bite	V;NFIN
plant	plant	N;SG
spend	spend	V;NFIN
bunny	bunny	N;SG
ant	ant	N;SG
ketchup	ketchup	N;SG
hay	hay	N;SG
circle	circling	V;V.PTCP;PRS
corner	corner	N;SG
plan	plan	V;NFIN
wheat	wheat	N;SG
couch	couch	N;SG
scratch	scratch	N;SG
castle	castle	N;SG
close	close	V;NFIN
miss	missed	V;PST
tub	tub	N;SG
note	countable	N;PL
state	state	N;SG
squash	squash	N;SG
jingle	jingle	V;NFIN
knot	knot	N;SG
dump	dump	N;SG
flatten	flatten	V;NFIN
tree	trees	N;PL
tear	tear	V;NFIN
boat	boat	N;SG
mix	mix	V;NFIN
hope	hope	N;SG
triangle	triangle	N;SG
circle	circle	N;SG
match	matching	V;V.PTCP;PRS
owie	owie	N;SG
mammy	mammy	N;SG
square	square	N;SG
stew	stew	N;SG
grow	grow	V;NFIN
touch	touch	V;NFIN
lot	lot	N;SG
seem	seem	V;NFIN
boy	boy	N;SG
peek	peeked	V;PST
sleep	sleeping	V;V.PTCP;PRS
jet	jet	N;SG
snack	snacks	N;PL
pronounce	pronounce	V;NFIN
catch	catching	V;V.PTCP;PRS
vegetarian	vegetarian	N;SG
listen	listened	V;PST
sky	skies	N;PL
momma	momma	N;SG
leather	leather	N;SG
jersey	jersey	N;SG
button	buttons	N;PL
bother	bother	V;NFIN
flower	flower	N;SG
mama	mama	N;SG
bottle	bottle	N;SG
mom	mom	N;SG
keep	keep	N;SG
fix	fixed	V;PST
ouch	ouch	N;SG
mow	mow	N;SG
throw	thrown	V;V.PTCP;PST
bolt	bolt	N;SG
lake	lake	N;SG
thermometer	thermometer	N;SG
still	still	V;NFIN
drip	dripping	V;V.PTCP;PRS
fly	flys	N;PL
excuse	excused	V;V.PTCP;PST
care	care	N;SG
quack	quack	N;SG
have	have	N;SG
monster	monster	N;SG
pull	pull	V;NFIN
crate	crate	N;SG
see	seen	V;V.PTCP;PST
trouble	trouble	N;SG
goose	goose	N;SG
cool	cool	V;NFIN
outside	outside	N;SG
prick	prick	N;SG
clap	clapping	V;V.PTCP;PRS
problem	problem	N;SG
canoe	canoe	N;SG
teach	teaches	N;PL
clown	clown	N;SG
sound	sound	V;NFIN
grandmother	grandmother	N;SG
mess	mess	N;SG
answer	answer	N;SG
cloud	clouds	N;PL
wish	wish	V;NFIN
stuff	stuff	N;SG
climb	climbing	V;V.PTCP;PRS
waffle	waffles	N;PL
dad	dads	N;PL
pour	pour	N;SG
decoration	decoration	N;SG
drill	drill	N;SG
pin	pins	N;PL
hug	hugs	N;PL
time	time	N;SG
grass	grass	N;SG
sentence	sentence	N;SG
apple	apple	N;SG
pick	picked	V;PST
leash	leash	N;SG
button	button	V;NFIN
fall	fall	V;NFIN
dirty	dirty	V;NFIN
garbage	garbage	N;SG
stir	stir	V;NFIN
place	place	N;SG
moan	moaning	V;V.PTCP;PRS
get	get	V;NFIN
stay	stayed	V;PST
find	fand	V;PST
crown	crown	N;SG
fly	flew	V;PST
jeans	jeans	N;SG
stay	staying	V;V.PTCP;PRS
dragon	dragon	N;SG
cook	cooking	V;V.PTCP;PRS
distress	distressed	V;V.PTCP;PST
chipmunk	chipmunks	N;PL
dry	dry	V;NFIN
sort	sort	N;SG
be	been	V;V.PTCP;PST
puppy	puppies	N;PL
elephant	elephant	N;SG
till	till	N;SG
stop	stopped	V;PST
banana	banana	N;SG
bacteria	bacteria	N;SG
meat	meat	N;SG
lion	lion	N;SG
plant	plants	N;PL
shake	shake	V;NFIN
knife	knife	N;SG
fold	fold	V;NFIN
imagine	imagine	V;NFIN
jam	countable	N;PL
leave	leaving	V;V.PTCP;PRS
bang	bang	N;SG
check	check	V;NFIN
bang	banging	V;V.PTCP;PRS
son	son	N;SG
keep	kept	V;PST
recipe	recipe	N;SG
store	store	V;NFIN
day	days	N;PL
father	father	N;SG
might	might	V;NFIN
side	side	N;SG
mouse	mouse	N;SG
toy	toy	V;NFIN
mail	mail	N;SG
kitchen	kitchen	N;SG
koala	koalas	N;PL
hum	hum	N;SG
session	session	N;SG
machine	machine	N;SG
receive	receive	V;NFIN
clean	clean	V;NFIN
worry	worry	V;NFIN
burger	burger	N;SG
string	string	N;SG
amaze	amazed	V;V.PTCP;PST
tool	tool	N;SG
frost	frost	V;NFIN
seesaw	seesaw	N;SG
tomato	tomato	N;SG
lose	lose	V;NFIN
cat	cat	N;SG
prefer	prefer	V;NFIN
supper	supper	N;SG
point	pointing	V;V.PTCP;PRS
telephone	countable	N;PL
accident	accident	N;SG
earth	earth	N;SG
toe	toes	N;PL
foot	foot	N;SG
mitten	mittens	N;PL
wheel	wheel	N;SG
scarf	scarf	N;SG
matter	matter	N;SG
cupcake	cupcake	N;SG
voice	voice	N;SG
happen	happened	V;PST
bell	bell	N;SG
language	language	N;SG
rig	rigging	V;V.PTCP;PRS
beach	beach	N;SG
bore	bored	V;V.PTCP;PST
kid	kids	N;PL
monk	monk	N;SG
sing	sang	V;PST
fall	fell	V;PST
soap	soap	N;SG
rag	rag	N;SG
stand	stand	N;SG
man	man	N;SG
brown	brown	V;NFIN
plate	plates	N;PL
gravel	gravel	N;SG
saw	saw	N;SG
child	child	N;SG
gum	gums	N;PL
light	light	N;SG
recognize	recognize	V;NFIN
table	table	N;SG
finish	finished	V;V.PTCP;PST
buy	buy	N;SG
smell	countable	N;PL
cream	cream	N;SG
think	thinking	V;V.PTCP;PRS
puppet	puppet	N;SG
truck	countable	N;PL
desk	desk	N;SG
throw	throw	V;NFIN
go	gone	V;V.PTCP;PST
minute	minutes	N;PL
swallow	swallow	V;NFIN
pattycake	pattycake	V;NFIN
explain	explain	V;NFIN
friday	friday	N;SG
bubble	bubble	N;SG
hammer	hammering	V;V.PTCP;PRS
dream	dreams	N;PL
island	island	N;SG
stamp	stamp	N;SG
catch	caught	V;V.PTCP;PST
drug	drug	N;SG
helicopter	helicopter	N;SG
scare	scare	N;SG
fork	fork	N;SG
number	number	N;SG
spank	spank	V;NFIN
miss	miss	V;NFIN
leg	legs	N;PL
tick	tick	N;SG
plain	plains	N;PL
clean	cleaned	V;PST
land	land	N;SG
steak	steak	N;SG
feather	feathers	N;PL
play	playing	V;V.PTCP;PRS
homosexual	homosexual	N;SG
fall	falling	V;V.PTCP;PRS
rest	rest	N;SG
rip	ripping	V;V.PTCP;PRS
dish	dish	N;SG
understand	understood	V;PST
party	party	N;SG
art	art	N;SG
seal	seals	N;PL
spider	spider	N;SG
wipe	wipe	V;NFIN
nut	nuts	N;PL
cheat	cheating	V;V.PTCP;PRS
do	doing	V;V.PTCP;PRS
fire	fire	N;SG
drawing	drawing	N;SG
magazine	magazines	N;PL
zip	zip	N;SG
pancake	pancakes	N;PL
make	made	V;PST
whistle	whistled	V;PST
steam	steamed	V;PST
dust	dust	N;SG
cloth	cloth	N;SG
look	look	V;NFIN
purpose	purpose	N;SG
part	parts	N;PL
kitten	kittens	N;PL
leak	leak	N;SG
outdoors	outdoors	N;SG
rope	rope	N;SG
taco	taco	N;SG
kid	kid	N;SG
read	reading	V;V.PTCP;PRS
show	show	N;SG
bless	bless	V;NFIN
fight	fight	N;SG
sky	sky	N;SG
weigh	weighed	V;PST
cut	cut	V;NFIN
murder	murder	N;SG
jack	jack	V;NFIN
wonder	wonder	V;NFIN
meet	met	V;PST
guard	guard	N;SG
lobster	lobster	N;SG
locker	locker	N;SG
poke	poke	V;NFIN
thank	thank	V;NFIN
orchestra	orchestra	N;SG
order	order	N;SG
letter	letters	N;PL
shell	shells	N;PL
punch	punch	V;NFIN
swan	swan	N;SG
let	letting	V;V.PTCP;PRS
principle	principle	N;SG
bean	beans	N;PL
store	store	N;SG
dog	dogs	N;PL
floor	floor	N;SG
marshmallow	marshmallow	N;SG
lily	lily	N;SG
neigh	neigh	V;NFIN
ooh	ooh	V;NFIN
buy	buy	V;NFIN
dance	dance	V;NFIN
onion	onions	N;PL
mud	mud	N;SG
crash	crash	N;SG
freshen	freshened	V;PST
heart	heart	N;SG
frame	frame	N;SG
hypnotize	hypnotizing	V;V.PTCP;PRS
cross	cross	N;SG
cough	coughing	V;V.PTCP;PRS
seem	seemed	V;PST
suit	suit	N;SG
wall	wall	N;SG
peel	peel	V;NFIN
give	giving	V;V.PTCP;PRS
god	god	N;SG
key	key	N;SG
chop	chop	V;NFIN
wait	waited	V;PST
coke	coke	N;SG
drill	drilling	V;V.PTCP;PRS
spell	spell	V;NFIN
weirdo	weirdo	N;SG
upset	upset	V;NFIN
arm	arm	N;SG
while	while	N;SG
structure	structure	N;SG
tissue	tissue	N;SG
excuse	excuse	V;NFIN
chimney	chimney	N;SG
train	train	N;SG
don	don	N;SG
scare	scared	V;V.PTCP;PST
word	word	N;SG
talk	talking	V;V.PTCP;PRS
stand	stand	V;NFIN
fill	fill	V;NFIN
life	life	N;SG
sound	sound	N;SG
stick	sticking	V;V.PTCP;PRS
ease	ease	N;SG
bowl	bowl	N;SG
bean	bean	N;SG
stick	sticked	V;PST
lilac	lilacs	N;PL
cause	caused	V;V.PTCP;PST
star	star	N;SG
suck	suck	N;SG
guy	guy	N;SG
hear	heard	V;V.PTCP;PST
pet	pet	N;SG
kitty	kitty	N;SG
let	let	V;NFIN
go	went	V;PST
pave	paved	V;V.PTCP;PST
sleep	sleep	N;SG
tweet	tweet	V;NFIN
clothing	clothing	N;SG
pudding	pudding	N;SG
beagle	beagle	N;SG
run	ran	V;PST
hope	hope	V;NFIN
puzzle	puzzle	N;SG
ear	ear	N;SG
pouch	pouch	N;SG
thumb	thumb	N;SG
car	cars	N;PL
slide	slide	N;SG
crab	countable	N;PL
hear	hear	V;NFIN
bump	bump	N;SG
wife	wife	N;SG
horse	horse	N;SG
adventure	adventure	N;SG
taxi	taxi	N;SG
secret	secret	N;SG
cry	crying	V;V.PTCP;PRS
broccoli	broccoli	N;SG
cardboard	cardboard	N;SG
shell	shell	V;NFIN
nurse	nurse	N;SG
picture	pictures	N;PL
man	man	V;NFIN
hill	hill	N;SG
doll	doll	N;SG
kite	kite	N;SG
bag	bag	N;SG
cut	cutting	V;V.PTCP;PRS
soup	soup	N;SG
fold	fold	N;SG
study	studied	V;PST
cockatiel	cockatiel	N;SG
jail	jail	N;SG
drop	dropped	V;PST
camera	camera	N;SG
hand	hand	V;NFIN
pardon	pardon	V;NFIN
salami	salami	N;SG
dinosaur	dinosaur	N;SG
sticky	sticky	N;SG
pet	pet	V;NFIN
figure	figure	V;NFIN
pizza	pizza	N;SG
flour	flour	N;SG
plate	plate	N;SG
build	built	V;PST
scramble	scramble	V;NFIN
watch	watch	V;NFIN
hurt	hurt	V;NFIN
interrupt	interrupted	V;PST
apple	apples	N;PL
hop	hop	N;SG
adjust	adjust	V;NFIN
sting	sting	V;NFIN
shoot	shot	V;PST
chase	chasing	V;V.PTCP;PRS
guest	guest	N;SG
cousin	cousin	N;SG
caterpillar	caterpillar	N;SG
sit	sit	V;NFIN
fire	countable	N;PL
screen	screen	N;SG
neighborhood	neighborhood	N;SG
traffic	traffic	N;SG
shade	countable	N;PL
taste	taste	V;NFIN
protein	protein	N;SG
phone	phone	N;SG
scurry	scurried	V;PST
pen	pens	N;PL
medicine	medicine	N;SG
do	do	V;NFIN
obstacle	obstacles	N;PL
woof	woof	V;NFIN
form	form	N;SG
package	package	N;SG
settle	settle	V;NFIN
tractor	tractors	N;PL
juice	juice	N;SG
baby	baby	V;NFIN
moose	moose	N;SG
luck	luck	N;SG
red	red	N;SG
animal	animal	N;SG
dress	dress	N;SG
course	course	N;SG
beef	beef	N;SG
shadow	shadow	N;SG
pull	pulling	V;V.PTCP;PRS
thunder	thunder	N;SG
plush	plush	N;SG
scene	scene	N;SG
sing	sing	V;NFIN
invite	invite	V;NFIN
test	test	N;SG
be	be	V;NFIN
smart	smart	V;NFIN
take	took	V;PST
thing	thing	N;SG
shoot	shoot	N;SG
renovate	renovated	V;V.PTCP;PST
borrow	borrow	V;NFIN
bottom	bottom	N;SG
gem	gem	N;SG
bake	bake	V;NFIN
laugh	laugh	V;NFIN
cat	cats	N;PL
smile	smiled	V;PST
grab	grabbed	V;PST
straight	straight	N;SG
stick	stick	N;SG
operate	operated	V;PST
pretzel	pretzel	N;SG
house	uncountable	N;PL
sleep	sleep	V;NFIN
tip	tip	V;NFIN
wiggle	wiggle	N;SG
erase	erase	N;SG
bring	brought	V;PST
race	race	N;SG
path	path	N;SG
snake	snake	N;SG
ball	ball	N;SG
train	train	V;NFIN
eye	eye	V;NFIN
wrong	wrong	V;NFIN
bunch	bunch	N;SG
dig	digging	V;V.PTCP;PRS
hug	hug	N;SG
slide	sliding	V;V.PTCP;PRS
pet	pets	N;PL
wear	wearing	V;V.PTCP;PRS
alligator	alligator	N;SG
bone	bone	N;SG
write	write	V;NFIN
olive	olive	N;SG
gobble	gobble	V;NFIN
toucan	toucan	N;SG
tie	tying	V;V.PTCP;PRS
calf	calf	N;SG
tunnel	tunnel	N;SG
match	matched	V;PST
corn	corn	N;SG
rock	rock	N;SG
work	countable	N;PL
love	love	V;NFIN
magnet	magnet	N;SG
want	wanted	V;V.PTCP;PST
tie	tie	V;NFIN
record	records	N;PL
hide	hiding	V;V.PTCP;PRS
gym	gym	N;SG
free	freed	V;V.PTCP;PST
rib	ribs	N;PL
jello	jello	N;SG
dip	dip	V;NFIN
day	day	N;SG
grape	grape	N;SG
barrel	barrel	N;SG
pipe	pipe	N;SG
shape	shape	N;SG
case	case	N;SG
chin	chin	N;SG
piece	pieces	N;PL
golf	golf	N;SG
carousel	carousel	N;SG
mushroom	mushroom	N;SG
present	presents	N;PL
brush	brush	V;NFIN
give	give	V;NFIN
bridge	bridge	N;SG
live	living	V;V.PTCP;PRS
way	way	N;SG
man	men	N;PL
sea	sea	N;SG
jam	jam	N;SG
learn	learning	V;V.PTCP;PRS
popsicle	popsicle	N;SG
dresser	dresser	N;SG
got	got	V;NFIN
rock	rock	V;NFIN
give	gave	V;PST
turn	turn	N;SG
fence	fence	N;SG
time	countable	N;PL
forest	forest	N;SG
line	line	N;SG
lace	countable	N;PL
milk	milk	V;NFIN
drawbridge	drawbridge	N;SG
borrow	borrowed	V;V.PTCP;PST
marshmallow	marshmallows	N;PL
press	press	V;NFIN
cake	cake	N;SG
toilet	toilet	N;SG
vegetable	vegetable	N;SG
water	water	N;SG
towel	towel	N;SG
should	should	V;NFIN
note	note	N;SG
tell	told	V;PST
cow	cows	N;PL
bug	bugging	V;V.PTCP;PRS
frisbee	frisbee	N;SG
swim	swimming	V;V.PTCP;PRS
tongue	tongue	N;SG
rinse	rinse	V;NFIN
purse	purse	N;SG
husband	husband	N;SG
world	world	N;SG
photograph	photographs	N;PL
favorite	favorites	N;PL
branch	branch	N;SG
put	put	V;NFIN
well	well	N;SG
squirrel	squirrel	N;SG
position	positioned	V;PST
stick	stick	V;NFIN
machine	machines	N;PL
cup	cups	N;PL
cracker	cracker	N;SG
kind	kinds	N;PL
calendar	calendar	N;SG
door	doors	N;PL
motorcycle	motorcycle	N;SG
dance	dance	N;SG
sweater	sweaters	N;PL
mat	mat	N;SG
cover	covered	V;V.PTCP;PST
oil	oil	N;SG
wool	wool	N;SG
cry	cried	V;PST
sheet	sheet	N;SG
bend	bend	V;NFIN
refrigerator	refrigerator	N;SG
used	used	V;NFIN
saw	saw	V;NFIN
bounce	bounce	N;SG
prince	prince	N;SG
speed	speed	N;SG
button	button	N;SG
berry	berries	N;PL
telephone	telephone	N;SG
purple	purple	N;SG
control	countable	N;PL
mine	mine	N;SG
set	set	V;V.PTCP;PST
rocket	rocket	N;SG
baba	baba	N;SG
move	moved	V;PST
weasel	weasel	N;SG
arm	arms	N;PL
sheep	sheep	N;SG
airplane	airplane	N;SG
time	time	V;NFIN
morning	morning	N;SG
freeze	freezing	V;V.PTCP;PRS
carpet	carpet	N;SG
stuff	stuffed	V;V.PTCP;PST
hippopotamus	hippopotamus	N;SG
hand	hand	N;SG
measure	measure	N;SG
pony	pony	N;SG
evening	evening	N;SG
vacation	vacation	N;SG
pineapple	pineapple	N;SG
ash	countable	N;PL
alien	aliens	N;PL
hide	hide	N;SG
hang	hang	V;NFIN
reason	reason	N;SG
pot	pot	N;SG
tug	tugging	V;V.PTCP;PRS
bus	buses	N;PL
change	change	V;NFIN
kick	kick	V;NFIN
friend	friends	N;PL
wind	wind	V;NFIN
disco	disco	N;SG
square	squares	N;PL
buttercup	buttercup	N;SG
space	space	N;SG
coffee	coffee	N;SG
write	writing	V;V.PTCP;PRS
lady	lady	N;SG
reindeer	reindeer	N;SG
start	starting	V;V.PTCP;PRS
soccer	soccer	N;SG
roar	roar	N;SG
move	move	N;SG
mix	mixed	V;V.PTCP;PST
bobble	bobble	N;SG
cry	cry	V;NFIN
mop	mop	N;SG
correct	corrected	V;PST
call	call	V;NFIN
drive	countable	N;PL
boost	boost	N;SG
ice	iced	V;V.PTCP;PST
cloud	cloud	N;SG
gut	countable	N;PL
iron	iron	V;NFIN
dump	dump	V;NFIN
climb	climbed	V;PST
organize	organizing	V;V.PTCP;PRS
go	going	V;V.PTCP;PRS
walk	walking	V;V.PTCP;PRS
pin	pinned	V;V.PTCP;PST
bubble	bubbles	N;PL
officer	officer	N;SG
poppy	poppy	N;SG
cabbage	cabbage	N;SG
cottage	cottage	N;SG
situation	situation	N;SG
cockroach	cockroach	N;SG
happen	happening	V;V.PTCP;PRS
sigh	sighed	V;PST
spoon	spoons	N;PL
hat	hat	N;SG
nursery	nursery	N;SG
smile	smiling	V;V.PTCP;PRS
melt	melt	V;NFIN
lick	licked	V;PST
wire	countable	N;PL
bouncer	bouncer	N;SG
orange	orange	N;SG
stiff	stiff	N;SG
whoop	whoop	N;SG
jump	jump	V;NFIN
shoe	shoes	N;PL
tire	tired	V;PST
rooster	roosters	N;PL
climb	climb	V;NFIN
dream	dream	V;NFIN
yell	yelled	V;PST
call	call	N;SG
percussion	percussion	N;SG
dose	dose	N;SG
microphone	microphone	N;SG
ball	countable	N;PL
part	part	V;NFIN
fur	fur	N;SG
section	section	N;SG
dig	dig	V;NFIN
surprise	surprised	V;V.PTCP;PST
mix	mixing	V;V.PTCP;PRS
put	putting	V;V.PTCP;PRS
board	board	N;SG
bank	bank	N;SG
record	record	N;SG
quiet	quiet	N;SG
sail	sail	V;NFIN
cook	cook	V;NFIN
hang	hang	N;SG
stuff	stuffed	V;PST
please	please	V;NFIN
belong	belong	V;NFIN
sandwich	sandwich	N;SG
story	story	N;SG
eucalyptus	eucalyptus	N;SG
dress	dressed	V;PST
cut	countable	N;PL
glow	glow	N;SG
herd	herd	N;SG
basement	basement	N;SG
look	looked	V;PST
wash	wash	V;NFIN
mom	mom	V;NFIN
rice	rice	N;SG
musician	musicians	N;PL
present	present	N;SG
shampoo	shampoo	N;SG
sit	sitting	V;V.PTCP;PRS
year	years	N;PL
attach	attached	V;V.PTCP;PST
break	broken	V;V.PTCP;PST
sock	sock	N;SG
pass	passed	V;V.PTCP;PST
mouse	mice	N;PL
build	building	V;V.PTCP;PRS
gum	gum	N;SG
hatch	hatching	V;V.PTCP;PRS
beginning	beginning	N;SG
breeze	breeze	N;SG
cord	cord	N;SG
come	came	V;PST
chunk	chunks	N;PL
flavor	flavor	N;SG
tulip	tulips	N;PL
summer	summer	N;SG
lighten	lighten	V;NFIN
sneaker	sneakers	N;PL
send	send	V;NFIN
colander	colander	N;SG
hide	hide	V;NFIN
journey	journey	N;SG
look	look	N;SG
know	know	V;NFIN
bake	baking	V;V.PTCP;PRS
job	job	N;SG
calendar	calendars	N;PL
idea	idea	N;SG
honk	countable	N;PL
clock	clock	V;NFIN
reach	reach	N;SG
ground	ground	N;SG
egg	egg	N;SG
lasagne	lasagne	N;SG
cheerio	cheerio	N;SG
bungee	bungee	N;SG
candy	candy	N;SG
night	night	N;SG
eat	eat	V;NFIN
say	say	V;NFIN
block	blocked	V;PST
extra	extra	N;SG
may	may	V;NFIN
tummy	tummy	N;SG
take	take	V;NFIN
get	got	V;V.PTCP;PST
ear	ears	N;PL
bath	bath	N;SG
helmet	helmet	N;SG
clap	clap	N;SG
smoke	smoke	N;SG
raise	raising	V;V.PTCP;PRS
cookie	cookies	N;PL
cover	cover	N;SG
bury	bury	V;NFIN
wait	waiting	V;V.PTCP;PRS
sweater	sweater	N;SG
leg	leg	N;SG
yogurt	yogurt	N;SG
call	called	V;PST
bear	bear	N;SG
trip	trip	N;SG
year	year	N;SG
stone	stone	N;SG
snack	snack	N;SG
game	game	N;SG
leave	leaved	V;V.PTCP;PST
no	no	N;SG
tell	told	V;V.PTCP;PST
pink	pink	N;SG
chicken	countable	N;PL
cook	cooked	V;PST
talk	talk	V;NFIN
play	play	N;SG
stretch	stretching	V;V.PTCP;PRS
race	race	V;NFIN
spinach	spinach	N;SG
sip	sip	N;SG
believe	believe	V;NFIN
motor	motor	N;SG
rip	ripped	V;PST
find	find	V;NFIN
dream	dreamed	V;PST
play	played	V;V.PTCP;PST
scream	scream	V;NFIN
vanilla	vanilla	N;SG
pasta	pasta	N;SG
spit	spit	V;NFIN
grandma	grandmas	N;PL
celery	celery	N;SG
mistake	mistake	N;SG
tickle	tickle	V;NFIN
serve	serve	V;NFIN
grape	countable	N;PL
shave	shaved	V;V.PTCP;PST
scream	screamed	V;V.PTCP;PST
gun	gun	N;SG
group	groups	N;PL
clementine	clementine	N;SG
chicken	chicken	N;SG
stick	sticked	V;V.PTCP;PST
skirt	skirt	N;SG
fall	fall	N;SG
cereal	cereal	N;SG
low	low	N;SG
woman	woman	N;SG
sew	sewing	V;V.PTCP;PRS
duty	duty	N;SG
toast	toast	N;SG
jar	jar	N;SG
principal	principal	N;SG
chain	chain	N;SG
pan	pan	N;SG
fun	fun	N;SG
scramble	scrambled	V;V.PTCP;PST
bet	bet	V;NFIN
please	pleased	V;V.PTCP;PST
step	steps	N;PL
will	will	V;NFIN
bandaid	bandaid	N;SG
mirror	mirror	N;SG
stripe	stripe	N;SG
head	head	N;SG
raccoon	raccoon	N;SG
spot	spot	N;SG
swing	swing	N;SG
try	try	V;NFIN
bran	bran	N;SG
hurt	hurt	V;V.PTCP;PST
wallet	wallet	N;SG
ride	riding	V;V.PTCP;PRS
bear	bears	N;PL
pardon	pardon	N;SG
igloo	igloo	N;SG
hole	hole	N;SG
shirt	shirt	N;SG
use	using	V;V.PTCP;PRS
home	home	N;SG
stop	stop	V;NFIN
put	put	V;V.PTCP;PST
bone	bones	N;PL
miss	miss	N;SG
chip	chips	N;PL
kindergartener	kindergartener	N;SG
alarm	alarm	N;SG
indian	indian	N;SG
devil	devils	N;PL
practice	practicing	V;V.PTCP;PRS
pancake	pancake	N;SG
treat	treat	N;SG
quarter	quarter	N;SG
cross	cross	V;NFIN
name	names	N;PL
close	closed	V;PST
surf	surfing	V;V.PTCP;PRS
shut	shut	V;NFIN
bead	beads	N;PL
funnel	funnel	N;SG
promise	promise	V;NFIN
shock	shock	N;SG
watch	watches	N;PL
car	car	N;SG
stand	standing	V;V.PTCP;PRS
snake	snakes	N;PL
step	step	N;SG
fix	fix	V;NFIN
bathe	bathing	V;V.PTCP;PRS
feller	feller	N;SG
name	named	V;V.PTCP;PST
drive	drave	V;PST
walk	walked	V;PST
person	person	N;SG
park	park	N;SG
seed	seed	N;SG
ceiling	ceiling	N;SG
underarm	underarm	V;NFIN
minute	minute	N;SG
basket	basket	N;SG
salt	salt	N;SG
yokey_pokey	yokey_pokey	N;SG
pop	pop	N;SG
bill	bills	N;PL
swim	swim	V;NFIN
absorb	absorb	V;NFIN
one	ones	N;PL
argue	arguing	V;V.PTCP;PRS
junior	junior	N;SG
backside	backside	N;SG
bed	bed	N;SG
farm	farm	N;SG
pad	pad	N;SG
string	countable	N;PL
pilot	pilot	N;SG
book	book	N;SG
surprise	surprise	N;SG
love	loved	V;PST
rub	rub	V;NFIN
dark	dark	N;SG
video	video	N;SG
tag	tag	N;SG
clunk	clunk	V;NFIN
song	song	N;SG
load	loading	V;V.PTCP;PRS
fast	fast	N;SG
puppy	puppy	N;SG
seamstress	seamstress	N;SG
musketeer	musketeer	N;SG
dinner	dinner	N;SG
session	sessions	N;PL
trunk	trunk	N;SG
miss	missing	V;V.PTCP;PRS
jump	jumping	V;V.PTCP;PRS
water	watering	V;V.PTCP;PRS
lose	lost	V;V.PTCP;PST
gate	gate	N;SG
whale	whale	N;SG
add	add	V;NFIN
nurse	nurse	V;NFIN
sock	sock	V;NFIN
sister	sister	N;SG
doctor	doctor	N;SG
macaroni	macaroni	N;SG
lizard	lizard	N;SG
get	getting	V;V.PTCP;PRS
drop	drop	V;NFIN
suppose	supposed	V;V.PTCP;PST
chef	chef	N;SG
fly	fly	V;NFIN
knee	knee	N;SG
closet	closet	N;SG
baby	baby	N;SG
untest	untest	V;NFIN
fry	fries	N;PL
bucket	bucket	N;SG
sink	sink	N;SG
period	period	N;SG
figure	figured	V;PST
bog	bog	N;SG
power	power	N;SG
excite	exciting	V;V.PTCP;PRS
flipper	flippers	N;PL
bonk	bonk	N;SG
shark	sharks	N;PL
tumble	tumble	N;SG
doll	dolls	N;PL
disguise	disguised	V;PST
crawl	crawl	V;NFIN
say	said	V;PST
bus	bus	N;SG
dine	dining	V;V.PTCP;PRS
letter	letter	N;SG
come	coming	V;V.PTCP;PRS
wrong	wrong	N;SG
interest	interested	V;V.PTCP;PST
bunny	bunnies	N;PL
mall	mall	N;SG
smell	smell	V;NFIN
fish	fish	N;SG
seal	seal	N;SG
brother	brother	N;SG
tell	telling	V;V.PTCP;PRS
zoom	zoom	V;NFIN
gas	gas	N;SG
shell	shell	N;SG
stink	stink	N;SG
dazzle	dazzle	V;NFIN
use	used	V;V.PTCP;PST
tray	tray	N;SG
money	money	N;SG
giraffe	giraffe	N;SG
umbrella	umbrella	N;SG
stair	stairs	N;PL
bum	bum	N;SG
wire	wiring	V;V.PTCP;PRS
cause	cause	N;SG
dog	dog	V;NFIN
hold	hold	V;NFIN
week	weeks	N;PL
grandpa	grandpa	N;SG
skip	skipped	V;PST
cookie	cookie	N;SG
smile	smile	N;SG
forget	forgat	V;PST
shame	shame	N;SG
school	school	N;SG
duck	duck	N;SG
mind	mind	N;SG
close	close	N;SG
turn	turning	V;V.PTCP;PRS
marigold	marigold	N;SG
notice	noticed	V;V.PTCP;PST
tea	tea	N;SG
maam	maam	N;SG
ride	ride	V;NFIN
frustrate	frustrating	V;V.PTCP;PRS
skull	skull	N;SG
bar	countable	N;PL
servant	servant	N;SG
fact	fact	N;SG
tickle	tickling	V;V.PTCP;PRS
blueberry	blueberry	N;SG
kiss	kiss	N;SG
stall	stalled	V;PST
lie	lie	V;NFIN
page	page	N;SG
grandma	grandma	N;SG
pile	pile	V;NFIN
part	part	N;SG
tape	tape	N;SG
skunk	skunk	N;SG
dust	dusted	V;PST
swing	swinging	V;V.PTCP;PRS
director	director	N;SG
vase	vase	N;SG
otter	otters	N;PL
rain	rain	N;SG
sandal	sandals	N;PL
hour	hour	N;SG
pie	pie	N;SG
straw	straw	N;SG
ocean	ocean	N;SG
stand	stood	V;PST
follow	follow	V;NFIN
cocoon	cocoon	N;SG
pencil	pencil	N;SG
john	john	N;SG
throw	threw	V;PST
have	having	V;V.PTCP;PRS
cast	cast	V;NFIN
grade	grade	N;SG
hair	hair	N;SG
turn	turn	V;NFIN
plant	plant	V;NFIN
pair	pair	N;SG
volcano	volcano	N;SG
front	front	N;SG
lettuce	lettuce	N;SG
spray	spraying	V;V.PTCP;PRS
last	last	N;SG
class	class	N;SG
wood	wood	N;SG
dough	dough	N;SG
hydrant	hydrant	N;SG
move	moves	N;PL
shoo	shoo	V;NFIN
alien	alien	N;SG
hook	hook	N;SG
stomachache	stomachache	N;SG
loosen	loosen	V;NFIN
lap	lap	N;SG
feel	felt	V;PST
nappie	nappie	N;SG
shed	shed	N;SG
meow	meow	V;NFIN
jump	jump	N;SG
litter	littered	V;V.PTCP;PST
hump	humps	N;PL
need	needed	V;PST
stomach	stomach	N;SG
hammer	hammer	N;SG
cup	cup	N;SG
pile	pile	N;SG
vacuum	vacuum	N;SG
earn	earn	V;NFIN
soda	soda	N;SG
work	work	V;NFIN
fine	fine	N;SG
charge	charge	V;NFIN
screw	screw	N;SG
chirp	chirping	V;V.PTCP;PRS
rabbit	rabbit	N;SG
whole	whole	N;SG
yellow	yellow	N;SG
lay	lay	V;NFIN
clue	clue	N;SG
master	master	N;SG
battery	battery	N;SG
overhang	overhang	V;NFIN
eye	eyes	N;PL
bread	bread	N;SG
hold	hold	N;SG
rejoice	rejoice	V;NFIN
hurt	hurting	V;V.PTCP;PRS
jelly	jelly	N;SG
dollar	dollars	N;PL
clerk	clerk	N;SG
sun	sun	N;SG
pin	pin	N;SG
kind	kind	N;SG
snort	snort	N;SG
goo	goo	N;SG
page	pages	N;PL
engine	engine	N;SG
zebra	zebra	N;SG
vitamin	vitamins	N;PL
come	come	V;NFIN
tricycle	tricycle	N;SG
mouth	mouth	N;SG
pick	pick	V;NFIN
move	move	V;NFIN
fit	fit	V;NFIN
bake	bake	N;SG
deal	deal	N;SG
listen	listen	V;NFIN
play	play	V;NFIN
dinosaur	dinosaurs	N;PL
clap	clap	V;NFIN
grab	grab	V;NFIN
sled	sled	N;SG
tow	tow	N;SG
talk	talk	N;SG
tire	tires	N;PL
lotion	lotion	N;SG
cheese	cheese	N;SG
undo	undo	V;NFIN
artist	artist	N;SG
worry	worrying	V;V.PTCP;PRS
masterpiece	masterpiece	N;SG
parent	parents	N;PL
escape	escape	V;NFIN
moon	moon	N;SG
bib	bib	N;SG
wish	wished	V;PST
pig	pig	N;SG
finger	finger	N;SG
sweep	sweep	N;SG
monkey	monkeys	N;PL
flower	flowers	N;PL
train	trains	N;PL
pack	pack	N;SG
least	least	N;SG
build	build	V;NFIN
forget	forget	V;NFIN
diet	diet	N;SG
wing	wings	N;PL
airport	airport	N;SG
pudding	pudding	V;NFIN
pinch	pinch	N;SG
plastic	plastic	N;SG
open	open	V;NFIN
work	work	N;SG
scratch	scratched	V;PST
milk	milk	N;SG
push	push	V;NFIN
buck	buck	N;SG
match	match	V;NFIN
balloon	balloon	N;SG
band	band	N;SG
flip	flip	V;NFIN
ham	ham	N;SG
cute	cute	N;SG
comb	comb	V;NFIN
loo	loo	N;SG
candle	candle	N;SG
surprise	countable	N;PL
lock	lock	V;NFIN
visit	visit	V;NFIN
maze	maze	N;SG
squeeze	squeeze	V;NFIN
stay	stay	V;NFIN
green	green	N;SG
heaven	heaven	N;SG
happen	happened	V;V.PTCP;PST
pox	pox	N;SG
lasso	lasso	V;NFIN
mustache	mustache	N;SG
temper	temper	N;SG
chop	chops	N;PL
mail	mail	V;NFIN
outfit	outfit	N;SG
start	start	V;NFIN
cold	cold	N;SG
finish	finish	V;NFIN
gear	gear	N;SG
hello	hello	N;SG
shoot	shoot	V;NFIN
ask	asked	V;PST
wave	waving	V;V.PTCP;PRS
tag	tagged	V;PST
nest	nest	N;SG
slug	slugs	N;PL
walk	walks	N;PL
nap	nap	N;SG
buy	bought	V;PST
trailer	trailer	N;SG
moon	moon	V;NFIN
hush	hush	N;SG
owl	owl	N;SG
spot	spots	N;PL
record	recording	V;V.PTCP;PRS
raisin	raisins	N;PL
question	question	N;SG
insight	insight	N;SG
peek	peeking	V;V.PTCP;PRS
door	door	N;SG
vegetable	vegetables	N;PL
hippo	hippo	N;SG
office	office	N;SG
guess	guess	N;SG
draw	drew	V;PST
clay	clay	N;SG
steal	steal	V;NFIN
run	run	V;NFIN
remember	remember	V;NFIN
pea	peas	N;PL
safe	safe	N;SG
stare	stared	V;PST
duckling	duckling	N;SG
fit	fit	V;V.PTCP;PST
engineer	engineer	N;SG
doctor	doctors	N;PL
frog	frogs	N;PL
middle	middle	N;SG
sprinkle	sprinkle	N;SG
squeal	squealed	V;PST
wipe	wipe	N;SG
rug	rug	N;SG
lock	locked	V;V.PTCP;PST
taste	taste	N;SG
rhino	rhino	N;SG
chop	chop	N;SG
hockey	hockey	N;SG
color	color	V;NFIN
cave	cave	N;SG
jungle	jungle	N;SG
daddy	daddies	N;PL
size	size	N;SG
bring	bringing	V;V.PTCP;PRS
have	have	V;NFIN
air	air	N;SG
share	share	V;NFIN
bug	bug	N;SG
snap	snap	V;NFIN
paddle	paddling	V;V.PTCP;PRS
miss	missed	V;V.PTCP;PST
like	liked	V;PST
back	back	N;SG
tinker	tinker	N;SG
garden	garden	N;SG
cross	crossing	V;V.PTCP;PRS
sprout	sprout	V;NFIN
live	live	V;NFIN
napkin	napkins	N;PL
name	name	N;SG
glove	gloves	N;PL
food	food	N;SG
ax	ax	N;SG
mother	mother	N;SG
sort	sort	V;NFIN
drink	drink	V;NFIN
kneel	kneeling	V;V.PTCP;PRS
have	had	V;V.PTCP;PST
die	died	V;PST
wash	washing	V;V.PTCP;PRS
trash	trash	N;SG
wedding	wedding	N;SG
bird	bird	N;SG
silver	silver	N;SG
voice	voices	N;PL
bumble	bumble	V;NFIN
poison	poison	N;SG
want	want	V;NFIN
color	color	N;SG
make	made	V;V.PTCP;PST
erase	erase	V;NFIN
span	span	N;SG
bound	bound	N;SG
teach	taught	V;V.PTCP;PST
nobody	nobody	N;SG
caboose	caboose	N;SG
chocolate	chocolate	N;SG
start	started	V;PST
final	final	N;SG
shop	shopping	V;V.PTCP;PRS
fruit	fruit	N;SG
doo	doo	N;SG
girl	girl	N;SG
body	body	N;SG
meet	meet	V;NFIN
beat	beat	N;SG
truck	truck	N;SG
hit	hit	V;NFIN
ant	ants	N;PL
see	seeing	V;V.PTCP;PRS
keep	keep	V;NFIN
see	saw	V;PST
thing	things	N;PL
move	moving	V;V.PTCP;PRS
maple	maple	N;SG
scratch	scratch	V;NFIN
magazine	magazine	N;SG
boo	boo	N;SG
break	broke	V;PST
helmet	helmets	N;PL
let	let	V;V.PTCP;PST
squash	squash	V;NFIN
blood	blood	N;SG
pear	pears	N;PL
realize	realized	V;PST
bracelet	bracelet	N;SG
diaper	diaper	N;SG
slice	slice	N;SG
pitcher	pitcher	N;SG
mountain	mountain	N;SG
win	won	V;PST
game	countable	N;PL
yell	yelled	V;V.PTCP;PST
whisper	whispered	V;PST
right	right	N;SG
interest	interested	V;PST
pass	pass	N;SG
busy	busy	V;NFIN
orange	countable	N;PL
lollipop	lollipop	N;SG
duck	countable	N;PL
help	help	V;NFIN
cause	cause	V;NFIN
scrapbook	scrapbook	N;SG
move	moved	V;V.PTCP;PST
