bonk	bonk	N;SG
wire	countable	N;PL
blue	blue	N;SG
toe	toe	N;SG
ride	ride	V;NFIN
drop	drop	N;SG
child	child	N;SG
wallet	wallet	N;SG
miss	missing	V;V.PTCP;PRS
fart	fart	N;SG
kneel	kneel	V;NFIN
start	start	V;NFIN
stuff	stuffed	V;V.PTCP;PST
pear	pears	N;PL
hello	hello	N;SG
flour	flour	N;SG
lightning	lightning	N;SG
gun	guns	N;PL
least	least	N;SG
snap	snap	V;NFIN
bat	bat	N;SG
today	today	N;SG
sleeve	sleeve	N;SG
period	period	N;SG
dance	dance	N;SG
stand	stood	V;PST
down	down	N;SG
love	love	N;SG
mamma	mamma	N;SG
center	center	N;SG
bubble	bubble	V;NFIN
telephone	telephone	N;SG
kind	kind	N;SG
year	year	N;SG
allow	allowed	V;V.PTCP;PST
quack	quack	N;SG
bubble	bubbles	N;PL
coffee	coffee	N;SG
laugh	laughing	V;V.PTCP;PRS
dog	dog	N;SG
table	table	N;SG
clerk	clerk	N;SG
hamburger	hamburger	N;SG
skirt	skirt	N;SG
earth	earth	N;SG
skate	skate	N;SG
compute	compute	N;SG
pop	pop	V;NFIN
nightie	nightie	N;SG
choke	choking	V;V.PTCP;PRS
soap	soap	N;SG
clay	clay	N;SG
drop	dropped	V;V.PTCP;PST
bush	bushes	N;PL
pour	poured	V;PST
show	showing	V;V.PTCP;PRS
interest	interested	V;V.PTCP;PST
interest	interest	N;SG
cancel	canceling	V;V.PTCP;PRS
while	while	N;SG
guess	guess	V;NFIN
work	work	N;SG
party	party	N;SG
comedy	comedy	N;SG
boo	boo	N;SG
cab	cab	N;SG
graham	graham	N;SG
rabbit	rabbit	N;SG
store	store	N;SG
hay	hay	N;SG
sort	sort	N;SG
boo	boo	V;NFIN
hole	holes	N;PL
frosting	frosting	N;SG
pretzel	pretzels	N;PL
look	looking	V;V.PTCP;PRS
seamstress	seamstress	N;SG
butter	butter	N;SG
beam	beam	N;SG
hop	hop	N;SG
collar	collar	N;SG
boot	countable	N;PL
chase	chase	N;SG
shoot	shot	V;PST
lower	lower	V;NFIN
jack	jack	N;SG
have	have	V;NFIN
gasp	gasped	V;PST
color	color	V;NFIN
wag	wag	V;NFIN
lock	lock	V;NFIN
found	found	V;NFIN
pressure	pressure	N;SG
student	students	N;PL
want	wanted	V;V.PTCP;PST
put	put	V;NFIN
squash	squash	V;NFIN
wake	woke	V;PST
army	army	N;SG
sail	sailed	V;PST
sound	sound	V;NFIN
sausage	sausage	N;SG
chew	chewing	V;V.PTCP;PRS
finish	finish	V;NFIN
couple	couple	N;SG
heat	heat	V;NFIN
bee	bees	N;PL
rodeo	rodeo	N;SG
gun	gun	N;SG
guy	guys	N;PL
wait	waiting	V;V.PTCP;PRS
prize	prizes	N;PL
seek	seek	V;NFIN
brown	brown	V;NFIN
go	go	V;NFIN
compare	compared	V;PST
blue	countable	N;PL
nurse	nurse	V;NFIN
syrup	syrup	N;SG
circus	circus	N;SG
sock	sock	N;SG
pay	paid	V;PST
pin	pin	V;NFIN
help	help	V;NFIN
answer	answer	V;NFIN
couch	couch	N;SG
lift	lift	V;NFIN
wrap	wrap	V;NFIN
crumple	crumpled	V;PST
tickle	tickle	V;NFIN
spell	spell	V;NFIN
stop	stopped	V;PST
apple	apple	N;SG
place	places	N;PL
daughter	daughter	N;SG
job	job	N;SG
valentine	valentine	N;SG
noise	noise	N;SG
swing	swinging	V;V.PTCP;PRS
monday	monday	N;SG
teach	teach	N;SG
fern	ferns	N;PL
saw	saw	V;NFIN
ache	ache	N;SG
shoe	shoes	N;PL
toddle	toddle	N;SG
middle	middle	N;SG
roll	roll	N;SG
right	right	N;SG
have	having	V;V.PTCP;PRS
hurt	hurt	V;NFIN
keep	keep	V;NFIN
cracker	cracker	N;SG
fly	flew	V;PST
fan	fan	N;SG
wave	waves	N;PL
add	add	V;NFIN
toy	toys	N;PL
like	like	V;NFIN
kangaroo	kangaroos	N;PL
peel	peel	N;SG
lime	lime	N;SG
grandma	grandma	N;SG
matter	matter	V;NFIN
park	park	N;SG
can	can	N;SG
few	few	N;SG
cousin	cousin	N;SG
dress	dressed	V;V.PTCP;PST
mirror	mirror	N;SG
needle	needle	N;SG
recognize	recognize	V;NFIN
tip	tip	N;SG
octopus	octopus	N;SG
game	game	N;SG
imagination	imagination	N;SG
charge	charge	V;NFIN
time	time	N;SG
cereal	cereal	N;SG
return	returned	V;PST
word	word	N;SG
snatch	snatch	V;NFIN
bottom	bottom	N;SG
tie	tying	V;V.PTCP;PRS
well	well	N;SG
call	called	V;PST
sky	sky	N;SG
bed	bed	N;SG
lady	lady	N;SG
mask	mask	N;SG
poke	poke	V;NFIN
day	day	N;SG
sponge	sponged	V;PST
kill	kill	N;SG
leg	leg	N;SG
go	gone	V;V.PTCP;PST
maam	maam	N;SG
bed	beds	N;PL
sword	sword	N;SG
foresight	foresight	N;SG
piece	piece	N;SG
bridge	bridge	N;SG
cigarette	cigarettes	N;PL
dance	dance	V;NFIN
trunk	trunks	N;PL
cuckoo	cuckoo	N;SG
whistle	whistle	N;SG
see	see	V;NFIN
wall	walls	N;PL
rattle	rattle	N;SG
loop	loop	N;SG
rescue	rescue	N;SG
draw	draw	V;NFIN
fry	fries	N;PL
yell	yelled	V;PST
life	life	N;SG
sound	sounded	V;PST
twinkle	twinkle	N;SG
burn	burn	V;NFIN
dirty	dirty	V;NFIN
bake	bake	V;NFIN
scratch	scratch	V;NFIN
tell	told	V;PST
nut	nut	N;SG
love	uncountable	N;PL
leave	leaved	V;V.PTCP;PST
spring	spring	N;SG
mix	mix	V;NFIN
cup	cup	V;NFIN
lemonade	lemonade	N;SG
bush	bush	N;SG
dust	dusting	V;V.PTCP;PRS
spread	spread	V;NFIN
egg	egg	N;SG
even	even	V;NFIN
berry	berries	N;PL
turn	turn	N;SG
corner	corner	N;SG
patient	patient	N;SG
smush	smushing	V;V.PTCP;PRS
idea	idea	N;SG
coke	coke	N;SG
push	countable	N;PL
tree	trees	N;PL
pop	popped	V;V.PTCP;PST
bear	bear	N;SG
extra	extra	N;SG
kiss	kiss	V;NFIN
chip	chip	N;SG
replace	replace	V;NFIN
aunt	aunt	N;SG
fake	faking	V;V.PTCP;PRS
ride	ride	N;SG
boogie	boogie	N;SG
stand	standing	V;V.PTCP;PRS
broccoli	broccoli	N;SG
invention	invention	N;SG
begin	begin	V;NFIN
hummus	hummus	N;SG
disappear	disappeared	V;V.PTCP;PST
transmit	transmit	N;SG
pay	pay	V;NFIN
frog	frog	N;SG
vacation	vacation	N;SG
book	book	N;SG
kill	kill	V;NFIN
curl	curls	N;PL
leaf	leaf	N;SG
bead	beads	N;PL
shine	shining	V;V.PTCP;PRS
record	record	N;SG
bread	bread	N;SG
personal	personal	N;SG
pirate	pirate	N;SG
cry	cry	V;NFIN
scooter	scooter	N;SG
trim	trim	V;NFIN
stomp	stomp	V;NFIN
need	needed	V;PST
egg	eggs	N;PL
snow	snow	V;NFIN
dish	dishes	N;PL
stop	stop	V;NFIN
accident	accident	N;SG
must	must	V;NFIN
cheer	cheer	V;NFIN
cough	coughing	V;V.PTCP;PRS
carve	carved	V;PST
dot	dots	N;PL
car	car	N;SG
tool	tools	N;PL
cake	cake	N;SG
name	name	N;SG
pepper	pepper	N;SG
witch	witch	N;SG
woo	woo	V;NFIN
animal	animal	N;SG
unlock	unlock	V;NFIN
complete	complete	V;NFIN
pull	pulled	V;PST
pooey	pooey	N;SG
talk	talking	V;V.PTCP;PRS
stool	stool	N;SG
plane	plane	N;SG
scrape	scrape	V;NFIN
fish	fish	N;SG
pair	pair	N;SG
treat	treating	V;V.PTCP;PRS
change	changed	V;V.PTCP;PST
wrong	wrong	N;SG
phony	phony	N;SG
boss	boss	N;SG
reason	reason	N;SG
front	front	N;SG
alien	aliens	N;PL
true	true	V;NFIN
duck	countable	N;PL
reach	reached	V;PST
interest	interest	V;NFIN
worry	worry	V;NFIN
forget	forgat	V;PST
crowd	crowd	N;SG
movie	movie	N;SG
smoke	smoke	N;SG
fascinate	fascinated	V;V.PTCP;PST
cream	cream	N;SG
screw	screws	N;PL
glass	glass	N;SG
imagine	imagine	N;SG
devil	devil	N;SG
home	home	N;SG
flee	fled	V;PST
throw	throw	V;NFIN
mason	mason	N;SG
gas	gas	N;SG
tape	tape	N;SG
coop	coop	N;SG
god	god	N;SG
ball	ball	N;SG
note	countable	N;PL
tissue	tissue	N;SG
find	find	V;NFIN
damage	damage	N;SG
pan	pan	N;SG
hug	hug	N;SG
tricycle	tricycle	N;SG
jewelry	jewelry	N;SG
twirl	twirling	V;V.PTCP;PRS
dog	dog	V;NFIN
banana	banana	N;SG
horse	horses	N;PL
tiger	tigers	N;PL
kick	kick	V;NFIN
alligator	alligator	N;SG
reindeer	reindeer	N;SG
o	o	N;SG
mine	mines	N;PL
watch	watch	V;NFIN
cheese	cheese	N;SG
waffle	waffle	N;SG
block	block	V;NFIN
trade	trade	V;NFIN
see	seen	V;V.PTCP;PST
swish	swish	V;NFIN
skin	skin	N;SG
tweet	tweet	V;NFIN
drag	drag	N;SG
afternoon	afternoon	N;SG
bunny	bunny	N;SG
husband	husband	N;SG
chump	chump	N;SG
umbrella	umbrella	N;SG
kiwi	kiwi	N;SG
charge	charge	N;SG
whole	whole	N;SG
yesterday	yesterday	N;SG
duck	duck	N;SG
medium	medium	N;SG
son	son	N;SG
reach	reach	V;NFIN
boat	boat	N;SG
mess	mess	V;NFIN
starfish	starfish	N;SG
favorite	favorite	N;SG
pot	pot	N;SG
paint	paint	V;NFIN
matzo	matzo	N;SG
nurse	nursed	V;PST
grandpa	grandpa	N;SG
shoot	shooting	V;V.PTCP;PRS
phone	phone	N;SG
tickle	tickle	N;SG
lot	lot	N;SG
scoot	scoot	V;NFIN
opportunity	opportunity	N;SG
doctor	doctor	N;SG
station	station	N;SG
welcome	welcome	N;SG
ear	ear	N;SG
stuff	stuffed	V;PST
start	started	V;PST
buy	buy	N;SG
tower	tower	N;SG
prefer	prefer	V;NFIN
knife	knife	N;SG
sign	sign	N;SG
lion	lion	N;SG
fuzz	fuzz	N;SG
place	place	V;NFIN
top	top	N;SG
flag	flag	N;SG
moth	moth	N;SG
effect	effect	N;SG
might	might	N;SG
walk	walk	N;SG
order	order	N;SG
grab	grab	V;NFIN
swallow	swallow	V;NFIN
dream	dreams	N;PL
case	case	N;SG
train	trains	N;PL
stethoscope	stethoscope	N;SG
nurse	nurses	N;PL
sting	stung	V;V.PTCP;PST
clean	clean	V;NFIN
lasagna	lasagna	N;SG
hill	hills	N;PL
forget	forget	V;NFIN
gum	gum	N;SG
heart	heart	N;SG
fork	forks	N;PL
squash	squashed	V;V.PTCP;PST
have	had	V;PST
thing	thing	N;SG
acorn	acorns	N;PL
tap	tapping	V;V.PTCP;PRS
one	ones	N;PL
horse	horse	N;SG
goose	goose	N;SG
bun	bun	N;SG
salt	salt	N;SG
beef	beef	N;SG
ask	asking	V;V.PTCP;PRS
dig	dig	N;SG
need	need	N;SG
fun	fun	N;SG
open	open	V;NFIN
tangle	tangled	V;PST
eat	ate	V;PST
change	changed	V;PST
mush	mush	V;NFIN
scare	scared	V;V.PTCP;PST
lie	lie	N;SG
comb	comb	V;NFIN
burial	burial	N;SG
teach	teach	V;NFIN
shadow	shadow	N;SG
sweater	sweater	N;SG
wonder	wonder	V;NFIN
rub	rub	V;NFIN
garbage	garbage	N;SG
boot	boot	N;SG
stick	countable	N;PL
brave	brave	N;SG
card	countable	N;PL
hop	hopped	V;PST
fish	countable	N;PL
cocoa	cocoa	N;SG
change	change	V;NFIN
hit	hit	V;NFIN
hair	hair	N;SG
cheek	cheek	N;SG
rain	rain	V;NFIN
garage	garage	N;SG
need	need	V;NFIN
night	night	N;SG
consider	considered	V;V.PTCP;PST
fall	falling	V;V.PTCP;PRS
pediatrician	pediatrician	N;SG
bite	bite	V;NFIN
cranium	cranium	N;SG
rosey	rosey	N;SG
seat	seat	N;SG
sing	sing	V;NFIN
switch	switch	N;SG
count	counting	V;V.PTCP;PRS
meet	met	V;PST
back	backs	N;PL
care	care	V;NFIN
love	loved	V;PST
tire	tire	N;SG
panda	panda	N;SG
line	line	N;SG
jacket	jackets	N;PL
tree	tree	N;SG
clean	cleaned	V;V.PTCP;PST
hole	hole	V;NFIN
caboose	caboose	N;SG
tool	tool	N;SG
pig	pigs	N;PL
clarinet	clarinet	N;SG
sacrifice	sacrifice	V;NFIN
crayon	crayons	N;PL
use	use	V;NFIN
gym	gym	N;SG
nail	nail	N;SG
use	used	V;PST
fight	fight	N;SG
tuck	tuck	V;NFIN
sandwich	sandwiches	N;PL
lens	lens	N;SG
flip	flip	V;NFIN
seem	seemed	V;PST
get	got	V;V.PTCP;PST
airplane	airplane	N;SG
put	putting	V;V.PTCP;PRS
doll	doll	N;SG
baseball	baseball	N;SG
ring	rang	V;PST
load	load	N;SG
hall	hall	N;SG
aunt	aunts	N;PL
pink	pink	N;SG
friend	friends	N;PL
do	did	V;PST
bit	bit	N;SG
shape	shaped	V;V.PTCP;PST
whoosh	whoosh	V;NFIN
get	get	V;NFIN
kitty	kitty	N;SG
dump	dumped	V;PST
tv	tv	N;SG
cookie	cookies	N;PL
freeze	frozen	V;V.PTCP;PST
bone	bone	V;NFIN
discuss	discussed	V;PST
fruit	fruit	N;SG
zoom	zoom	V;NFIN
blow	blow	N;SG
guy	guy	N;SG
weather	weather	N;SG
go	went	V;PST
ax	ax	N;SG
rubber	rubber	N;SG
alphabet	alphabet	N;SG
start	starting	V;V.PTCP;PRS
clap	clap	N;SG
yoghurt	yoghurt	N;SG
click	click	N;SG
concentrate	concentrate	V;NFIN
twin	twins	N;PL
thank	thank	V;NFIN
plate	plate	N;SG
bird	bird	N;SG
tire	tired	V;V.PTCP;PST
pour	poured	V;V.PTCP;PST
miss	miss	N;SG
house	house	V;NFIN
tub	tub	N;SG
get	got	V;PST
go	going	V;V.PTCP;PRS
friend	friend	N;SG
unstick	unstuck	V;V.PTCP;PST
lick	lick	V;NFIN
robot	robots	N;PL
separate	separate	V;NFIN
company	company	N;SG
peekaboo	peekaboo	V;NFIN
girl	girl	N;SG
nurse	nurse	N;SG
meow	meow	V;NFIN
sentence	sentence	N;SG
attack	attack	N;SG
shout	shouted	V;PST
fix	fix	V;NFIN
plant	plant	V;NFIN
take	take	V;NFIN
bacon	bacon	N;SG
trunk	trunk	N;SG
cut	cut	N;SG
opposite	opposite	N;SG
fly	fly	N;SG
jello	jello	N;SG
being	being	N;SG
clip	countable	N;PL
ear	ears	N;PL
learn	learn	V;NFIN
pull	pull	V;NFIN
roll	rolls	N;PL
dime	dime	N;SG
wee	wee	N;SG
shut	shut	V;V.PTCP;PST
sell	sell	V;NFIN
climb	climb	V;NFIN
empire	empire	N;SG
diamond	diamond	N;SG
cry	crying	V;V.PTCP;PRS
bring	bring	V;NFIN
ruff	ruff	V;NFIN
wood	countable	N;PL
hop	hop	V;NFIN
hand	hands	N;PL
stone	stone	N;SG
birth	birth	N;SG
sit	sitting	V;V.PTCP;PRS
bounce	bounce	N;SG
ocean	ocean	N;SG
talk	talk	N;SG
walk	walked	V;PST
dinosaur	dinosaur	N;SG
man	man	V;NFIN
clear	clear	V;NFIN
drive	drive	N;SG
lay	lay	V;NFIN
shot	shot	N;SG
close	close	V;NFIN
tunnel	tunnel	N;SG
fourth	fourth	N;SG
eat	eaten	V;V.PTCP;PST
finger	finger	N;SG
bucket	bucket	N;SG
cement	cement	N;SG
milk	milk	N;SG
swing	countable	N;PL
kitten	kitten	N;SG
spider	spider	N;SG
stream	stream	N;SG
sugar	sugar	N;SG
be	been	V;V.PTCP;PST
lid	lid	N;SG
shed	shed	V;NFIN
interact	interacting	V;V.PTCP;PRS
sleep	sleep	N;SG
cloud	cloud	N;SG
junior	junior	N;SG
pumpkin	pumpkin	N;SG
wear	wear	V;NFIN
side	side	N;SG
poo	poo	N;SG
shall	shall	V;NFIN
question	question	N;SG
world	world	N;SG
brig	brig	N;SG
soccer	soccer	N;SG
basement	basement	N;SG
mammal	mammals	N;PL
protect	protect	V;NFIN
breakfast	breakfast	N;SG
wing	wing	N;SG
lose	lost	V;PST
pasture	pasture	N;SG
illustrate	illustrated	V;PST
string	string	N;SG
walrus	walrus	N;SG
cow	cows	N;PL
knock	knocked	V;PST
want	wanted	V;PST
diaper	diaper	N;SG
hook	hook	V;NFIN
hope	hope	N;SG
fall	fall	V;NFIN
shut	shut	V;NFIN
sale	sale	N;SG
preference	preference	N;SG
poppy	poppy	N;SG
pancake	pancakes	N;PL
mouse	mouse	N;SG
make	made	V;V.PTCP;PST
push	push	N;SG
untie	untied	V;V.PTCP;PST
gravy	gravy	N;SG
black	black	N;SG
think	thinking	V;V.PTCP;PRS
marry	married	V;V.PTCP;PST
cat	cats	N;PL
basket	basket	N;SG
squirt	squirting	V;V.PTCP;PRS
microphone	microphone	N;SG
drink	drink	N;SG
stranger	stranger	N;SG
smooch	smooch	N;SG
clap	clap	V;NFIN
shake	shake	N;SG
dig	digging	V;V.PTCP;PRS
squirt	squirt	N;SG
hop	hopped	V;V.PTCP;PST
city	cities	N;PL
love	love	V;NFIN
penguin	penguin	N;SG
goldfish	goldfish	N;SG
baby	baby	V;NFIN
follow	follow	V;NFIN
scuba	scuba	N;SG
cob	cob	N;SG
bride	bride	N;SG
pass	pass	V;NFIN
vitamin	vitamin	N;SG
taste	taste	N;SG
jump	jump	N;SG
horn	horn	N;SG
bell	bell	N;SG
freeze	freeze	N;SG
burn	burning	V;V.PTCP;PRS
barrel	barrel	N;SG
number	number	N;SG
chip	chips	N;PL
satin	satin	N;SG
tattle	tattle	V;NFIN
interest	interested	V;PST
lot	lots	N;PL
truck	countable	N;PL
flat	flat	N;SG
say	said	V;PST
way	ways	N;PL
puzzle	puzzles	N;PL
taco	taco	N;SG
flap	flap	V;NFIN
swing	swing	N;SG
office	office	N;SG
knee	knee	N;SG
hang	hanging	V;V.PTCP;PRS
golf	golf	N;SG
daddy	daddy	N;SG
pin	pin	N;SG
scare	scare	V;NFIN
otter	otter	N;SG
conversation	conversation	N;SG
pumpkin	pumpkins	N;PL
know	know	V;NFIN
muffin	muffins	N;PL
buy	buy	V;NFIN
mail	mail	N;SG
balance	balance	N;SG
window	window	N;SG
hotel	hotel	N;SG
nickel	countable	N;PL
run	running	V;V.PTCP;PRS
drink	drink	V;NFIN
give	gave	V;PST
mountain	mountain	N;SG
button	button	N;SG
masterpiece	masterpiece	N;SG
live	lived	V;PST
eye	eye	N;SG
floor	floor	N;SG
bell	bells	N;PL
cupcake	cupcake	N;SG
pat	patted	V;PST
carpet	carpet	N;SG
soup	soup	N;SG
sleep	sleeping	V;V.PTCP;PRS
frog	frogs	N;PL
work	working	V;V.PTCP;PRS
excuse	excuse	V;NFIN
wagon	wagon	N;SG
goo	goo	N;SG
mustard	mustard	N;SG
cafe	cafe	N;SG
bum	bum	N;SG
tell	tell	V;NFIN
sandwich	sandwich	N;SG
chop	chop	V;NFIN
dad	dads	N;PL
bang	bang	N;SG
cry	cry	N;SG
mother	mother	N;SG
cave	cave	N;SG
purr	purr	V;NFIN
arm	arms	N;PL
cook	cook	N;SG
watch	watching	V;V.PTCP;PRS
teach	taught	V;PST
may	may	V;NFIN
piece	pieces	N;PL
dessert	dessert	N;SG
evening	evening	N;SG
expect	expecting	V;V.PTCP;PRS
lunch	lunch	N;SG
letter	letter	N;SG
officer	officer	N;SG
seem	seem	V;NFIN
dad	dad	N;SG
square	square	N;SG
metal	metal	N;SG
pole	poles	N;PL
share	share	V;NFIN
daddy	daddies	N;PL
card	card	N;SG
throat	throat	N;SG
zip	zip	V;NFIN
work	worked	V;V.PTCP;PST
reach	reach	N;SG
help	help	N;SG
click	click	V;NFIN
flop	flops	N;PL
take	taking	V;V.PTCP;PRS
bunch	bunch	N;SG
sand	sand	N;SG
dinner	dinner	N;SG
cage	cage	N;SG
green	green	N;SG
morning	morning	N;SG
race	race	N;SG
closet	closet	N;SG
bean	beans	N;PL
snow	snow	N;SG
hope	hope	V;NFIN
yard	yard	N;SG
moose	moose	N;SG
dark	dark	N;SG
violin	violin	N;SG
lock	locked	V;V.PTCP;PST
block	block	N;SG
record	recording	V;V.PTCP;PRS
lemon	lemon	N;SG
crack	crack	V;NFIN
everywhere	everywhere	N;SG
buggy	buggy	N;SG
eggnog	eggnog	N;SG
whisper	whispering	V;V.PTCP;PRS
excite	excited	V;V.PTCP;PST
news	news	N;SG
buy	bought	V;PST
sing	sang	V;PST
pet	pet	V;NFIN
mark	mark	N;SG
pillow	pillow	N;SG
hippo	hippo	N;SG
ant	ants	N;PL
broom	broom	N;SG
cooperate	cooperate	V;NFIN
car	cars	N;PL
key	keys	N;PL
beaver	beaver	N;SG
hat	hats	N;PL
bury	bury	V;NFIN
log	log	N;SG
saltine	saltines	N;PL
delivery	delivery	N;SG
till	till	N;SG
manner	manners	N;PL
stick	stick	V;NFIN
swipe	swiping	V;V.PTCP;PRS
blueberry	countable	N;PL
make	make	V;NFIN
bank	bank	N;SG
fry	fry	V;NFIN
stick	sticked	V;PST
shirt	shirt	N;SG
light	countable	N;PL
tweezers	tweezers	N;SG
fossil	fossil	N;SG
sound	countable	N;PL
watch	watch	N;SG
tell	telling	V;V.PTCP;PRS
pile	pile	N;SG
kindergarten	kindergarten	N;SG
sport	sport	V;NFIN
form	formed	V;PST
parent	parents	N;PL
file	file	N;SG
fox	fox	N;SG
fence	countable	N;PL
call	call	V;NFIN
fairy	fairy	N;SG
house	house	N;SG
package	package	N;SG
dry	dry	V;NFIN
bump	bump	N;SG
to	to	V;NFIN
carry	carry	V;NFIN
feed	feed	V;NFIN
cold	cold	N;SG
track	track	N;SG
cool	cool	V;NFIN
slide	slide	V;NFIN
ingredient	ingredients	N;PL
close	closed	V;V.PTCP;PST
dance	countable	N;PL
oil	oil	N;SG
break	broke	V;PST
month	month	N;SG
sandal	sandals	N;PL
drink	drinking	V;V.PTCP;PRS
let	let	V;NFIN
honey	honey	N;SG
discuss	discussing	V;V.PTCP;PRS
stable	stable	N;SG
footprint	footprints	N;PL
garden	garden	N;SG
costume	costume	N;SG
elbow	elbow	N;SG
worm	worms	N;PL
wheel	wheel	N;SG
hammer	hammer	N;SG
salad	salad	N;SG
let	let	V;V.PTCP;PST
shit	shit	N;SG
ring	rings	N;PL
candy	candy	N;SG
barbecue	barbecue	N;SG
secret	secret	N;SG
dune	dune	N;SG
pee	pee	N;SG
stink	stink	N;SG
poop	poop	N;SG
sort	sort	V;NFIN
button	button	V;NFIN
ball	countable	N;PL
fall	fall	N;SG
tea	tea	N;SG
ounce	ounces	N;PL
cash	cash	N;SG
lotion	lotion	N;SG
wipe	wipe	V;NFIN
talk	talked	V;PST
take	took	V;PST
monster	monster	N;SG
buckle	buckle	N;SG
knock	knock	V;NFIN
become	become	V;NFIN
stay	stayed	V;PST
subway	subway	N;SG
beat	beat	N;SG
want	want	V;NFIN
try	try	V;NFIN
borrow	borrow	V;NFIN
caterpillar	caterpillars	N;PL
pull	pulling	V;V.PTCP;PRS
kill	killed	V;V.PTCP;PST
spill	spill	V;NFIN
oatmeal	oatmeal	N;SG
toe	toes	N;PL
plough	plough	N;SG
move	move	N;SG
frisbee	frisbee	N;SG
clown	clown	N;SG
grape	grape	N;SG
elbow	elbows	N;PL
write	write	V;NFIN
drill	drill	N;SG
vitamin	vitamins	N;PL
luck	luck	N;SG
rest	rest	N;SG
consent	consent	N;SG
connect	connected	V;PST
teaspoon	teaspoon	N;SG
hurry	hurry	N;SG
hahaha	hahaha	N;SG
realize	realized	V;PST
saucer	saucer	N;SG
cooperative	cooperative	N;SG
cup	cups	N;PL
rest	rest	V;NFIN
necklace	necklace	N;SG
ask	asked	V;PST
step	step	N;SG
deer	deer	N;SG
turn	turn	V;NFIN
banjo	banjo	N;SG
play	play	V;NFIN
bow	bow	N;SG
give	giving	V;V.PTCP;PRS
chick	chick	N;SG
crawl	crawl	V;NFIN
fold	folding	V;V.PTCP;PRS
bowl	bowl	V;NFIN
moon	moon	N;SG
fill	fill	V;NFIN
tum	tum	N;SG
shampoo	shampoo	N;SG
depend	depend	V;NFIN
jump	jump	V;NFIN
tonic	tonic	N;SG
speak	speak	V;NFIN
plenty	plenty	N;SG
stop	stop	N;SG
bowl	bowl	N;SG
double	double	N;SG
drive	drive	V;NFIN
finish	finished	V;PST
sniff	sniffed	V;PST
squish	squish	V;NFIN
baby	baby	N;SG
touch	touch	V;NFIN
ogre	ogre	N;SG
stay	stay	N;SG
drawer	drawer	N;SG
doll	dolls	N;PL
engine	engine	N;SG
self	self	N;SG
put	put	V;V.PTCP;PST
hook	hook	N;SG
nose	nose	N;SG
hum	hum	N;SG
be	be	V;NFIN
dummy	dummy	N;SG
picture	picture	V;NFIN
read	reading	V;V.PTCP;PRS
food	food	N;SG
suitcase	suitcase	N;SG
drive	driving	V;V.PTCP;PRS
wait	wait	V;NFIN
gulp	gulps	N;PL
prince	prince	N;SG
cracker	crackers	N;PL
cellar	cellar	N;SG
cookie	cookie	N;SG
jacket	jacket	N;SG
untangle	untangle	V;NFIN
ooh	ooh	V;NFIN
stick	stick	N;SG
hang	hanged	V;V.PTCP;PST
fix	fixed	V;PST
village	village	N;SG
machine	machine	N;SG
fly	flys	N;PL
shelf	shelf	N;SG
guard	guard	N;SG
ledge	ledge	N;SG
maple	maple	N;SG
ring	ring	N;SG
wind	wind	V;NFIN
diapie	diapie	N;SG
thank_you	thank_you	N;SG
clean	cleaning	V;V.PTCP;PRS
wax	wax	V;NFIN
buddy	buddy	N;SG
caterpillar	caterpillar	N;SG
hand	hand	N;SG
city	city	N;SG
brush	brush	V;NFIN
mustache	mustache	N;SG
question	questions	N;PL
loosen	loosening	V;V.PTCP;PRS
cherry	cherry	N;SG
used	used	V;NFIN
tone	tone	V;NFIN
patch	patch	N;SG
madam	madam	N;SG
age	age	N;SG
tent	tent	N;SG
plate	plates	N;PL
summer	summer	N;SG
stir	stirring	V;V.PTCP;PRS
sneaker	sneakers	N;PL
blow	blow	V;NFIN
pretend	pretend	V;NFIN
die	died	V;PST
decide	decide	V;NFIN
time	countable	N;PL
moo	moo	V;NFIN
protein	protein	N;SG
shirt	shirts	N;PL
sock	sock	V;NFIN
doctor	doctor	V;NFIN
robot	robot	N;SG
yellow	yellow	N;SG
meat	meat	N;SG
chart	chart	N;SG
penny	pennies	N;PL
count	count	N;SG
bake	baking	V;V.PTCP;PRS
library	library	N;SG
roll	roll	V;NFIN
zebra	zebra	N;SG
find	fand	V;PST
raisin	raisin	N;SG
rice	rice	N;SG
smell	smell	V;NFIN
puppy	puppy	N;SG
chariot	chariot	N;SG
editorial	editorial	N;SG
wander	wandered	V;PST
camera	camera	N;SG
barrette	barrette	N;SG
spin	spinning	V;V.PTCP;PRS
surf	surfing	V;V.PTCP;PRS
koala	koala	N;SG
menu	menu	N;SG
bath	bath	N;SG
drop	dropped	V;PST
soda	soda	N;SG
giraffe	giraffe	N;SG
robin	robins	N;PL
read	read	V;NFIN
believe	believe	V;NFIN
ladder	ladder	N;SG
leap	leap	N;SG
game	countable	N;PL
engineer	engineer	N;SG
figure	figure	V;NFIN
drink	drank	V;PST
corn	corn	N;SG
slice	slice	N;SG
prove	proved	V;PST
hide	hiding	V;V.PTCP;PRS
seal	seal	V;NFIN
pant	pant	V;NFIN
tease	tease	N;SG
waterfall	waterfall	N;SG
tooth	tooth	N;SG
kid	kid	N;SG
yum	yum	N;SG
smile	smile	N;SG
pig	pig	N;SG
uncle	uncle	N;SG
wash	washed	V;PST
fence	fence	N;SG
appoint	appoint	N;SG
still	still	V;NFIN
boy	boy	N;SG
rob	rob	N;SG
punish	punished	V;V.PTCP;PST
worm	worm	N;SG
peek	peek	V;NFIN
bolt	bolt	N;SG
joke	joke	N;SG
play	played	V;V.PTCP;PST
flower	flowers	N;PL
crab	crab	N;SG
thought	thought	N;SG
run	run	V;NFIN
neighbor	neighbors	N;PL
crab	countable	N;PL
fight	fighting	V;V.PTCP;PRS
helmet	helmet	N;SG
dream	dreamed	V;PST
drift	drift	N;SG
throw	throwing	V;V.PTCP;PRS
build	build	V;NFIN
share	sharing	V;V.PTCP;PRS
pour	pour	V;NFIN
kiss	kiss	N;SG
tape	tape	V;NFIN
rat	rat	N;SG
rob	uncountable	N;PL
hide	hide	N;SG
pattycake	pattycake	V;NFIN
yogurt	yogurt	N;SG
bib	bib	N;SG
sit	sit	V;NFIN
make	made	V;PST
train	train	N;SG
die	dying	V;V.PTCP;PRS
purple	purple	N;SG
scream	screamed	V;PST
lace	lace	N;SG
wave	waved	V;PST
make	making	V;V.PTCP;PRS
tiger	tiger	N;SG
date	date	N;SG
jelly	jelly	N;SG
shoulder	shoulder	N;SG
school	school	V;NFIN
tug	tug	N;SG
rain	rain	N;SG
notice	noticed	V;PST
hay	hay	V;NFIN
supper	supper	N;SG
pear	pear	N;SG
grampa	grampa	N;SG
guinea	guinea	N;SG
stir	stir	V;NFIN
bring	brought	V;PST
pound	pound	N;SG
shoot	shoot	V;NFIN
swim	swimming	V;V.PTCP;PRS
sleep	sleep	V;NFIN
pork	pork	N;SG
cub	cub	N;SG
box	boxes	N;PL
elephant	elephant	N;SG
microphone	microphone	V;NFIN
got	got	V;NFIN
snake	snake	N;SG
break	broken	V;V.PTCP;PST
lobster	lobster	N;SG
restaurant	restaurant	N;SG
harry	harry	V;NFIN
light	lighting	V;V.PTCP;PRS
country	country	N;SG
ballet	ballet	N;SG
pitcher	pitcher	N;SG
dream	dream	V;NFIN
sticker	sticker	V;NFIN
momma	momma	N;SG
teddy	teddy	N;SG
woof	woof	V;NFIN
wrestle	wrestling	V;V.PTCP;PRS
elevator	elevator	N;SG
chocolate	chocolate	N;SG
play	played	V;PST
cradle	cradle	N;SG
elevator	elevators	N;PL
stand	stand	N;SG
paint	painting	V;V.PTCP;PRS
whisper	whisper	V;NFIN
block	blocks	N;PL
peel	peel	V;NFIN
eye	eyes	N;PL
cat	cat	N;SG
count	count	V;NFIN
stay	staying	V;V.PTCP;PRS
spoil	spoiled	V;PST
hold	holding	V;V.PTCP;PRS
glove	glove	N;SG
toy	toy	N;SG
wont	wont	N;SG
licorice	licorice	N;SG
cone	cone	N;SG
copy	copy	V;NFIN
cloth	cloth	N;SG
box	box	N;SG
pyramid	pyramid	N;SG
slip	slip	V;NFIN
sing	singing	V;V.PTCP;PRS
mix	mixed	V;V.PTCP;PST
antelope	antelope	N;SG
cliff	cliff	N;SG
wolf	wolf	N;SG
white	white	N;SG
know	knew	V;PST
high	high	N;SG
back	back	V;NFIN
there	there	N;SG
peanut	peanuts	N;PL
airplane	airplanes	N;PL
wish	wish	V;NFIN
school	school	N;SG
deflate	deflated	V;V.PTCP;PST
do	doing	V;V.PTCP;PRS
ready	ready	V;NFIN
mean	mean	V;NFIN
air	air	N;SG
hospital	hospital	N;SG
select	selected	V;V.PTCP;PST
trip	trips	N;PL
log	logs	N;PL
town	town	N;SG
sun	sun	N;SG
palace	palace	N;SG
can	can	V;NFIN
oven	oven	N;SG
land	land	V;NFIN
punch	punch	N;SG
crash	crashed	V;PST
person	person	N;SG
carnival	carnival	N;SG
mix	mix	N;SG
disappear	disappear	V;NFIN
arm	arm	N;SG
creature	creature	N;SG
part	part	N;SG
zoo	zoo	N;SG
stay	stay	V;NFIN
cargo	cargo	N;SG
close	closed	V;PST
concern	concerned	V;V.PTCP;PST
build	building	V;V.PTCP;PRS
ambulance	ambulance	N;SG
tomato	tomato	N;SG
force	force	V;NFIN
sock	socks	N;PL
second	seconds	N;PL
flame	flame	N;SG
bandaid	bandaid	N;SG
chef	chef	N;SG
witch	witches	N;PL
chug	chug	V;NFIN
look	looked	V;PST
bag	bag	N;SG
bottle	bottle	N;SG
safe	safe	N;SG
cost	cost	V;NFIN
wear	weared	V;PST
match	match	V;NFIN
land	land	N;SG
approve	approve	V;NFIN
drop	drop	V;NFIN
cake	cake	V;NFIN
coyote	coyote	N;SG
mitten	mittens	N;PL
abc	abc	N;SG
taste	taste	V;NFIN
harmony	harmony	N;SG
beginning	beginning	N;SG
bus	bus	N;SG
mitten	mitten	N;SG
ship	ship	N;SG
money	money	N;SG
pool	pool	N;SG
rumble	rumble	N;SG
mess	mess	N;SG
mat	mat	N;SG
might	might	V;NFIN
pick	picked	V;PST
pass	passing	V;V.PTCP;PRS
surprise	surprise	V;NFIN
baby	babies	N;PL
weigh	weigh	V;NFIN
minute	minute	N;SG
guitar	guitar	N;SG
thread	thread	N;SG
fly	flying	V;V.PTCP;PRS
spot	spot	N;SG
come	come	V;NFIN
wear	wearing	V;V.PTCP;PRS
folder	folder	N;SG
group	group	N;SG
orange	orange	N;SG
stomach	stomach	N;SG
dry	dried	V;V.PTCP;PST
have	had	V;V.PTCP;PST
breathe	breathe	V;NFIN
bowl	bowling	V;V.PTCP;PRS
cut	cut	V;NFIN
catch	catch	V;NFIN
banner	banner	N;SG
monkey	monkey	N;SG
juice	juice	V;NFIN
liquid	liquid	N;SG
pen	pen	N;SG
lend	lend	V;NFIN
dynamite	dynamite	V;NFIN
haddock	haddock	N;SG
stove	stove	N;SG
neighborhood	neighborhood	N;SG
continue	continue	V;NFIN
swallow	swallowed	V;PST
slide	slide	N;SG
share	share	N;SG
service	service	N;SG
listen	listen	V;NFIN
king	king	N;SG
chamber	chamber	N;SG
skitter	skitter	V;NFIN
difference	difference	N;SG
stare	staring	V;V.PTCP;PRS
suppose	supposed	V;V.PTCP;PST
problem	problem	N;SG
circle	circle	N;SG
slipper	slippers	N;PL
sister	sister	N;SG
tennis	tennis	N;SG
wipe	wipe	N;SG
walk	walk	V;NFIN
polo	polo	N;SG
maw	maw	N;SG
snack	snack	N;SG
pretzel	pretzel	N;SG
bucket	buckets	N;PL
spell	spells	N;PL
happen	happened	V;PST
nursery	nursery	N;SG
pop	pop	N;SG
poop	pooping	V;V.PTCP;PRS
leave	leave	N;SG
item	items	N;PL
mine	mine	N;SG
rug	rug	N;SG
rhyme	rhyme	V;NFIN
end	end	N;SG
pea	peas	N;PL
trash	trash	N;SG
size	size	N;SG
recital	recital	N;SG
castle	castle	N;SG
hippopotamus	hippopotamus	N;SG
tank	tank	N;SG
hen	hen	N;SG
squash	squash	N;SG
tow	tow	N;SG
activity	activity	N;SG
happen	happen	V;NFIN
pan	pans	N;PL
cent	cent	N;SG
let	letting	V;V.PTCP;PRS
wake	wake	V;NFIN
male	male	N;SG
answer	answer	N;SG
spot	spots	N;PL
fit	fit	V;NFIN
film	film	N;SG
awe	awe	N;SG
brick	brick	N;SG
triangle	triangle	N;SG
pocket	pocket	N;SG
map	map	N;SG
special	special	N;SG
plant	plant	N;SG
switch	switch	V;NFIN
shore	shore	N;SG
fool	fooled	V;PST
koolaid	koolaid	N;SG
cluck	cluck	N;SG
crown	crown	N;SG
come	came	V;PST
back	back	N;SG
bike	bike	N;SG
whistle	countable	N;PL
swing	swing	V;NFIN
cherry	cherries	N;PL
stair	stairs	N;PL
sad	sad	N;SG
contain	contain	N;SG
promise	promise	V;NFIN
stick	sticking	V;V.PTCP;PRS
break	break	N;SG
weapon	weapons	N;PL
stick	sticked	V;V.PTCP;PST
umbrella	umbrellas	N;PL
sit	sat	V;V.PTCP;PST
end	ends	N;PL
door	doors	N;PL
weed	countable	N;PL
dump	dump	V;NFIN
blanket	blanket	N;SG
poop	pooped	V;PST
miss	miss	V;NFIN
newspaper	newspaper	N;SG
beep	beeping	V;V.PTCP;PRS
cause	cause	V;NFIN
sewer	sewer	N;SG
brush	brush	N;SG
door	door	N;SG
crib	crib	N;SG
pea	pea	N;SG
peace	peace	N;SG
danger	danger	N;SG
gobble	gobble	V;NFIN
ding	ding	V;NFIN
look	looks	N;PL
set	set	V;NFIN
grandmother	grandmother	N;SG
room	room	N;SG
class	class	N;SG
vanilla	vanilla	N;SG
slam	slam	N;SG
south	south	N;SG
enjoy	enjoy	V;NFIN
walk	walking	V;V.PTCP;PRS
parade	parade	N;SG
purse	purse	N;SG
excuse	excused	V;V.PTCP;PST
see	saw	V;PST
poop	poop	V;NFIN
spoke	spokes	N;PL
crash	crash	N;SG
run	ran	V;PST
hold	held	V;PST
shoo	shoo	V;NFIN
wash	wash	V;NFIN
musical	musical	N;SG
pad	pad	N;SG
fox	foxes	N;PL
set	set	N;SG
help	helping	V;V.PTCP;PRS
building	building	N;SG
democrat	democrat	N;SG
hat	hat	N;SG
guess	guess	N;SG
year	years	N;PL
foot	foot	N;SG
oil	oil	V;NFIN
homosexual	homosexual	N;SG
mattress	mattress	N;SG
ride	riding	V;V.PTCP;PRS
porridge	porridge	N;SG
comb	combed	V;V.PTCP;PST
ma	ma	N;SG
magic	magic	N;SG
smile	smile	V;NFIN
fly	fly	V;NFIN
pie	pie	N;SG
family	family	N;SG
remember	remember	V;NFIN
could	could	V;NFIN
cloud	clouds	N;PL
feel	felt	V;PST
cause	cause	N;SG
father	father	N;SG
cup	cup	N;SG
nickel	nickel	N;SG
barn	barn	N;SG
dollar	dollar	N;SG
trumpet	trumpet	N;SG
press	press	N;SG
toast	toast	N;SG
mom	moms	N;PL
forest	forest	N;SG
hear	hear	V;NFIN
cardinal	cardinal	N;SG
pet	pet	N;SG
toy	toy	V;NFIN
balloon	balloon	N;SG
kitchen	kitchen	N;SG
burst	burst	V;NFIN
farm	farm	N;SG
stuff	stuff	N;SG
pick	pick	V;NFIN
mama	mama	N;SG
present	present	N;SG
page	pages	N;PL
apricot	apricots	N;PL
branch	branch	N;SG
sir	sir	N;SG
bang	banged	V;PST
finger	fingers	N;PL
bet	bet	V;NFIN
fever	fever	N;SG
plum	plum	N;SG
shovel	shovel	N;SG
lamb	lamb	N;SG
get	getting	V;V.PTCP;PRS
bone	bone	N;SG
dare	daring	V;V.PTCP;PRS
paper	paper	N;SG
mean	meaned	V;PST
fashion	fashion	N;SG
tie	tie	V;NFIN
science	science	N;SG
animal	animals	N;PL
baggage	baggage	N;SG
wash	wash	N;SG
briefcase	briefcase	N;SG
find	found	V;V.PTCP;PST
skate	skates	N;PL
mash	mash	V;NFIN
leave	leaved	V;PST
call	call	N;SG
import	imported	V;V.PTCP;PST
sale	sales	N;PL
crayon	crayon	N;SG
break	break	V;NFIN
feed	feeding	V;V.PTCP;PRS
say	saying	V;V.PTCP;PRS
ability	ability	N;SG
own	own	N;SG
babe	babe	N;SG
hole	hole	N;SG
blankie	blankie	N;SG
board	board	N;SG
out	out	N;SG
pane	pane	N;SG
brother	brother	N;SG
hush	hush	N;SG
lettuce	lettuce	N;SG
chin	chin	N;SG
smash	smashing	V;V.PTCP;PRS
ipod	ipod	N;SG
kid	kids	N;PL
clock	clock	N;SG
do	do	V;NFIN
cobra	cobra	N;SG
cucumber	cucumbers	N;PL
stretch	straight	V;V.PTCP;PST
snow	snew	V;PST
float	floating	V;V.PTCP;PRS
read	read	N;SG
see	seeing	V;V.PTCP;PRS
work	work	V;NFIN
day	days	N;PL
pepperoni	pepperoni	N;SG
job	jobs	N;PL
glue	glue	N;SG
pat	pats	N;PL
clean	cleaned	V;PST
carrot	carrot	N;SG
roast	roast	N;SG
second	second	N;SG
become	became	V;PST
pickle	pickle	N;SG
lose	lost	V;V.PTCP;PST
adjust	adjust	V;NFIN
yoga	yoga	N;SG
agree	agree	V;NFIN
capture	captured	V;PST
hammer	hammer	V;NFIN
give	give	V;NFIN
notice	notice	V;NFIN
miracle	miracle	N;SG
spaghetti	spaghetti	N;SG
clip	clip	N;SG
fire	fire	N;SG
turn	turned	V;PST
bend	bend	V;NFIN
hurry	hurry	V;NFIN
pipe	pipe	N;SG
try	tried	V;PST
dress	dress	V;NFIN
trust	trust	V;NFIN
flower	flower	N;SG
thing	things	N;PL
play	play	N;SG
hurt	hurt	V;PST
french	french	N;SG
cube	cube	N;SG
kid	kid	V;NFIN
leave	leaving	V;V.PTCP;PRS
