morsel	morsel	N;SG
stone	countable	N;PL
wave	waving	V;V.PTCP;PRS
car	car	N;SG
bath	bath	N;SG
shot	shot	N;SG
wine	wine	N;SG
add	add	V;NFIN
spoon	spoon	V;NFIN
chip	chip	N;SG
lid	lid	N;SG
dump	dump	V;NFIN
flower	flowers	N;PL
ride	ride	N;SG
flat	flat	N;SG
come	coming	V;V.PTCP;PRS
interest	interested	V;V.PTCP;PST
ship	ships	N;PL
beef	beef	N;SG
happen	happen	V;NFIN
pocket	pockets	N;PL
gun	guns	N;PL
kitty	kitties	N;PL
kid	kid	N;SG
complete	complete	V;NFIN
beet	beets	N;PL
ride	riding	V;V.PTCP;PRS
kiawe	kiawe	N;SG
give	giving	V;V.PTCP;PRS
reason	reason	N;SG
boot	boot	V;NFIN
throw	throw	V;NFIN
turn	turn	V;NFIN
wire	countable	N;PL
name	name	V;NFIN
finger	fingers	N;PL
order	order	V;NFIN
rid	rid	V;NFIN
bus	bus	N;SG
cricket	cricket	N;SG
dollar	dollars	N;PL
air	air	N;SG
hate	hate	V;NFIN
chew	chewing	V;V.PTCP;PRS
genus	genus	N;SG
knit	knit	V;NFIN
pizza	pizza	N;SG
down	down	V;NFIN
cow	cow	N;SG
net	net	N;SG
trip	trip	V;NFIN
lotion	lotion	N;SG
maestro	maestro	N;SG
granola	granola	N;SG
bless	bless	V;NFIN
beetle	beetle	N;SG
firework	fireworks	N;PL
horse	horse	N;SG
line	line	V;NFIN
roar	roar	N;SG
help	help	N;SG
wrestle	wrestle	V;NFIN
glue	glue	V;NFIN
hit	hitting	V;V.PTCP;PRS
bring	bringing	V;V.PTCP;PRS
bill	bill	N;SG
pair	pair	N;SG
soap	soap	N;SG
daisy	daisy	N;SG
blow	blown	V;V.PTCP;PST
watch	watch	N;SG
mat	mat	N;SG
ballerina	ballerina	N;SG
control	control	V;NFIN
tickle	tickle	N;SG
angel	angels	N;PL
slack	slack	N;SG
alphabet	alphabet	N;SG
bean	bean	N;SG
stable	stable	N;SG
yap	yap	V;NFIN
eye	eye	V;NFIN
ache	ache	N;SG
decoration	decoration	N;SG
dig	dig	N;SG
order	ordered	V;V.PTCP;PST
film	filmed	V;PST
sea	sea	N;SG
brown	brown	N;SG
look	looking	V;V.PTCP;PRS
supper	supper	N;SG
quiche	quiche	N;SG
walk	walking	V;V.PTCP;PRS
music	music	N;SG
book	book	N;SG
elastic	elastic	N;SG
rub	rub	N;SG
dark	dark	N;SG
lay	lay	V;NFIN
stand	standing	V;V.PTCP;PRS
pretend	pretending	V;V.PTCP;PRS
suppose	suppose	V;NFIN
piece	piece	V;NFIN
set	set	V;NFIN
pay	pay	N;SG
term	terms	N;PL
table	table	N;SG
yawn	yawning	V;V.PTCP;PRS
hear	hear	V;NFIN
fire	fire	N;SG
cheese	cheese	N;SG
sleep	sleeping	V;V.PTCP;PRS
house	house	N;SG
inside	inside	N;SG
butcher	butcher	N;SG
rent	rented	V;PST
bet	bet	N;SG
steak	steak	N;SG
couch	couch	N;SG
bobby	bobby	N;SG
kick	kick	V;NFIN
fight	fighting	V;V.PTCP;PRS
button	buttons	N;PL
mill	mill	N;SG
throw	threw	V;PST
tooth	tooth	N;SG
penny	pennies	N;PL
stand	stand	V;NFIN
hide	hide	N;SG
pen	pens	N;PL
mouth	mouth	N;SG
cupcake	cupcake	N;SG
whale	whale	N;SG
skip	skipping	V;V.PTCP;PRS
park	park	N;SG
move	moving	V;V.PTCP;PRS
beep	beep	N;SG
card	card	N;SG
scrape	scrape	V;NFIN
medicine	medicine	N;SG
do	done	V;V.PTCP;PST
arm	arm	N;SG
sky	sky	N;SG
change	change	V;NFIN
wand	wand	N;SG
ball	countable	N;PL
gown	gown	N;SG
plane	plane	N;SG
hall	hall	N;SG
buckle	buckle	V;NFIN
answer	answer	V;NFIN
bank	bank	N;SG
key	key	V;NFIN
cape	cape	N;SG
bounce	bounce	N;SG
collar	collar	N;SG
grocery	groceries	N;PL
call	calls	N;PL
grandpa	grandpa	N;SG
see	saw	V;PST
belly	belly	N;SG
newspaper	newspaper	N;SG
lobster	lobster	N;SG
electricity	electricity	N;SG
jug	jug	N;SG
try	tried	V;V.PTCP;PST
type	type	N;SG
bladder	bladder	N;SG
rest	rest	N;SG
bear	bear	V;NFIN
butt	butt	N;SG
chase	chased	V;V.PTCP;PST
pineapple	pineapple	N;SG
momma	momma	N;SG
see	seen	V;V.PTCP;PST
army	army	N;SG
month	month	N;SG
take	take	V;NFIN
drive	drave	V;PST
research	research	N;SG
layer	layer	N;SG
motorcycle	motorcycle	N;SG
golf	golf	N;SG
peanut	peanuts	N;PL
canal	canal	N;SG
clown	clown	N;SG
cute	cute	N;SG
long	longed	V;PST
help	helping	V;V.PTCP;PRS
share	share	V;NFIN
feel	feel	V;NFIN
begin	beginning	V;V.PTCP;PRS
save	save	V;NFIN
know	knew	V;PST
match	match	V;NFIN
animal	animals	N;PL
use	used	V;V.PTCP;PST
yeast	yeast	N;SG
sandal	sandals	N;PL
pumpkin	pumpkins	N;PL
van	van	N;SG
wet	wet	V;V.PTCP;PST
flash	flashing	V;V.PTCP;PRS
thing	things	N;PL
name	names	N;PL
cold	cold	N;SG
money	money	N;SG
gallop	galloping	V;V.PTCP;PRS
mow	mowing	V;V.PTCP;PRS
draw	draw	V;NFIN
eat	eating	V;V.PTCP;PRS
turtle	turtle	N;SG
wear	wear	V;NFIN
teach	teaches	N;PL
button	button	V;NFIN
kool_aid	kool_aid	N;SG
chase	chase	V;NFIN
fly	flew	V;PST
piece	piece	N;SG
front	front	V;NFIN
store	store	N;SG
lie	lie	N;SG
confuse	confusing	V;V.PTCP;PRS
soap	soap	V;NFIN
pepper	pepper	N;SG
llama	llama	N;SG
win	win	V;NFIN
cry	cried	V;PST
mister	mister	N;SG
bite	bite	N;SG
welcome	welcome	V;NFIN
face	face	N;SG
tank	tank	N;SG
surprise	surprise	N;SG
father	father	N;SG
question	question	V;NFIN
doughnut	doughnut	N;SG
terror	terror	N;SG
hunt	hunt	N;SG
order	ordering	V;V.PTCP;PRS
glass	glass	N;SG
hope	hope	V;NFIN
bribe	bribe	V;NFIN
owl	owls	N;PL
present	presents	N;PL
take	took	V;PST
hand	hands	N;PL
tin	tin	N;SG
gobble	gobbles	N;PL
box	box	V;NFIN
spit	spitting	V;V.PTCP;PRS
swim	swim	N;SG
hop	hop	N;SG
see	seeing	V;V.PTCP;PRS
do	did	V;PST
touch	touch	N;SG
sun	sun	N;SG
time	time	V;NFIN
talk	talk	V;NFIN
magician	magician	N;SG
grow	grow	V;NFIN
joke	joke	N;SG
alligator	alligator	N;SG
bologna	bologna	N;SG
yawn	yawn	N;SG
parrot	parrot	N;SG
trolley	trolley	N;SG
bulb	bulb	N;SG
hold	hold	V;NFIN
claw	claw	N;SG
swing	swing	N;SG
daughter	daughter	N;SG
pig	pigs	N;PL
club	club	V;NFIN
paddle	paddle	V;NFIN
bee	bee	N;SG
monkey	monkeys	N;PL
tunnel	tunnel	N;SG
give	gave	V;PST
court	court	N;SG
drink	drink	N;SG
cock	cock	N;SG
mike	mike	N;SG
snake	snake	N;SG
yogurt	yogurt	N;SG
bear	bears	N;PL
urinate	urinate	V;NFIN
plop	plopped	V;PST
tub	tub	N;SG
counter	counter	N;SG
warm	warm	V;NFIN
story	story	N;SG
ask	ask	V;NFIN
sock	socks	N;PL
screw	screws	N;PL
phone	phone	V;NFIN
stretch	stretching	V;V.PTCP;PRS
reach	reach	V;NFIN
telephone	telephone	N;SG
whole	whole	N;SG
grey	grey	V;NFIN
lumber	lumber	N;SG
power	power	N;SG
monster	monsters	N;PL
toy	toys	N;PL
batter	batter	N;SG
march	march	N;SG
run	running	V;V.PTCP;PRS
crawl	crawling	V;V.PTCP;PRS
be	been	V;V.PTCP;PST
walk	walk	N;SG
milk	milk	V;NFIN
drive	drive	V;NFIN
skedaddle	skedaddle	V;NFIN
rag	rags	N;PL
ballet	ballet	N;SG
song	song	N;SG
upgrade	upgrade	V;NFIN
splash	splash	N;SG
hit	hit	N;SG
keep	kept	V;PST
being	being	N;SG
number	number	N;SG
cow	cows	N;PL
carry	carry	V;NFIN
heel	heels	N;PL
sibling	sibling	N;SG
project	project	N;SG
think	thought	V;PST
sure	sure	V;NFIN
chair	chair	N;SG
fat	fat	N;SG
laundry	laundry	N;SG
smash	smash	N;SG
scarf	scarf	N;SG
press	press	V;NFIN
look	looked	V;PST
choose	choose	V;NFIN
pass	passed	V;PST
sail	sailing	V;V.PTCP;PRS
racket	racket	N;SG
get	get	V;NFIN
nurse	nurses	N;PL
stuff	stuffed	V;PST
fox	fox	N;SG
doll	doll	N;SG
nose	nose	N;SG
explain	explain	V;NFIN
fun	fun	N;SG
cherry	cherries	N;PL
roll	roll	N;SG
ring	ring	N;SG
sprinkle	sprinkle	V;NFIN
dinosaur	dinosaur	N;SG
world	world	N;SG
sigh	sigh	N;SG
fix	fixing	V;V.PTCP;PRS
bounce	bouncing	V;V.PTCP;PRS
telephone	telephone	V;NFIN
drag	dragging	V;V.PTCP;PRS
line	lines	N;PL
mix	mixed	V;PST
symbol	symbol	N;SG
canoe	canoes	N;PL
rush	rushed	V;V.PTCP;PST
buy	buy	V;NFIN
turtle	turtles	N;PL
happen	happening	V;V.PTCP;PRS
stroll	stroll	N;SG
hole	hole	N;SG
hon	hon	N;SG
sauce	sauce	N;SG
crown	crown	N;SG
smile	smile	N;SG
lift	lifted	V;V.PTCP;PST
produce	produce	N;SG
truck	countable	N;PL
fix	fixed	V;V.PTCP;PST
spot	spots	N;PL
taste	taste	V;NFIN
yoyo	yoyo	N;SG
triangle	triangle	N;SG
napkin	napkin	N;SG
flower	flower	N;SG
eye	eye	N;SG
muffin	muffin	N;SG
thread	thread	N;SG
honk	honk	N;SG
man	man	N;SG
leaf	leaf	N;SG
right	right	N;SG
back	back	V;NFIN
breakfast	breakfast	N;SG
dream	dream	V;NFIN
barrette	barrette	N;SG
thief	thief	N;SG
hail	hail	N;SG
cell	cells	N;PL
drink	drink	V;NFIN
guy	guys	N;PL
bean	beans	N;PL
summer	summer	N;SG
work	work	V;NFIN
pickle	pickle	N;SG
want	want	V;NFIN
light	light	N;SG
vanilla	vanilla	N;SG
color	color	V;NFIN
sand	sand	N;SG
sandwich	sandwiches	N;PL
grape	grape	N;SG
play	play	N;SG
valentine	valentine	N;SG
idea	idea	N;SG
frankfurter	frankfurter	N;SG
tie	tie	N;SG
well	well	N;SG
wool	wool	N;SG
fit	fit	V;NFIN
bucket	bucket	N;SG
step	stepped	V;V.PTCP;PST
zip	zip	N;SG
deal	deal	N;SG
rice_krispies	rice_krispies	N;SG
missile	missiles	N;PL
go	go	V;NFIN
poop	countable	N;PL
lullaby	lullaby	N;SG
dinner	dinner	N;SG
tuck	tucking	V;V.PTCP;PRS
taxi	taxi	N;SG
arm	arms	N;PL
chug	chug	V;NFIN
sound	countable	N;PL
record	records	N;PL
frog	frog	N;SG
tomato	tomato	N;SG
spinach	spinach	N;SG
tea	tea	N;SG
pick	pick	V;NFIN
goat	goat	N;SG
game	countable	N;PL
chalk	chalk	N;SG
guy	guy	N;SG
hat	hats	N;PL
turn	turned	V;PST
mud	mud	N;SG
cat	cats	N;PL
plenty	plenty	N;SG
one	ones	N;PL
microphone	microphone	N;SG
peach	peaches	N;PL
trip	trip	N;SG
spaghetti	spaghetti	N;SG
pump	pump	N;SG
tiger	tiger	N;SG
stunt	stunting	V;V.PTCP;PRS
meat	meat	N;SG
spend	spending	V;V.PTCP;PRS
mug	mug	N;SG
pronounce	pronounce	V;NFIN
talk	talk	N;SG
gorilla	gorilla	N;SG
cough	coughing	V;V.PTCP;PRS
distance	distance	N;SG
run	run	V;NFIN
word	word	N;SG
motor	motor	N;SG
boil	boil	V;NFIN
pajamas	pajamas	N;SG
move	moved	V;PST
griffin	griffin	N;SG
pretend	pretend	V;NFIN
kite	kite	N;SG
float	floating	V;V.PTCP;PRS
saw	saw	N;SG
win	won	V;PST
soup	soup	N;SG
forget	forgat	V;PST
point	point	V;NFIN
toe	toe	N;SG
guard	guarding	V;V.PTCP;PRS
puff	puff	N;SG
set	set	N;SG
work	worked	V;PST
matter	matter	N;SG
meet	meet	V;NFIN
nick	nick	N;SG
grocery	grocery	N;SG
scream	scream	V;NFIN
tie	tying	V;V.PTCP;PRS
fall	falling	V;V.PTCP;PRS
side	side	V;NFIN
blankie	blankie	N;SG
step	step	N;SG
name	name	N;SG
particular	particular	N;SG
moon	moon	N;SG
life	life	N;SG
jam	jam	N;SG
bin	bin	N;SG
buy	bought	V;PST
push	push	N;SG
thing	thing	N;SG
look	look	V;NFIN
skin	skin	N;SG
lettuce	lettuce	N;SG
crab	crab	N;SG
spoil	spoil	V;NFIN
question	question	N;SG
boat	boat	N;SG
wash	wash	V;NFIN
god	god	N;SG
snap	snap	V;NFIN
carry	carrying	V;V.PTCP;PRS
grizzly	grizzly	N;SG
tissue	countable	N;PL
sense	sense	N;SG
want	wanting	V;V.PTCP;PRS
seem	seemed	V;PST
rabbit	rabbit	N;SG
pounce	pounce	V;NFIN
clock	clock	N;SG
share	share	N;SG
monkey	monkey	N;SG
quarter	quarter	N;SG
ladder	ladder	N;SG
flatten	flatten	V;NFIN
plant	plant	N;SG
position	position	N;SG
hen	hen	N;SG
soldier	soldiers	N;PL
year	years	N;PL
home	home	N;SG
slip	slip	V;NFIN
dance	dance	V;NFIN
sleep	sleep	V;NFIN
luck	luck	N;SG
damn	damn	N;SG
safe	safe	N;SG
wake	wake	V;NFIN
puppy	puppies	N;PL
whip	whip	V;NFIN
sell	sell	V;NFIN
snake	snakes	N;PL
meatball	meatball	N;SG
tickle	tickle	V;NFIN
car	cars	N;PL
figure	figured	V;PST
ribbon	ribbon	N;SG
kiddo	kiddo	N;SG
rock	rocking	V;V.PTCP;PRS
fuck	fuck	V;NFIN
break	break	V;NFIN
kiss	kissing	V;V.PTCP;PRS
low	low	N;SG
spatula	spatula	N;SG
globe	globe	N;SG
corn	corn	N;SG
slip	slip	N;SG
sprinkle	sprinkles	N;PL
overwhelm	overwhelmed	V;V.PTCP;PST
smell	smell	V;NFIN
ride	ride	V;NFIN
brontosaurus	brontosaurus	N;SG
think	thinking	V;V.PTCP;PRS
hippopotamus	hippopotamus	N;SG
construction	construction	N;SG
knock	knock	N;SG
hand	hand	V;NFIN
sponsor	sponsor	V;NFIN
fold	fold	N;SG
busy	busy	V;NFIN
try	try	V;NFIN
should	should	V;NFIN
program	program	N;SG
puddle	puddle	N;SG
chip	chip	V;NFIN
doll	dolls	N;PL
rush	rush	N;SG
cash	cash	N;SG
row	row	N;SG
green	green	V;NFIN
snap	snapping	V;V.PTCP;PRS
jeep	jeep	N;SG
hand	hand	N;SG
improvise	improvised	V;V.PTCP;PST
tonic	tonic	N;SG
miss	miss	V;NFIN
show	showed	V;V.PTCP;PST
disappear	disappeared	V;V.PTCP;PST
giant	giant	N;SG
strawberry	strawberry	N;SG
taste	taste	N;SG
cover	covered	V;PST
evening	evening	N;SG
rug	rug	N;SG
dust	dust	V;NFIN
gas	gas	N;SG
woof	woof	V;NFIN
minute	minute	N;SG
pee	peeing	V;V.PTCP;PRS
ale	ale	N;SG
swim	swims	N;PL
loo	loo	N;SG
call	called	V;V.PTCP;PST
jeans	jeans	N;SG
plant	plants	N;PL
hold	holding	V;V.PTCP;PRS
light	countable	N;PL
store	stores	N;PL
laugh	laughed	V;PST
do	do	V;NFIN
pilgrim	pilgrims	N;PL
fish	fish	N;SG
here	here	N;SG
tickle	tickled	V;V.PTCP;PST
sticky	sticky	N;SG
number	numbers	N;PL
meal	meal	N;SG
girl	girl	N;SG
piglet	piglet	N;SG
sleeve	sleeve	N;SG
walk	walks	N;PL
sweater	sweater	N;SG
true	true	N;SG
munchkin	munchkin	N;SG
hamburger	hamburger	N;SG
oatmeal	oatmeal	N;SG
plate	plate	N;SG
combination	combination	N;SG
buck	buck	N;SG
beginning	beginning	N;SG
connection	connection	N;SG
finish	finish	V;NFIN
waffle	waffle	N;SG
tape	tape	N;SG
needle	needles	N;PL
tangle	tangled	V;V.PTCP;PST
middle	middle	N;SG
excuse	excuse	V;NFIN
toast	toast	N;SG
potato	potato	N;SG
bite	bite	V;NFIN
track	track	V;NFIN
pea	pea	N;SG
sister	sister	N;SG
karate	karate	N;SG
size	countable	N;PL
shout	shouted	V;PST
couple	couple	N;SG
lick	licking	V;V.PTCP;PRS
toss	toss	V;NFIN
diapie	diapie	N;SG
miss	missing	V;V.PTCP;PRS
service	service	N;SG
plan	planning	V;V.PTCP;PRS
chimney	chimney	N;SG
rubber	rubber	N;SG
chain	chain	N;SG
kitten	kitten	N;SG
saw	saw	V;NFIN
crash	crash	N;SG
tower	tower	N;SG
fry	fries	N;PL
hold	hold	N;SG
grass	grass	N;SG
station	station	N;SG
listen	listen	V;NFIN
buzz	buzzing	V;V.PTCP;PRS
shall	shall	V;NFIN
ash	countable	N;PL
stay	stayed	V;V.PTCP;PST
disguise	disguise	V;NFIN
cough	cough	N;SG
dress	dress	N;SG
read	read	N;SG
snack	snack	N;SG
cry	cry	N;SG
mow	mow	N;SG
caterpillar	caterpillars	N;PL
teddy	teddy	N;SG
work	working	V;V.PTCP;PRS
cook	cook	N;SG
pasta	pasta	N;SG
kind	kinds	N;PL
bun	bun	N;SG
hiccup	hiccup	N;SG
decibel	decibels	N;PL
yum	yum	N;SG
pee	pee	N;SG
ghost	ghost	N;SG
circle	circle	N;SG
coo	coo	V;NFIN
thank_you	thank_you	N;SG
flurry	flurried	V;PST
call	call	N;SG
connect	connect	V;NFIN
owl	owl	N;SG
turn	turned	V;V.PTCP;PST
koolaid	koolaid	N;SG
hippo	hippo	N;SG
tuck	tuck	V;NFIN
werewolf	werewolf	N;SG
key	keys	N;PL
green	green	N;SG
lip	countable	N;PL
cut	cutting	V;V.PTCP;PRS
must	must	V;NFIN
water	water	N;SG
rooster	rooster	N;SG
knit	knitting	V;V.PTCP;PRS
ocean	ocean	N;SG
piece	pieces	N;PL
lunch	lunch	N;SG
introduce	introduce	V;NFIN
fall	fell	V;PST
bird	birds	N;PL
turn	turning	V;V.PTCP;PRS
read	read	V;NFIN
stick	sticked	V;V.PTCP;PST
train	train	N;SG
stop	stop	V;NFIN
slide	slide	V;NFIN
tuna	tuna	N;SG
amount	amount	N;SG
button	button	N;SG
guest	guest	N;SG
suck	suck	V;NFIN
double	double	N;SG
bubble	bubble	N;SG
call	calling	V;V.PTCP;PRS
rule	countable	N;PL
paddle	paddling	V;V.PTCP;PRS
down	down	N;SG
penny	penny	N;SG
say	say	V;NFIN
cabinet	cabinet	N;SG
babe	babes	N;PL
family	family	N;SG
bug	bugs	N;PL
sing	singing	V;V.PTCP;PRS
mow	mow	V;NFIN
arcade	arcades	N;PL
board	countable	N;PL
picture	picture	N;SG
lipstick	lipstick	N;SG
bend	bend	V;NFIN
there	there	V;NFIN
rope	rope	N;SG
buddy	buddy	N;SG
avocado	avocado	N;SG
halloween	halloween	N;SG
favorite	favorite	N;SG
hide	hide	V;NFIN
put	put	V;V.PTCP;PST
coat	coat	N;SG
plus	plus	N;SG
side	sides	N;PL
return	returned	V;PST
wait	waited	V;PST
wave	waved	V;V.PTCP;PST
steal	stealing	V;V.PTCP;PRS
copy	copy	N;SG
forest	forest	N;SG
candle	candles	N;PL
salmon	salmon	N;SG
open	open	V;NFIN
bore	boring	V;V.PTCP;PRS
race	race	N;SG
matter	matter	V;NFIN
hose	hose	N;SG
building	building	N;SG
flour	flour	N;SG
be	be	V;NFIN
incubator	incubator	N;SG
collection	collection	N;SG
wake	wake	N;SG
squeak	squeak	N;SG
capture	captured	V;V.PTCP;PST
guard	guards	N;PL
fog	fog	N;SG
moon	moons	N;PL
responsibility	responsibility	N;SG
airplane	airplane	N;SG
photograph	photographs	N;PL
cabin	cabin	N;SG
splinter	splinter	N;SG
week	week	N;SG
pop	pop	V;NFIN
bag	bag	N;SG
wear	wearing	V;V.PTCP;PRS
clap	clapped	V;PST
wrong	wrong	N;SG
slide	slide	N;SG
hydrant	hydrant	N;SG
dry	dry	V;NFIN
dog	dogs	N;PL
break	broke	V;PST
sweep	sweeping	V;V.PTCP;PRS
nappie	nappies	N;PL
trace	trace	V;NFIN
school	school	N;SG
iron	ironed	V;PST
birth	birth	N;SG
clean	cleans	N;PL
shit	shit	N;SG
move	move	N;SG
iron	iron	N;SG
bend	bended	V;PST
joy	joy	N;SG
island	island	N;SG
drum	drum	N;SG
ear	ears	N;PL
love	love	V;NFIN
way	way	N;SG
fix	fixed	V;PST
bulldoze	bulldoze	N;SG
time	time	N;SG
discussion	discussion	N;SG
write	writing	V;V.PTCP;PRS
tractor	tractor	N;SG
newspaper	newspaper	V;NFIN
raspberry	raspberry	N;SG
thumb	thumb	N;SG
fast	fast	N;SG
knock	knocked	V;PST
country	country	N;SG
share	sharing	V;V.PTCP;PRS
feel	felt	V;PST
eagle	eagles	N;PL
wad	wad	V;NFIN
put	putting	V;V.PTCP;PRS
penguin	penguin	N;SG
stage	stage	N;SG
shoot	shoot	V;NFIN
item	items	N;PL
have	have	V;NFIN
trick	tricked	V;PST
swing	swing	V;NFIN
thought	thought	N;SG
cup	cup	N;SG
park	park	V;NFIN
square	square	N;SG
porridge	porridge	N;SG
manage	managed	V;PST
problem	problem	N;SG
movie	movie	N;SG
lollipop	lollipop	N;SG
whoop	whoop	N;SG
oystering	oystering	N;SG
ally	ally	N;SG
fence	fence	N;SG
freeze	freezing	V;V.PTCP;PRS
use	used	V;PST
gramma	gramma	N;SG
push	pushing	V;V.PTCP;PRS
start	starting	V;V.PTCP;PRS
know	know	V;NFIN
pocket	pocket	N;SG
please	please	V;NFIN
cook	cook	V;NFIN
iceberg	iceberg	N;SG
bush	bush	N;SG
yolk	yolk	N;SG
strawberry	countable	N;PL
duck	duck	N;SG
stop	stop	N;SG
pudding	pudding	N;SG
hear	heard	V;PST
flip	flipping	V;V.PTCP;PRS
break	broken	V;V.PTCP;PST
pie	pie	N;SG
ruff	ruff	V;NFIN
shoe	shoes	N;PL
fossil	fossils	N;PL
turkey	turkey	N;SG
ink	ink	N;SG
alien	aliens	N;PL
box	box	N;SG
sandwich	sandwich	N;SG
student	student	N;SG
rattle	rattle	N;SG
refrigerator	refrigerator	N;SG
smoke	smoke	N;SG
baby	baby	V;NFIN
cousin	cousin	N;SG
lady	lady	N;SG
hahaha	hahaha	N;SG
pop	pop	N;SG
sound	sound	V;NFIN
fill	filled	V;V.PTCP;PST
nap	nap	N;SG
fork	fork	N;SG
hello	hello	N;SG
cost	cost	V;NFIN
get	got	V;V.PTCP;PST
church	church	N;SG
jump	jumped	V;PST
have	had	V;PST
scrapbook	scrapbook	N;SG
tear	tear	V;NFIN
drive	countable	N;PL
tip	tip	N;SG
lose	lose	V;NFIN
mess	mess	V;NFIN
cootie	cootie	N;SG
say	said	V;V.PTCP;PST
ham	ham	N;SG
hug	hug	N;SG
send	sent	V;PST
hear	heard	V;V.PTCP;PST
push	pushed	V;PST
dot	dot	N;SG
moment	moment	N;SG
hum	hum	N;SG
skip	skip	N;SG
grandma	grandma	N;SG
nana	nana	N;SG
ear	ear	N;SG
love	loved	V;PST
try	tried	V;PST
king	king	N;SG
spike	spike	V;NFIN
catch	caught	V;PST
dump	dumped	V;PST
muss	muss	V;NFIN
wallet	wallet	N;SG
chick	chick	N;SG
bear	bear	N;SG
avenue	avenue	N;SG
curtain	curtains	N;PL
yellow	yellow	N;SG
like	like	V;NFIN
gum	gum	N;SG
capture	capture	V;NFIN
lamb	lamb	N;SG
set	set	V;V.PTCP;PST
neck	neck	N;SG
poop	poop	N;SG
slipper	slippers	N;PL
hockey	hockey	N;SG
order	ordered	V;PST
wind	wind	N;SG
night	night	N;SG
freeze	frozen	V;V.PTCP;PST
seam	seam	N;SG
organize	organize	N;SG
chatter	chatter	N;SG
age	age	N;SG
delay	delayed	V;PST
fix	fix	V;NFIN
brown	brown	V;NFIN
basket	basket	N;SG
ring	ringing	V;V.PTCP;PRS
wake	woke	V;PST
queen	queen	N;SG
blow	blow	V;NFIN
kiss	kissed	V;V.PTCP;PST
moo	moo	V;NFIN
water	water	V;NFIN
action	action	N;SG
second	second	N;SG
script	script	N;SG
pig	pig	N;SG
curtain	curtain	N;SG
shut	shut	V;NFIN
mess	messing	V;V.PTCP;PRS
crack	cracked	V;PST
shoot	shoot	N;SG
kiss	kiss	N;SG
ipad	ipad	N;SG
circus	circus	N;SG
trip	trips	N;PL
toddle	toddle	N;SG
jar	jar	N;SG
water	watered	V;PST
road	road	N;SG
farm	farm	N;SG
door	door	N;SG
alien	alien	N;SG
safe	safes	N;PL
apologize	apologize	V;NFIN
hole	holes	N;PL
write	writ	V;PST
dip	dip	N;SG
pleasure	pleasure	N;SG
floor	floor	N;SG
rabbit	countable	N;PL
check	checking	V;V.PTCP;PRS
clay	clay	N;SG
dose	dose	N;SG
wait	waiting	V;V.PTCP;PRS
egg	eggs	N;PL
raisin	raisins	N;PL
zip	zip	V;NFIN
diamond	diamond	N;SG
candy	candy	N;SG
attach	attach	V;NFIN
poof	poof	V;NFIN
foot	foot	N;SG
radio	radio	N;SG
shuffle	shuffle	V;NFIN
get	got	V;PST
rip	rip	V;NFIN
talk	talking	V;V.PTCP;PRS
play	playing	V;V.PTCP;PRS
want	wanted	V;V.PTCP;PST
read	reading	V;V.PTCP;PRS
camera	camera	N;SG
meet	met	V;PST
wonder	wonder	V;NFIN
page	pages	N;PL
vocabulary	vocabulary	N;SG
sweep	sweep	V;NFIN
phone	phones	N;PL
take	taking	V;V.PTCP;PRS
tail	tail	N;SG
word	word	V;NFIN
divide	dividing	V;V.PTCP;PRS
attack	attacked	V;PST
string	string	N;SG
puppy	puppy	N;SG
play	play	V;NFIN
belong	belong	V;NFIN
key	key	N;SG
chase	chased	V;PST
dish	dishes	N;PL
yell	yell	N;SG
rise	rise	V;NFIN
doo	doo	N;SG
caterpillar	caterpillar	N;SG
mine	mine	V;NFIN
safety	safety	N;SG
group	group	N;SG
wind	wind	V;NFIN
hesitation	hesitation	N;SG
rest	rest	V;NFIN
chill	chilled	V;PST
lot	lots	N;PL
parent	parents	N;PL
man	men	N;PL
will	will	V;NFIN
tap	tap	N;SG
minute	minutes	N;PL
snuggle	snuggle	V;NFIN
cut	cut	N;SG
leave	leaving	V;V.PTCP;PRS
mom	mom	N;SG
friend	friend	N;SG
nurse	nurse	N;SG
send	send	V;NFIN
wish	wish	V;NFIN
hike	hike	N;SG
jump	jump	N;SG
borrow	borrow	V;NFIN
stick	stick	N;SG
touch	touch	V;NFIN
remember	remember	V;NFIN
scoop	scoop	N;SG
disturb	disturb	V;NFIN
carve	carved	V;V.PTCP;PST
brother	brother	N;SG
cookie	cookie	N;SG
pirate	pirate	N;SG
page	page	N;SG
sing	sing	V;NFIN
wheel	wheel	N;SG
point	points	N;PL
peek	peek	V;NFIN
leave	leaved	V;PST
kind	kind	N;SG
bull	bulls	N;PL
mean	mean	N;SG
unseat	unseat	V;NFIN
make	making	V;V.PTCP;PRS
believe	believe	V;NFIN
penguin	penguins	N;PL
stove	stove	N;SG
decide	decided	V;PST
bike	bike	N;SG
fall	fall	N;SG
ride	rode	V;PST
dance	dancing	V;V.PTCP;PRS
notice	notice	V;NFIN
paint	paint	V;NFIN
cone	cone	N;SG
goggle	goggle	N;SG
help	helped	V;PST
bed	bed	N;SG
feather	feathers	N;PL
yard	yard	N;SG
berry	berries	N;PL
beat	beat	N;SG
shortcut	shortcut	N;SG
clean	cleaned	V;PST
cottage	cottage	N;SG
guess	guess	V;NFIN
let	let	V;V.PTCP;PST
stay	staying	V;V.PTCP;PRS
step	step	V;NFIN
dirty	dirty	V;NFIN
nondrip	nondrip	N;SG
space	space	N;SG
keep	keep	V;NFIN
tongue	tongue	N;SG
freeze	froze	V;PST
glue	glue	N;SG
menu	menu	N;SG
pee	peed	V;PST
banana	banana	N;SG
goldfish	goldfish	N;SG
fine	fine	N;SG
hour	hour	N;SG
find	fand	V;PST
start	started	V;PST
noise	countable	N;PL
cross	cross	V;NFIN
thunder	thunder	N;SG
bike	bikes	N;PL
stuff	stuff	V;NFIN
stay	stayed	V;PST
say	said	V;PST
stuff	stuff	N;SG
phone	phone	N;SG
blue	blue	N;SG
police	police	N;SG
stair	stairs	N;PL
kitten	kittens	N;PL
musketeer	musketeer	N;SG
huff	huffed	V;V.PTCP;PST
land	land	V;NFIN
snip	snip	V;NFIN
giraffe	giraffe	N;SG
squid	squid	N;SG
bottle	bottle	N;SG
tire	tired	V;PST
bee	bees	N;PL
tube	tube	N;SG
heat	heat	N;SG
candle	candle	N;SG
cream	cream	N;SG
winter	winter	N;SG
cone	cones	N;PL
date	date	N;SG
corner	corner	N;SG
base	base	N;SG
stork	storks	N;PL
cube	cube	N;SG
trunk	trunks	N;PL
arrange	arrange	V;NFIN
card	countable	N;PL
hoopla	hoopla	N;SG
cooperate	cooperating	V;V.PTCP;PRS
approach	approach	N;SG
child	child	N;SG
soda	soda	N;SG
dress	dressed	V;PST
thank	thank	V;NFIN
high	high	N;SG
wipe	wipe	N;SG
wipe	wipes	N;PL
stay	stay	V;NFIN
front	front	N;SG
smell	smell	N;SG
mustache	mustache	N;SG
suit	suit	N;SG
wheat	wheat	N;SG
pound	pounds	N;PL
pour	pour	V;NFIN
seal	seal	N;SG
boot	boot	N;SG
elevator	elevator	N;SG
size	sized	V;V.PTCP;PST
crayon	crayons	N;PL
kiwi	kiwi	N;SG
admit	admitting	V;V.PTCP;PRS
dub	dub	V;NFIN
light	lighted	V;V.PTCP;PST
preschool	preschool	N;SG
splat	splat	N;SG
want	wanted	V;PST
bring	bring	V;NFIN
block	blocks	N;PL
till	till	V;NFIN
bowl	bowl	N;SG
butter	butter	V;NFIN
edge	edge	V;NFIN
drool	drool	V;NFIN
carrot	carrot	N;SG
cat	cat	N;SG
feed	feed	V;NFIN
learn	learning	V;V.PTCP;PRS
fever	fever	N;SG
go	gone	V;V.PTCP;PST
desk	desk	N;SG
whack	whacked	V;V.PTCP;PST
attic	attic	N;SG
crumble	crumbled	V;V.PTCP;PST
mean	mean	V;NFIN
begin	began	V;PST
bell	bell	N;SG
stir	stir	V;NFIN
kiss	kiss	V;NFIN
mitten	mittens	N;PL
dial	dials	N;PL
fall	fall	V;NFIN
leg	legs	N;PL
realize	realize	V;NFIN
lay	laying	V;V.PTCP;PRS
bunny	bunny	N;SG
live	live	V;NFIN
leash	leash	N;SG
fly	fly	N;SG
hurry	hurry	V;NFIN
tree	trees	N;PL
trunk	trunk	N;SG
craft	craft	N;SG
bead	beads	N;PL
yell	yell	V;NFIN
fairy	fairy	N;SG
pop	popped	V;V.PTCP;PST
decide	decide	V;NFIN
diet	diet	N;SG
roof	roof	N;SG
toto	toto	N;SG
shape	countable	N;PL
give	give	V;NFIN
sausage	sausage	N;SG
ask	asked	V;PST
climb	climb	V;NFIN
elbow	elbow	N;SG
recess	recess	N;SG
ghost	ghosts	N;PL
hate	hate	N;SG
paint	paint	N;SG
dress	dressing	V;V.PTCP;PRS
tv	tv	N;SG
check	check	V;NFIN
cement	cement	N;SG
party	party	N;SG
destroy	destroyed	V;PST
shine	shining	V;V.PTCP;PRS
nut	nut	N;SG
lamp	lamp	N;SG
heart	heart	N;SG
mark	marks	N;PL
make	make	V;NFIN
eye	eyes	N;PL
zoo	zoo	N;SG
clunk	clunking	V;V.PTCP;PRS
drip	drip	N;SG
fit	fit	N;SG
hood	hood	N;SG
squash	squashed	V;V.PTCP;PST
clap	clap	N;SG
push	push	V;NFIN
pray	pray	V;NFIN
bark	bark	N;SG
pant	pant	V;NFIN
accident	accident	N;SG
wave	waves	N;PL
pay	pay	V;NFIN
glove	gloves	N;PL
quack	quack	N;SG
turn	turn	N;SG
shut	shut	V;V.PTCP;PST
spank	spank	V;NFIN
bit	bit	N;SG
wolf	wolf	N;SG
title	title	N;SG
dish	dish	N;SG
squishy	squishy	N;SG
peek	peeking	V;V.PTCP;PRS
smell	countable	N;PL
mommy	mommy	N;SG
spear	spear	N;SG
dog	dog	N;SG
bang	banging	V;V.PTCP;PRS
letter	letter	N;SG
hang	hang	V;NFIN
back	back	N;SG
lose	lost	V;V.PTCP;PST
trade	trade	V;NFIN
dance	dance	N;SG
make	made	V;V.PTCP;PST
wash	wash	N;SG
forehead	forehead	N;SG
teach	teach	N;SG
tear	teared	V;PST
finish	finished	V;V.PTCP;PST
care	care	V;NFIN
bone	bones	N;PL
tum	tum	N;SG
smear	smeared	V;PST
noodle	noodles	N;PL
bug	bug	N;SG
step	steps	N;PL
stand	stand	N;SG
fly	fly	V;NFIN
go	going	V;V.PTCP;PRS
attendance	attendance	N;SG
crawl	crawl	N;SG
goose	goose	N;SG
shake	shake	V;NFIN
try	trying	V;V.PTCP;PRS
deep	deep	N;SG
clean	clean	V;NFIN
crunch	crunching	V;V.PTCP;PRS
call	called	V;PST
darn	darn	V;NFIN
forget	forget	V;NFIN
bridge	bridge	N;SG
name	named	V;PST
peach	peach	N;SG
way	ways	N;PL
towel	towel	N;SG
bow	bow	N;SG
brush	brush	N;SG
open	open	N;SG
sir	sir	N;SG
bib	bib	N;SG
while	while	N;SG
coke	coke	N;SG
starfish	starfish	N;SG
sugar	sugar	N;SG
crawl	crawl	V;NFIN
play	played	V;PST
dump	dump	N;SG
garden	garden	N;SG
white	white	N;SG
screen	screen	N;SG
cap	cap	N;SG
take	taken	V;V.PTCP;PST
jingle	jingle	V;NFIN
ring	ring	V;NFIN
lioness	lioness	N;SG
part	part	N;SG
husband	husband	N;SG
grape	countable	N;PL
carriage	carriage	N;SG
bat	bats	N;PL
job	job	N;SG
peel	peel	V;NFIN
cut	cut	V;NFIN
feel	feeling	V;V.PTCP;PRS
bump	bump	N;SG
bunny	bunnies	N;PL
bridle	bridle	N;SG
d_v_d	d_v_d	N;SG
badger	badger	N;SG
picnic	picnic	N;SG
capital	capital	N;SG
work	work	N;SG
pat	pat	V;NFIN
imitate	imitate	V;NFIN
miss	miss	N;SG
sleep	sleep	N;SG
pack	pack	N;SG
spirit	spirit	N;SG
message	message	N;SG
finger	finger	N;SG
window	window	N;SG
have	having	V;V.PTCP;PRS
whistle	whistle	N;SG
nest	nest	N;SG
grill	grilled	V;PST
wrinkle	wrinkled	V;V.PTCP;PST
chocolate	chocolate	N;SG
billion	billions	N;PL
worry	worry	V;NFIN
question	questions	N;PL
end	end	N;SG
son	son	N;SG
sit	sat	V;PST
get	getting	V;V.PTCP;PRS
bush	bushes	N;PL
sailor	sailor	N;SG
name	named	V;V.PTCP;PST
grab	grabbed	V;PST
pull	pulling	V;V.PTCP;PRS
dryer	dryer	N;SG
stick	countable	N;PL
miss	missed	V;PST
climb	climbed	V;PST
roll	rolling	V;V.PTCP;PRS
closet	closet	N;SG
live	living	V;V.PTCP;PRS
pear	pears	N;PL
frustrate	frustrate	N;SG
speak	speak	V;NFIN
pimple	pimples	N;PL
work	countable	N;PL
antelope	antelope	N;SG
tree	tree	N;SG
splinter	splinter	V;NFIN
garbage	garbage	N;SG
movie	movies	N;PL
puzzle	puzzles	N;PL
milk	milk	N;SG
charge	charge	V;NFIN
grandma	grandmas	N;PL
lap	lap	N;SG
treasure	treasure	N;SG
leg	leg	N;SG
write	write	V;NFIN
lizard	lizard	N;SG
cool	cool	V;NFIN
stretch	stretch	N;SG
flag	flag	N;SG
day	days	N;PL
squeeze	squeeze	N;SG
rescue	rescue	V;NFIN
tray	tray	N;SG
cracker	cracker	N;SG
swallow	swallowed	V;PST
feather	feathered	V;V.PTCP;PST
eat	ate	V;PST
lot	lot	N;SG
game	game	V;NFIN
beach	beach	N;SG
suppose	supposed	V;V.PTCP;PST
basement	basement	N;SG
chance	chance	N;SG
ketchup	ketchup	N;SG
cuckoo	cuckoo	N;SG
drop	dropped	V;PST
sort	sort	N;SG
poison	poison	N;SG
count	count	N;SG
transmit	transmit	V;NFIN
line	line	N;SG
protein	protein	N;SG
need	need	N;SG
artichoke	artichoke	N;SG
hum	hum	V;NFIN
ice	ice	N;SG
koala	koala	N;SG
paper	paper	N;SG
lion	lion	N;SG
verb	verbs	N;PL
dare	dare	V;NFIN
rhinoceros	rhinoceros	N;SG
tricycle	tricycle	N;SG
mammy	mammy	N;SG
toe	toes	N;PL
daddy	daddy	N;SG
crayon	crayon	N;SG
show	showed	V;PST
boss	boss	N;SG
frog	frogs	N;PL
come	came	V;PST
bother	bother	V;NFIN
kid	kids	N;PL
dress	dress	V;NFIN
chew	chew	V;NFIN
uncle	uncle	N;SG
puppet	puppet	N;SG
mine	mine	N;SG
head	head	N;SG
bran	bran	N;SG
honey	honey	N;SG
truck	truck	N;SG
climb	climbing	V;V.PTCP;PRS
ship	ship	N;SG
monster	monster	N;SG
carnivore	carnivore	N;SG
tie	tie	V;NFIN
mummy	mummy	N;SG
present	present	N;SG
toy	toy	V;NFIN
bird	bird	N;SG
swim	swim	V;NFIN
cook	cooked	V;PST
flip	flipped	V;PST
blow	blow	N;SG
lego	lego	N;SG
white	white	V;NFIN
kangaroo	kangaroo	N;SG
art	art	N;SG
microwave	microwave	N;SG
guest	guests	N;PL
walk	walk	V;NFIN
put	put	V;NFIN
cross	cross	N;SG
break	break	N;SG
drip	dripped	V;PST
notice	noticed	V;V.PTCP;PST
cloth	cloth	N;SG
kitty	kitty	N;SG
help	help	V;NFIN
lime	lime	N;SG
jump	jumps	N;PL
shirt	shirt	N;SG
lemon	lemon	N;SG
straighten	straightened	V;PST
picture	pictures	N;PL
kleenex	kleenex	N;SG
person	person	N;SG
ouch	ouch	N;SG
shop	shop	N;SG
cupcake	cupcakes	N;PL
cake	cake	N;SG
wood	countable	N;PL
tire	tire	N;SG
dress	dressed	V;V.PTCP;PST
battery	battery	N;SG
somewhere	somewhere	N;SG
point	pointed	V;V.PTCP;PST
briefcase	briefcase	N;SG
beauty	beauty	N;SG
talk	talked	V;PST
nibble	nibbled	V;PST
slack	countable	N;PL
knee	knee	N;SG
stew	stew	N;SG
twinkle	twinkle	N;SG
cereal	cereal	N;SG
reach	reached	V;PST
seesaw	seesaw	N;SG
woman	woman	N;SG
cause	cause	V;NFIN
food	food	N;SG
examine	examined	V;PST
hair	hair	N;SG
pillow	pillow	N;SG
love	love	N;SG
let	let	V;NFIN
side	side	N;SG
grill	grill	N;SG
salad	salad	N;SG
carry	carried	V;PST
coffee	coffee	N;SG
spend	spend	V;NFIN
pretzel	pretzel	N;SG
ribbit	ribbit	V;NFIN
baseball	baseball	N;SG
boom	boom	N;SG
can	can	N;SG
say	saying	V;V.PTCP;PRS
can	can	V;NFIN
lime	countable	N;PL
puzzle	puzzle	N;SG
afternoon	afternoon	N;SG
moth	moth	N;SG
zebra	zebra	N;SG
fall	fallen	V;V.PTCP;PST
gate	gate	N;SG
notebook	notebook	N;SG
helmet	helmet	N;SG
pink	pinks	N;PL
hen	hens	N;PL
fridge	fridge	N;SG
sheep	sheep	N;SG
cave	cave	V;NFIN
board	board	N;SG
dog	dog	V;NFIN
mean	meaned	V;PST
vacation	vacation	N;SG
stool	stool	N;SG
friend	friends	N;PL
game	game	N;SG
poppy	poppy	N;SG
happen	happened	V;PST
knock	knocking	V;V.PTCP;PRS
blanket	blanket	N;SG
peak	peaked	V;PST
pansy	pansies	N;PL
like	liked	V;PST
brave	brave	N;SG
t_v	t_v	N;SG
walrus	walrus	N;SG
like	liked	V;V.PTCP;PST
garage	garage	N;SG
bandaid	bandaids	N;PL
touch	touching	V;V.PTCP;PRS
letter	letters	N;PL
orange	countable	N;PL
ground	ground	N;SG
sit	sitting	V;V.PTCP;PRS
come	come	V;NFIN
tune	tune	N;SG
study	study	N;SG
map	map	N;SG
wall	wall	N;SG
spill	spilled	V;PST
pencil	pencil	N;SG
door	doors	N;PL
plate	plates	N;PL
build	build	V;NFIN
apartment	apartment	N;SG
dad	dad	N;SG
tire	tired	V;V.PTCP;PST
pat	patting	V;V.PTCP;PRS
number	number	V;NFIN
lock	lock	V;NFIN
tag	tags	N;PL
wrap	wrap	V;NFIN
bat	bat	V;NFIN
show	show	N;SG
