مُخْتَفَى	المُخْتَفَى	N;NHUM;DEF;MASC;SG
دُجَى	دُجَى	N;NHUM;INDF;MASC;SG
طَرِيق	طَرِيقٌ	N;NHUM;NOM;INDF;MASC;SG
هِجْرَة	هِجْرَةِ	N;NHUM;GEN;FEM;SG;PSSD
عُمْق	أَعْماقٍ	N;NHUM;GEN;INDF;MASC;PL
ٱِعْتَمَد	تُعْتَمَدُ	V;IPFV;FEM;IND;SG;3;PASS
تِسْعُمِائَة	تِسْعَمِئَةُ	ADJ;NOM;FEM;SG;PSSD
أَشْمَل	أَشْمَلَ	ADJ;GEN;CMPR;INDF;MASC;SG
فِرْقَة	فِرْقَةُ	N;NHUM;NOM;FEM;SG;PSSD
جَمَع	تَجْمَعَ	V;IPFV;FEM;SBJV;SG;3;ACT
ساوَم	تُساوِمَ	V;IPFV;FEM;SBJV;SG;3;ACT
وَفاء	الوَفاءِ	N;NHUM;GEN;DEF;MASC;SG
حُفْرَة	حُفَرٍ	N;NHUM;GEN;INDF;FEM;PL
عاد	تَعُودُ	V;IPFV;FEM;IND;SG;3;ACT
عَمَلِيَّة	العَمَلِيّاتُ	N;NHUM;NOM;DEF;FEM;PL
رائِعَة	رَوائِعِ	N;NHUM;GEN;FEM;PL;PSSD
ٱِلْتِفاف	الاِلْتِفافُ	N;NHUM;NOM;DEF;MASC;SG
رُخْصَة	رُخْصَةً	N;NHUM;ACC;INDF;FEM;SG
ٱِنْدَفَع	تَنْدَفِعَ	V;IPFV;FEM;SBJV;SG;3;ACT
عَمَلِيَّة	عَمَلِيّاتٍ	N;NHUM;ACC;INDF;FEM;PL
حَدَّد	تُحَدِّدَ	V;IPFV;FEM;SBJV;SG;3;ACT
مُداخَلَة	مُداخَلاتٍ	N;NHUM;ACC;INDF;FEM;PL
مُناقَشَة	مُناقَشاتُ	N;NHUM;NOM;FEM;PL;PSSD
عَجْز	العَجْزِ	N;NHUM;GEN;DEF;MASC;SG
ساس	يَسُوسُ	V;IPFV;MASC;IND;SG;3;ACT
قَسّ	قَسٌّ	N;HUM;NOM;INDF;MASC;SG
ٱِخْتَزَن	يَخْتَزِنُ	V;IPFV;MASC;IND;SG;3;ACT
حَتَّم	يُحَتِّمُ	V;IPFV;MASC;IND;SG;3;ACT
حاجَة	حاجاتِ	N;NHUM;GEN;FEM;PL;PSSD
ٱِخْتَرَع	نَخْتَرِعَ	V;IPFV;SBJV;PL;1;ACT
مُوازاة	مُوازاةِ	N;NHUM;GEN;FEM;SG;PSSD
نِعْمَة	نِعَمٍ	N;NHUM;GEN;INDF;FEM;PL
مَعْرُوف	مَعْرُوفَ	ADJ;ACC;MASC;SG;PSSD
أَخ	إِخْوَةً	N;HUM;ACC;INDF;MASC;PL
تَصْوِيب	التَّصْوِيبِ	N;NHUM;GEN;DEF;MASC;SG
مُسْتَبْعَد	المُسْتَبْعَدِ	N;NHUM;GEN;DEF;MASC;SG
فَلَت	يَفْلِتُ	V;IPFV;MASC;IND;SG;3;ACT
فَتْح	الفُتُوحاتِ	N;NHUM;ACC;DEF;MASC;PL
فائِز	فائِزَةٍ	N;HUM;GEN;INDF;FEM;SG
وَحِيد	الوَحِيدَ	ADJ;ACC;DEF;MASC;SG
مَجّانِيَّة	مَجّانِيَّةٍ	N;NHUM;GEN;INDF;FEM;SG
أُعْجُوبَة	الأَعاجِيبِ	N;NHUM;GEN;DEF;FEM;PL
خُلْسَة	الخُلْسَةَ	N;NHUM;ACC;DEF;FEM;SG
ٱِسْتَجْوَب	يَسْتَجْوِبَ	V;IPFV;MASC;SBJV;SG;3;ACT
مُدَرِّب	مُدَرِّباً	N;HUM;ACC;INDF;MASC;SG
مَيْدانِيّ	مَيْدانِيّاً	ADJ;ACC;INDF;MASC;SG
عِراقِيّ	العِراقِيَّ	ADJ;ACC;DEF;MASC;SG
مَفْقُود	مَفْقُودٍ	N;HUM;GEN;INDF;MASC;SG
فَرْحَة	فَرْحَةِ	N;NHUM;GEN;FEM;SG;PSSD
قَذِيفَة	قَذِيفَةٍ	N;NHUM;GEN;INDF;FEM;SG
آتِي	الآتِينَ	ADJ;ACC;DEF;MASC;PL
مَوَّل	تُمَوِّلُ	V;IPFV;FEM;IND;SG;3;ACT
ٱِتِّصال	الاِتِّصالاتِ	N;NHUM;ACC;DEF;MASC;PL
مُسْتَقْبَلِيّ	مُسْتَقْبَلِيٍّ	ADJ;GEN;INDF;MASC;SG
عالِم	العُلَماءُ	N;HUM;NOM;DEF;MASC;PL
ٱِشْتَدّ	يَشْتَدُّ	V;IPFV;MASC;IND;SG;3;ACT
أَحْيَى	تُحْيِي	V;IPFV;FEM;IND;SG;3;ACT
جُنْدِيّ	الجُنْدِيّانِ	N;HUM;NOM;DEF;MASC;DU
ٱِنْتِهاك	اِنْتِهاكاتٍ	N;NHUM;GEN;INDF;MASC;PL
تَكْلِيف	التَّكالِيفَ	N;NHUM;ACC;DEF;MASC;PL
فَرِيق	فَرِيقَ	N;NHUM;ACC;MASC;SG;PSSD
ٱِسْتَحْسَن	يَسْتَحْسِنْ	V;IPFV;MASC;JUS;SG;3;ACT
دَرَك	الدَّرَكِ	N;NHUM;GEN;DEF;MASC;SG
أَهْل	أَهْلٌ	N;HUM;NOM;INDF;MASC;SG
فَرَج	الفَرَجُ	N;NHUM;NOM;DEF;MASC;SG
شَقِيق	شَقِيقُ	N;HUM;NOM;MASC;SG;PSSD
تَفَهُّم	التَّفَهُّمِ	N;NHUM;GEN;DEF;MASC;SG
مُغَيَّب	مُغَيَّبَيْنِ	ADJ;ACC;INDF;MASC;DU
قائِم	القائِمِينَ	N;HUM;ACC;DEF;MASC;PL
مُتَشَدِّد	مُتَشَدِّدُونَ	N;HUM;NOM;INDF;MASC;PL
مَشَى	نَمْشِيَ	V;IPFV;SBJV;PL;1;ACT
قُوَّة	القُوَى	N;NHUM;DEF;FEM;PL
حَصْر	حَصْرِ	N;NHUM;GEN;MASC;SG;PSSD
خَبَّأ	خَبَّأْتُ	V;PFV;IND;SG;1;ACT
تَوالَى	تَتَوالَى	V;IPFV;FEM;IND;SG;3;ACT
كُرْدِيّ	أَكْراداً	N;HUM;ACC;INDF;MASC;PL
تَزْوِيد	تَزْوِيدَ	N;NHUM;ACC;MASC;SG;PSSD
تَلا	تُتْلَى	V;IPFV;FEM;IND;SG;3;PASS
أَسْهَل	أَسْهَلَ	ADJ;ACC;CMPR;INDF;FEM;SG
أَسَّس	تُؤَسَّسَ	V;IPFV;FEM;SBJV;SG;3;PASS
مَنْظُور	مَنْظُورِ	N;NHUM;GEN;MASC;SG;PSSD
شارِع	شارِعِ	N;NHUM;GEN;MASC;SG;PSSD
مُؤْتَمَر	المُؤْتَمَرُ	N;NHUM;NOM;DEF;MASC;SG
سُلَّم	السُّلَّمِ	N;NHUM;GEN;DEF;MASC;SG
هِلِكُوبْتَر	هِلِيكُوبْتَر	N;NHUM;INDF;FEM;SG
رِسالَة	رِسالَةَ	N;NHUM;ACC;FEM;SG;PSSD
تَرْخِيص	تَراخِيصَ	N;NHUM;ACC;MASC;PL;PSSD
رَوَى	يَرْوِي	V;IPFV;MASC;IND;SG;3;ACT
عَسْكَرِيّ	عَسْكَرِيٍّ	ADJ;GEN;INDF;MASC;SG
تَعْوِيض	تَعْوِيضَ	N;NHUM;ACC;MASC;SG;PSSD
ذَخِيرَة	ذَخِيرَةِ	N;NHUM;GEN;FEM;SG;PSSD
تَقاضِي	التَّقاضِي	N;NHUM;DEF;MASC;SG
مِفْتاح	مِفْتاحِ	N;NHUM;GEN;MASC;SG;PSSD
تَرابَط	تَتَرابَطُ	V;IPFV;FEM;IND;SG;3;ACT
مانِع	مانِعَ	ADJ;ACC;MASC;SG;PSSD
مُوافِق	مُوافِقِينَ	ADJ;ACC;INDF;MASC;PL
أَبْقَى	يُبْقِي	V;IPFV;MASC;IND;SG;3;ACT
هَيْكَلِيَّة	هَيْكَلِيَّةِ	N;NHUM;GEN;FEM;SG;PSSD
تَراكَض	تَتَراكَضُ	V;IPFV;FEM;IND;SG;3;ACT
ٱِجْتاز	يَجْتازَ	V;IPFV;MASC;SBJV;SG;3;ACT
وَهْم	أَوْهامٍ	N;NHUM;GEN;INDF;MASC;PL
صَعَق	صَعَقَ	N;NHUM;ACC;MASC;SG;PSSD
تَقَوْقَع	تَتَقَوْقَعَ	V;IPFV;FEM;SBJV;SG;3;ACT
فَعّالِيَّة	فَعّالِيَّةً	N;NHUM;ACC;INDF;FEM;SG
ٱِفْتَقَد	تَفْتَقِدُ	V;IPFV;FEM;IND;SG;3;ACT
ظاهِر	ظاهِرَةِ	N;NHUM;GEN;FEM;SG;PSSD
وَضَع	تُوضَعَ	V;IPFV;FEM;SBJV;SG;3;PASS
عَطَّر	يُعَطِّرْنَ	V;IPFV;FEM;PL;3;ACT
ٱِصْطِياف	الاِصْطِيافِ	N;NHUM;GEN;DEF;MASC;SG
تَمَكُّن	تَمَكُّنِ	N;NHUM;GEN;MASC;SG;PSSD
سَمَّى	تُسَمِّي	V;IPFV;FEM;IND;SG;3;ACT
ساهَم	تُساهِمُ	V;IPFV;FEM;IND;SG;3;ACT
مُسَلَّح	مُسَلَّحٍ	ADJ;GEN;INDF;MASC;SG
مَصْرُوف	مَصْرُوفِ	N;NHUM;GEN;MASC;SG;PSSD
كاتِب	الكُتّابَ	N;HUM;ACC;DEF;MASC;PL
أَكْثَر	أَكْثَرِ	N;GEN;FEM;SG;PSSD
سَحَب	تُسْحَبُ	V;IPFV;FEM;IND;SG;3;PASS
ٱِسْتِشْهادِيّ	الاِسْتِشْهادِيُّونَ	N;HUM;NOM;DEF;MASC;PL
ناصِرِيّ	النّاصِرِيَّ	ADJ;ACC;DEF;MASC;SG
مُعَدَّل	المُعَدَّلُ	N;NHUM;NOM;DEF;MASC;SG
مائِدَة	مائِدَةِ	N;NHUM;GEN;FEM;SG;PSSD
ٱِسْتَمَع	يَسْتَمِعَ	V;IPFV;MASC;SBJV;SG;3;ACT
عاد	يَعُودُ	V;IPFV;MASC;IND;SG;3;ACT
مَوْلِد	المَوْلِدِ	N;NHUM;GEN;DEF;MASC;SG
عِزّ	العِزِّ	N;NHUM;GEN;DEF;MASC;SG
كَتَب	كَتَبْنا	V;PFV;IND;PL;1;ACT
مُفاوِض	مُفاوِضِينَ	N;HUM;GEN;INDF;MASC;PL
مَحَلِّيّ	المَحَلِّيِّينَ	ADJ;ACC;DEF;MASC;PL
تِشْرِين	تِشْرِين	N;NHUM;INDF;MASC;SG
شَعْبِيَّة	شَعْبِيَّةَ	N;NHUM;ACC;FEM;SG;PSSD
تَحْدِيد	التَّحْدِيدِ	N;NHUM;GEN;DEF;MASC;SG
أَصْدَر	تُصْدَرُ	V;IPFV;FEM;IND;SG;3;PASS
حَرْبَة	الحِرابِ	N;NHUM;GEN;DEF;FEM;PL
مُمارَسَة	مُمارَسَةَ	N;NHUM;ACC;FEM;SG;PSSD
فِيل	الفُيُولَ	N;NHUM;ACC;DEF;MASC;PL
شَرْعِيَّة	شَرْعِيَّةُ	N;NHUM;NOM;FEM;SG;PSSD
خِرِّيج	خِرِّيجِي	N;HUM;ACC;MASC;PL;PSSD
تَوْفِيق	التَّوْفِيقِ	N;NHUM;GEN;DEF;MASC;SG
تَقاعُس	التَّقاعُسِ	N;NHUM;GEN;DEF;MASC;SG
مُدَرَّج	مُدَرَّجاتُ	N;NHUM;NOM;MASC;PL;PSSD
مُرْتاح	مُرْتاحاً	ADJ;ACC;INDF;MASC;SG
تِشْرِين	تِشْرِينَ	N;NHUM;ACC;MASC;SG;PSSD
حَلَّق	تُحَلِّقُ	V;IPFV;FEM;IND;SG;3;ACT
مُسْتَغَلّ	مُسْتَغَلّاً	ADJ;ACC;INDF;MASC;SG
فَشِل	تَفْشَلُ	V;IPFV;FEM;IND;SG;3;ACT
عِبْء	عِبْءٌ	N;NHUM;NOM;INDF;MASC;SG
زَحَف	يَزْحَفَ	V;IPFV;MASC;SBJV;SG;3;ACT
آمِل	آمِلاً	ADJ;ACC;INDF;MASC;SG
جُمْهُورِيّ	جُمْهُورِيٍّ	ADJ;GEN;INDF;MASC;SG
هَرْوَل	تُهَرْوِلَ	V;IPFV;FEM;SBJV;SG;3;ACT
عَلَنِيّ	عَلَنِيّاً	ADJ;ACC;INDF;MASC;SG
تَناسَب	يَتَناسَبُ	V;IPFV;MASC;IND;SG;3;ACT
مُقَرَّر	المُقَرَّرِ	N;NHUM;GEN;DEF;MASC;SG
سِرّ	أَسْرارٍ	N;NHUM;GEN;INDF;MASC;PL
عَجِز	عَجِزُوا	V;PFV;MASC;IND;PL;3;ACT
أَخْطَأ	أَخْطَأُوا	V;PFV;MASC;IND;PL;3;ACT
تَوْفِير	تَوْفِيرِ	N;NHUM;GEN;MASC;SG;PSSD
إِصْرار	الإِصْرارُ	N;NHUM;NOM;DEF;MASC;SG
أَسْوَأ	أَسْوَأُ	ADJ;NOM;CMPR;FEM;SG;PSSD
شَقّ	شَقِّ	N;NHUM;GEN;MASC;SG;PSSD
أَدْنَى	الأَدْنَى	N;NHUM;DEF;MASC;SG
بَدائِيَّة	بَدائِيَّةٍ	N;NHUM;GEN;INDF;FEM;SG
مُنْتَقِم	مُنْتَقِماً	ADJ;ACC;INDF;MASC;SG
ٱِسْتَهْلَك	نَسْتَهْلِكَ	V;IPFV;SBJV;PL;1;ACT
لَحَظ	تَلْحَظُ	V;IPFV;FEM;IND;SG;3;ACT
شَكَّل	يُشَكِّلْ	V;IPFV;MASC;JUS;SG;3;ACT
أُجْرَة	الأُجْرَةَ	N;NHUM;ACC;DEF;FEM;SG
تَرْكِيز	التَّرْكِيزِ	N;NHUM;GEN;DEF;MASC;SG
أَيْدِيُولُوجِيا	الأَيْدِيُولُوجِيا	N;NHUM;DEF;FEM;SG
دائِر	الدّائِرَ	ADJ;ACC;DEF;MASC;SG
مُراهَقَة	مُراهَقَةِ	N;NHUM;GEN;FEM;SG;PSSD
نُسْخَة	نُسْخَتَيْنِ	N;NHUM;GEN;INDF;FEM;DU
ٱِغْتِيال	الاِغْتِيالِ	N;NHUM;GEN;DEF;MASC;SG
حَذَّر	تُحَذِّرْ	V;IPFV;FEM;JUS;SG;3;ACT
إِطْفاء	إِطْفاءِ	N;NHUM;GEN;MASC;SG;PSSD
لاحَظ	لاحَظُوا	V;PFV;MASC;IND;PL;3;ACT
عالَم	العالَمُ	N;NHUM;NOM;DEF;MASC;SG
ٱِسْتَفاد	يَسْتَفِيدَ	V;IPFV;MASC;SBJV;SG;3;ACT
تَكامُل	التَّكامُلِ	N;NHUM;GEN;DEF;MASC;SG
أَعْلام	أَعْلامِ	N;HUM;GEN;MASC;PL;PSSD
ضَمان	الضَّماناتِ	N;NHUM;ACC;DEF;MASC;PL
مُثابَرَة	المُثابَرَةَ	N;NHUM;ACC;DEF;FEM;SG
مِينِي	المِينِي	N;NHUM;DEF;FEM;SG
سِياحَة	سِياحَةٍ	N;NHUM;GEN;INDF;FEM;SG
مُخَصَّص	مُخَصَّصٍ	ADJ;GEN;INDF;MASC;SG
داء	داءِ	N;NHUM;GEN;MASC;SG;PSSD
شَفاعَة	شَفاعَةَ	N;NHUM;ACC;FEM;SG;PSSD
تَناقُض	التَّناقُضُ	N;NHUM;NOM;DEF;MASC;SG
عَتَبَة	العَتَبَةَ	N;NHUM;ACC;DEF;FEM;SG
رَضِيع	رَضِيعاً	ADJ;ACC;INDF;MASC;SG
تَوَلِّي	تَوَلِّيَ	N;NHUM;ACC;MASC;SG;PSSD
قائِد	قادَةٍ	N;HUM;GEN;INDF;MASC;PL
رَهِينَة	رَهائِنَ	N;NHUM;GEN;INDF;FEM;PL
لَجْنَة	اللَّجْنَةَ	N;NHUM;ACC;DEF;FEM;SG
بَيان	بَياناتُ	N;NHUM;NOM;MASC;PL;PSSD
ساعَد	يُساعِدُ	V;IPFV;MASC;IND;SG;3;ACT
أَثَر	أَثَرْتُ	V;PFV;IND;SG;1;ACT
مُذْ	مُذْ	N;NHUM;INDF;MASC;SG
نَوْعِيَّة	النَّوْعِيّاتِ	N;NHUM;GEN;DEF;FEM;PL
نَقِيب	نَقِيباً	N;HUM;ACC;INDF;MASC;SG
بِنْيَة	بِنْيَةَ	N;NHUM;ACC;FEM;SG;PSSD
غِذاء	الغِذاءُ	N;NHUM;NOM;DEF;MASC;SG
ٱِعْتَبَر	اِعْتَبَرْنا	V;PFV;IND;PL;1;ACT
تَفَقُّد	تَفَقُّدِ	N;NHUM;GEN;MASC;SG;PSSD
دِينِيّ	الدِّينِيِّ	N;NHUM;GEN;DEF;MASC;SG
حِين	أَحْيانٍ	N;NHUM;GEN;INDF;MASC;PL
ٱِسْتِحْداث	اِسْتِحْداثِ	N;NHUM;GEN;MASC;SG;PSSD
دَمار	دَمارٌ	N;NHUM;NOM;INDF;MASC;SG
رَئِيسِيّ	الرَّئِيسِيِّينَ	ADJ;ACC;DEF;MASC;PL
قَصِيدَة	قَصِيدَةُ	N;NHUM;NOM;FEM;SG;PSSD
دَرَك	دَرَكِ	N;NHUM;GEN;MASC;SG;PSSD
ٱِلْتَزَم	نَلْتَزِمَ	V;IPFV;SBJV;PL;1;ACT
تَبَيَّن	تَتَبَيَّنُ	V;IPFV;FEM;IND;SG;3;ACT
شَبَكَة	شَبَكَةُ	N;NHUM;NOM;FEM;SG;PSSD
ٱِسْتَثار	يَسْتَثِيرُ	V;IPFV;MASC;IND;SG;3;ACT
زَعامَة	زَعاماتٍ	N;NHUM;GEN;INDF;FEM;PL
حائِز	حائِزُ	N;HUM;NOM;MASC;SG;PSSD
مَقام	المَقامِ	N;NHUM;GEN;DEF;MASC;SG
مُمَثِّل	مُمَثِّلٍ	N;HUM;GEN;INDF;MASC;SG
تَصَوَّر	تَصَوَّرُوا	V;PFV;MASC;IND;PL;3;ACT
تَكَتُّم	التَّكَتُّمِ	N;NHUM;GEN;DEF;MASC;SG
مُكافَحَة	مُكافَحَةِ	N;NHUM;GEN;FEM;SG;PSSD
ذَعِن	تَذْعَنَ	V;IPFV;FEM;SBJV;SG;3;ACT
تَوارَى	يَتَوارَى	V;IPFV;MASC;IND;SG;3;ACT
دَخَل	تَدْخُلُ	V;IPFV;FEM;IND;SG;3;ACT
لَيْلِيّ	لَيْلِيٍّ	ADJ;GEN;INDF;MASC;SG
قَدْر	قَدْرٌ	N;NHUM;NOM;INDF;MASC;SG
عاش	عاشُوا	V;PFV;MASC;IND;PL;3;ACT
مُجَرَّد	مُجَرَّدِ	N;NHUM;GEN;MASC;SG;PSSD
جِنازَة	جِنازاتٍ	N;NHUM;ACC;INDF;FEM;PL
شَغُوف	شَغُوفاً	ADJ;ACC;INDF;MASC;SG
أَهَمِّيَّة	أَهَمِّيَّةٍ	N;NHUM;GEN;INDF;FEM;SG
دَعْوَة	دَعْوَةُ	N;NHUM;NOM;FEM;SG;PSSD
أَبْقَى	تُبْقِيَ	V;IPFV;FEM;SBJV;SG;3;ACT
مُشْتَقّ	المُشْتَقَّ	ADJ;ACC;DEF;MASC;SG
حَقِيبَة	حَقِيبَةَ	N;NHUM;ACC;FEM;SG;PSSD
مُنْطَلَق	مُنْطَلَقِ	N;NHUM;GEN;MASC;SG;PSSD
أُسْبُوع	أُسْبُوعٌ	N;NHUM;NOM;INDF;MASC;SG
طَلَقَة	طَلَقَةِ	N;NHUM;GEN;FEM;SG;PSSD
مُواطِن	مُواطِنُ	N;HUM;NOM;MASC;SG;PSSD
تَبادَل	تَبادَلْنا	V;PFV;IND;PL;1;ACT
وَضَّح	تُوَضِّحُ	V;IPFV;FEM;IND;SG;3;ACT
مُحْسِن	مُحْسِناً	N;HUM;ACC;INDF;MASC;SG
مُضاعَفَة	مُضاعَفَةِ	N;NHUM;GEN;FEM;SG;PSSD
صَدْمَة	صَدْمَةً	N;NHUM;ACC;INDF;FEM;SG
صَدَد	الصَّدَدِ	N;NHUM;GEN;DEF;MASC;SG
سَيْف	سَيْفٌ	N;NHUM;NOM;INDF;MASC;SG
فَرَض	يَفْرِضْ	V;IPFV;MASC;JUS;SG;3;ACT
كُولُونِيل	الكُولُونِيلَ	N;HUM;ACC;DEF;MASC;SG
جامِعَة	جامِعَةَ	N;NHUM;ACC;FEM;SG;PSSD
لاذ	لاذُوا	V;PFV;MASC;IND;PL;3;ACT
عُذْر	عُذْرَ	N;NHUM;ACC;MASC;SG;PSSD
تَوَجَّب	يَتَوَجَّبُ	V;IPFV;MASC;IND;SG;3;ACT
تَعاوُن	التَّعاوُن	N;NHUM;DEF;MASC;SG
أَقْوَى	الأَقْوَى	ADJ;DEF;MASC;SG
مَسار	المَسارُ	N;NHUM;NOM;DEF;MASC;SG
صِفَة	صِفاتِ	N;NHUM;GEN;FEM;PL;PSSD
مَدْرَسَة	مَدْرَسَةَ	N;NHUM;ACC;FEM;SG;PSSD
عِقاب	العِقابِ	N;NHUM;GEN;DEF;MASC;SG
مُؤَسَّسَة	المُؤَسَّساتِ	N;NHUM;GEN;DEF;FEM;PL
عَجَب	العَجَبِ	N;NHUM;GEN;DEF;MASC;SG
مَرْكَز	المَرْكَزَيْنِ	N;NHUM;ACC;DEF;MASC;DU
تَعَيَّن	يَتَعَيَّنُ	V;IPFV;MASC;IND;SG;3;ACT
رَضِيّ	الرَّضِيَّ	ADJ;ACC;DEF;MASC;SG
زامْبِيّ	الزّامْبِيّ	ADJ;DEF;MASC;SG
فِعْل	فِعْلَ	N;NHUM;ACC;MASC;SG;PSSD
مُرافَقَة	مُرافَقَةً	N;NHUM;ACC;INDF;FEM;SG
بَنَى	تَبْنِيَ	V;IPFV;FEM;SBJV;SG;3;ACT
وَصَل	وَصَلْنا	V;PFV;IND;PL;1;ACT
جَمْعِيَّة	جَمْعِيَّةٍ	N;NHUM;GEN;INDF;FEM;SG
نَسَمَة	نَسَمَةُ	N;NHUM;NOM;FEM;SG;PSSD
إِثْراء	الإِثْراءِ	N;NHUM;GEN;DEF;MASC;SG
جُمْعَة	جُمْعَةُ	N;NHUM;NOM;FEM;SG;PSSD
تالِي	تالٍ	ADJ;GEN;INDF;MASC;SG
مِيزَة	مِيزَتانِ	N;NHUM;NOM;INDF;FEM;DU
ٱِنْبِثاق	اِنْبِثاقٌ	N;NHUM;NOM;INDF;MASC;SG
تَعاقُد	التَّعاقُدُ	N;NHUM;NOM;DEF;MASC;SG
مَسْأَلَة	مَسائِلِ	N;NHUM;GEN;FEM;PL;PSSD
سَنّ	تَسُنُّ	V;IPFV;FEM;IND;SG;3;ACT
باكِر	باكِراً	ADJ;ACC;INDF;MASC;SG
رافِض	رافِضٍ	ADJ;GEN;INDF;MASC;SG
وَهَج	وَهَجِ	N;NHUM;GEN;MASC;SG;PSSD
هَدّاف	هَدّافاً	N;HUM;ACC;INDF;MASC;SG
ذِراع	ذِراعانِ	N;NHUM;NOM;INDF;MASC;DU
رَكْعَة	رَكْعَتَيْنِ	N;NHUM;GEN;INDF;FEM;DU
سَنَوِيّ	السَّنَوِيَّ	ADJ;ACC;DEF;MASC;SG
دِقَّة	الدِّقَّةَ	N;NHUM;ACC;DEF;FEM;SG
أَرْشَد	يُرْشِدُ	V;IPFV;MASC;IND;SG;3;ACT
تَزْفِيت	تَزْفِيتٌ	N;NHUM;NOM;INDF;MASC;SG
ثَلّاجَة	ثَلّاجَةِ	N;NHUM;GEN;FEM;SG;PSSD
صادَف	يُصادِفُ	V;IPFV;MASC;IND;SG;3;ACT
ٱِمْتِياز	الاِمْتِيازِ	N;NHUM;GEN;DEF;MASC;SG
خَيْرِيّ	خَيْرِيّاً	ADJ;ACC;INDF;MASC;SG
ثَرْوَة	ثَرْوَةٍ	N;NHUM;GEN;INDF;FEM;SG
شامِل	الشّامِلَ	ADJ;ACC;DEF;MASC;SG
مُثِير	مُثِيراً	ADJ;ACC;INDF;MASC;SG
مُنْغَلِق	مُنْغَلِقاً	ADJ;ACC;INDF;MASC;SG
قَصِيدَة	قَصائِدَ	N;NHUM;GEN;INDF;FEM;PL
شَكْلِيّ	شَكْلِيّاً	ADJ;ACC;INDF;MASC;SG
شَوَّه	يُشَوِّهُ	V;IPFV;MASC;IND;SG;3;ACT
غَرْسَة	غَرَساتِ	N;NHUM;GEN;FEM;PL;PSSD
ناجِي	ناجِينَ	ADJ;ACC;INDF;MASC;PL
نَوْع	أَنْواعَ	N;NHUM;ACC;MASC;PL;PSSD
خَطْوَة	خُطْوَتَيْنِ	N;NHUM;ACC;INDF;FEM;DU
سابِع	سابِعاً	ADJ;ACC;INDF;MASC;SG
سَرَى	يَسْرِي	V;IPFV;MASC;IND;SG;3;ACT
تَرْتِيب	تَرْتِيبَ	N;NHUM;ACC;MASC;SG;PSSD
تِلِسْكُوب	تِلِسْكُوباتٍ	N;NHUM;GEN;INDF;MASC;PL
مُرَشَّح	المُرَشَّحُونَ	N;HUM;NOM;DEF;MASC;PL
طَوّافَة	طَوّافاتٍ	N;NHUM;GEN;INDF;FEM;PL
مَنْفَذ	مَنْفَذَ	N;NHUM;ACC;MASC;SG;PSSD
ٱِكْتَسَب	يَكْتَسِبَ	V;IPFV;MASC;SBJV;SG;3;ACT
جِنْسِيّ	جِنْسِيّاً	ADJ;ACC;INDF;MASC;SG
تَبِع	يَتْبَعَ	V;IPFV;MASC;SBJV;SG;3;ACT
كَرْمَلِيّ	الكَرْمَلِيَّيْنِ	ADJ;GEN;DEF;MASC;DU
طالِب	طَلَبَةِ	N;HUM;GEN;MASC;PL;PSSD
ثابِت	ثابِتٍ	ADJ;GEN;INDF;MASC;SG
ٱِحْتِمال	اِحْتِمالِ	N;NHUM;GEN;MASC;SG;PSSD
مِصْيَدَة	مَصايِدِ	N;NHUM;GEN;FEM;PL;PSSD
مُبادَلَة	المُبادَلاتِ	N;NHUM;GEN;DEF;FEM;PL
شَرَح	شَرَحُوا	V;PFV;MASC;IND;PL;3;ACT
ذَكَر	أَذْكُرُ	V;IPFV;IND;SG;1;ACT
قُطْبِيّ	قُطْبِيٍّ	ADJ;GEN;INDF;MASC;SG
دِفاع	الدِّفاعُ	N;NHUM;NOM;DEF;MASC;SG
رَهْن	الرَّهْنِ	N;NHUM;GEN;DEF;MASC;SG
مُمَثِّل	مُمَثِّلِي	N;HUM;ACC;MASC;PL;PSSD
حَدِيقَة	حَدِيقَةً	N;NHUM;ACC;INDF;FEM;SG
راهِبَة	راهِبَةٍ	N;HUM;GEN;INDF;FEM;SG
حَصْرِيّ	الحَصْرِيِّينَ	N;NHUM;ACC;DEF;MASC;PL
ٱِخْتَصَر	يَخْتَصِرُ	V;IPFV;MASC;IND;SG;3;ACT
تَغْيِير	التَّغْيِيراتُ	N;NHUM;NOM;DEF;FEM;PL
طائِرَة	طائِرَتَيْ	N;NHUM;GEN;FEM;DU;PSSD
زُجاجَة	زُجاجاتٍ	N;NHUM;ACC;INDF;FEM;PL
دَفَع	تُدْفَعُ	V;IPFV;FEM;IND;SG;3;PASS
إِمْهال	إِمْهالَ	N;NHUM;ACC;MASC;SG;PSSD
تَحَسَّن	يَتَحَسَّنْ	V;IPFV;MASC;JUS;SG;3;ACT
دُون	دُونَ	N;NHUM;ACC;MASC;SG;PSSD
باشَر	يُباشِرْ	V;IPFV;MASC;JUS;SG;3;ACT
تَسْوِيق	تَسْوِيقِ	N;NHUM;GEN;MASC;SG;PSSD
مَرْسُوم	مَرْسُومِ	N;NHUM;GEN;MASC;SG;PSSD
إِسْكُتْلَنْدِيّ	الإِسْكُوتْلَنْدِيّ	ADJ;DEF;MASC;SG
تَجْسِيد	تَجْسِيدٌ	N;NHUM;NOM;INDF;MASC;SG
جَهِل	يَجْهَلُ	V;IPFV;MASC;IND;SG;3;ACT
مِعْيار	مَعايِيرَ	N;NHUM;GEN;INDF;MASC;PL
أُغْنِيَة	أُغْنِيَةٍ	N;NHUM;GEN;INDF;FEM;SG
حاجّ	حُجاجَ	N;HUM;ACC;MASC;PL;PSSD
مُتَّهَم	مُتَّهَمِينَ	N;HUM;ACC;INDF;MASC;PL
كاتِب	كاتِبٌ	N;HUM;NOM;INDF;MASC;SG
جُلُوس	الجُلُوسِ	N;NHUM;GEN;DEF;MASC;SG
ظُهْر	الظُّهْرِ	N;NHUM;GEN;DEF;MASC;SG
ٱِمْتِصاص	اِمْتِصاصِ	N;NHUM;GEN;MASC;SG;PSSD
وَلاء	وَلاءاتٍ	N;NHUM;GEN;INDF;MASC;PL
أَقْسَى	أَقْسَى	N;NHUM;INDF;MASC;SG
مَرْأَى	مَرْأَى	N;NHUM;INDF;MASC;SG
حَقِيقَة	حَقائِقُ	N;NHUM;NOM;FEM;PL;PSSD
قَصَد	أَقْصِدُ	V;IPFV;IND;SG;1;ACT
ٱِفْتَرَض	تَفْتَرِضُ	V;IPFV;FEM;IND;SG;3;ACT
أَكادِيمِيّ	الأَكادِيمِيِّينَ	ADJ;ACC;DEF;MASC;PL
أَتَمّ	يُتِمَّ	V;IPFV;MASC;SBJV;SG;3;ACT
كَبُر	يَكْبُرَ	V;IPFV;MASC;SBJV;SG;3;ACT
مَنْحَى	المَنْحَى	N;NHUM;DEF;MASC;SG
حافِز	الحافِزُ	N;NHUM;NOM;DEF;MASC;SG
صان	تَصُونُ	V;IPFV;FEM;IND;SG;3;ACT
نَقْل	نَقْلَ	N;NHUM;ACC;MASC;SG;PSSD
مُتَنَبِّه	مُتَنَبِّهاً	ADJ;ACC;INDF;MASC;SG
فَوْق	فَوْقِ	N;NHUM;GEN;MASC;SG;PSSD
إِفْقار	إِفْقارِ	N;NHUM;GEN;MASC;SG;PSSD
فَشَل	الفَشَلِ	N;NHUM;GEN;DEF;MASC;SG
صِناعِيّ	الصِّناعِيِّينَ	N;HUM;ACC;DEF;MASC;PL
ٱِسْتَعْصَى	تَسْتَعْصِي	V;IPFV;FEM;IND;SG;3;ACT
رَبِح	يَرْبَحُ	V;IPFV;MASC;IND;SG;3;ACT
أَنْقَذ	يُنْقِذُ	V;IPFV;MASC;IND;SG;3;ACT
ضَرِيح	ضَرِيحِ	N;NHUM;GEN;MASC;SG;PSSD
نَفْع	النَّفْعِ	N;NHUM;GEN;DEF;MASC;SG
قام	تَقُومُ	V;IPFV;FEM;IND;SG;3;ACT
حامِل	حامِلُ	ADJ;NOM;MASC;SG;PSSD
سُكْر	سُكْرٌ	N;NHUM;NOM;INDF;MASC;SG
مِنْطَقَة	مِنْطَقَةَ	N;NHUM;ACC;FEM;SG;PSSD
مُشابِه	مُشابِهٍ	ADJ;GEN;INDF;MASC;SG
لاجِئ	اللّاجِئُونَ	N;HUM;NOM;DEF;MASC;PL
بَنْك	البَنْكِ	N;NHUM;GEN;DEF;MASC;SG
مُحاضَرَة	مُحاضَرَةٍ	N;NHUM;GEN;INDF;FEM;SG
تاجِر	تُجّارٌ	N;HUM;NOM;INDF;MASC;PL
لاهُوت	اللّاهُوتِ	N;NHUM;GEN;DEF;MASC;SG
تِلْمِيذ	تَلامِذَةٍ	N;HUM;GEN;INDF;MASC;PL
تَطاوُل	التَّطاوُلِ	N;NHUM;GEN;DEF;MASC;SG
حَرَس	الحَرَسَ	N;HUM;ACC;DEF;MASC;SG
وَرْك	الوَرْكِ	N;NHUM;GEN;DEF;MASC;SG
رَذْل	رَذْلِ	N;NHUM;GEN;MASC;SG;PSSD
نُورانِيَّة	نُورانِيَّةِ	N;NHUM;GEN;FEM;SG;PSSD
فَلّ	فُلُولَ	N;NHUM;ACC;MASC;PL;PSSD
حَيّ	حَيٍّ	ADJ;GEN;INDF;MASC;SG
غادَر	تُغادِرَ	V;IPFV;FEM;SBJV;SG;3;ACT
بَقِي	يَبْقَ	V;IPFV;MASC;JUS;SG;3;ACT
عابِر	عابِراً	ADJ;ACC;INDF;MASC;SG
بَعْثَة	بَعَثاتٍ	N;NHUM;GEN;INDF;FEM;PL
صَفْقَة	صَفْقَةٍ	N;NHUM;GEN;INDF;FEM;SG
إِقْلاع	إِقْلاعِ	N;NHUM;GEN;MASC;SG;PSSD
مَرْحَلِيّ	مَرْحَلِيّاً	ADJ;ACC;INDF;MASC;SG
ذات	الذّات	N;NHUM;DEF;MASC;SG
