Onkel	Onkel	N;NOM;MASC;PL
Jacke	Jacke	N;GEN;FEM;SG
schenken	schenken	V;IND;PL;3;PRS
nützen	nützen	V;IND;PL;1;PRS
Abschleppwagen	Abschleppwagen	N;NOM;MASC;PL
Quadrat	Quadrat	N;DAT;NEUT;SG
testen	teste	V;IND;SG;1;PRS
balancieren	balancierst	V;IND;SG;2;PRS
robben	robben	V;IND;PL;1;PRS
Ausstellung	Ausstellung	N;NOM;FEM;SG
angucken	gucken an	V;IND;PL;1;PRS
sprechen	spreche	V;IND;SG;1;PRS
tätigen	tätigen	V;IND;PL;3;PRS
streichen	streiche	V;IND;SG;1;PRS
gewinnen	gewinnen	V;IND;PL;3;PRS
Hand	Hände	N;NOM;FEM;PL
kriegen	krieg	V;IMP;SG;2
draufdrücken	drücken drauf	V;IND;PL;3;PRS
lächeln	lächeln	V;IND;PL;1;PRS
Inhaltsverzeichnis	Inhaltsverzeichnis	N;DAT;NEUT;SG
interessieren	interessierst	V;IND;SG;2;PRS
schnäuzen	schnäuzen	V;IND;PL;1;PRS
flüchten	flüchten	V;IND;PL;1;PRS
Ursache	Ursache	N;NOM;FEM;SG
grauen	grauen	V;IND;PL;3;PRS
zahlen	zahlen	V;IND;PL;3;PRS
Neun	Neun	N;GEN;FEM;SG
Buch	Buche	N;DAT;NEUT;SG
berichten	berichte	V;IND;SG;1;PRS
Bindfaden	Bindfadens	N;GEN;MASC;SG
konzentrieren	konzentrieren	V;IND;PL;3;PRS
waschen	wasch	V;IMP;SG;2
Eismeer	Eismeere	N;DAT;NEUT;SG
treten	tritt	V;IMP;SG;2
umsetzen	setzen um	V;IND;PL;1;PRS
Telefonleitung	Telefonleitung	N;NOM;FEM;SG
wenden	wende	V;IND;SG;1;PRS
umgehen	gehen um	V;IND;PL;3;PRS
kommen	kommen	V;IND;PL;3;PRS
ziehen	ziehst	V;IND;SG;2;PRS
umkippen	kippst um	V;IND;SG;2;PRS
beginnen	begann	V;IND;SG;1;PST
berücksichtigen	berücksichtigen	V;IND;PL;3;PRS
entsorgen	entsorge	V;IND;SG;1;PRS
probieren	probieren	V;IND;PL;3;PRS
Heckklappe	Heckklappe	N;NOM;FEM;SG
richtigstellen	stellen richtig	V;IND;PL;1;PRS
Maul	Maul	N;DAT;NEUT;SG
meinen	meinten	V;SBJV;PL;1;PST
Gefährt	Gefährte	N;DAT;NEUT;SG
zocken	zock	V;IMP;SG;2
schreiten	schreiten	V;IND;PL;1;PRS
mieten	mieten	V;IND;PL;3;PRS
Lied	Lieder	N;NOM;NEUT;PL
überwinden	überwinden	V;IND;PL;1;PRS
singen	sangen	V;IND;PL;3;PST
Kabel	Kabel	N;NOM;NEUT;PL
kaputtlachen	lachen kaputt	V;IND;PL;3;PRS
Geschick	Geschicke	N;NOM;NEUT;PL
Turmspitze	Turmspitze	N;NOM;FEM;SG
greifen	greifst	V;IND;SG;2;PRS
ausspülen	spülen aus	V;IND;PL;1;PRS
Lutscher	Lutschers	N;GEN;MASC;SG
fädeln	fädeln	V;IND;PL;3;PRS
kleckern	klecker	V;IND;SG;1;PRS
Panik	Panik	N;NOM;FEM;SG
halten	halten	V;IND;PL;1;PRS
sparen	sparen	V;IND;PL;1;PRS
stapeln	stapeln	V;IND;PL;1;PRS
pusten	pustest	V;IND;SG;2;PRS
Rätsel	Rätsel	N;NOM;NEUT;PL
bücken	bücken	V;IND;PL;3;PRS
besorgen	besorge	V;IND;SG;1;PRS
Brause	Brause	N;NOM;FEM;SG
vortragen	tragen vor	V;IND;PL;3;PRS
Erdkruste	Erdkruste	N;GEN;FEM;SG
verhunzen	verhunzen	V;IND;PL;1;PRS
fallen	fällst	V;IND;SG;2;PRS
leihen	leihen	V;IND;PL;1;PRS
schaukeln	schaukel	V;IND;SG;1;PRS
Lippe	Lippen	N;NOM;FEM;PL
Linse	Linse	N;GEN;FEM;SG
singen	singst	V;IND;SG;2;PRS
husten	huste	V;IND;SG;1;PRS
erklären	erklären	V;IND;PL;1;PRS
Lieferung	Lieferung	N;NOM;FEM;SG
Schiff	Schiffe	N;DAT;NEUT;SG
Batterie	Batterie	N;NOM;FEM;SG
wachküssen	küssen wach	V;IND;PL;1;PRS
klappern	klapperst	V;IND;SG;2;PRS
plagen	plagen	V;IND;PL;3;PRS
fingern	fingerst	V;IND;SG;2;PRS
lassen	lassen	V;IND;PL;3;PRS
poltern	poltern	V;IND;PL;1;PRS
grübeln	grübeln	V;IND;PL;1;PRS
vorlesen	lesen vor	V;IND;PL;1;PRS
Motorrad	Motorrade	N;DAT;NEUT;SG
Schicksal	Schicksal	N;DAT;NEUT;SG
betrachten	betrachte	V;IND;SG;1;PRS
Oma	Omas	N;NOM;FEM;PL
Nest	Nester	N;NOM;NEUT;PL
offenlegen	legen offen	V;IND;PL;1;PRS
brechen	brichst	V;IND;SG;2;PRS
Prärie	Prärie	N;NOM;FEM;SG
zumachen	machst zu	V;IND;SG;2;PRS
Sandale	Sandale	N;NOM;FEM;SG
wippen	wippen	V;IND;PL;1;PRS
ausgeben	geben aus	V;IND;PL;3;PRS
Pferdchen	Pferdchen	N;NOM;NEUT;PL
Hausnummer	Hausnummer	N;NOM;FEM;SG
Zoo	Zoos	N;GEN;MASC;SG
Person	Personen	N;NOM;FEM;PL
Teil	Teile	N;NOM;NEUT;PL
Vorstellung	Vorstellung	N;GEN;FEM;SG
vermeiden	vermeiden	V;IND;PL;1;PRS
Anker	Anker	N;NOM;MASC;PL
Spielfeld	Spielfeld	N;DAT;NEUT;SG
Hummel	Hummel	N;NOM;FEM;SG
stoßen	stoß	V;IMP;SG;2
verhungern	verhungerst	V;IND;SG;2;PRS
fetten	fetten	V;IND;PL;1;PRS
packen	packe	V;IND;SG;1;PRS
lochen	loche	V;IND;SG;1;PRS
abschleppen	schleppen ab	V;IND;PL;3;PRS
ersehen	ersehen	V;IND;PL;3;PRS
Eiscreme	Eiscreme	N;NOM;FEM;SG
geifern	geifern	V;IND;PL;3;PRS
küssen	küssen	V;IND;PL;3;PRS
umfassen	fassen um	V;IND;PL;3;PRS
Richtung	Richtungen	N;NOM;FEM;PL
Landebahn	Landebahn	N;NOM;FEM;SG
aushalten	halten aus	V;IND;PL;1;PRS
Gebirge	Gebirge	N;DAT;NEUT;SG
warten	warten	V;IND;PL;3;PRS
Prise	Prise	N;NOM;FEM;SG
Eieruhr	Eieruhr	N;NOM;FEM;SG
legen	legst	V;IND;SG;2;PRS
rosten	rosten	V;IND;PL;1;PRS
kichern	kicher	V;IND;SG;1;PRS
backen	backen	V;IND;PL;1;PRS
knicken	knicken	V;IND;PL;1;PRS
zünden	zünden	V;IND;PL;1;PRS
Eberesche	Eberesche	N;NOM;FEM;SG
sprechen	sprichst	V;IND;SG;2;PRS
Schwelle	Schwelle	N;NOM;FEM;SG
Bus	Busse	N;NOM;MASC;PL
Mensch	Menschen	N;NOM;MASC;PL
Obst	Obste	N;DAT;NEUT;SG
Nashorn	Nashörner	N;NOM;NEUT;PL
verhungern	verhungern	V;IND;PL;1;PRS
staunen	staune	V;IND;SG;1;PRS
steigen	steigen	V;IND;PL;3;PRS
Schneckenpost	Schneckenpost	N;NOM;FEM;SG
heiligen	heiligen	V;IND;PL;1;PRS
nachdenken	denken nach	V;IND;PL;3;PRS
angeln	angeln	V;IND;PL;3;PRS
fertigen	fertigen	V;IND;PL;1;PRS
stillen	stille	V;IND;SG;1;PRS
erzittern	erzittern	V;IND;PL;1;PRS
wehen	wehen	V;IND;PL;1;PRS
weiten	weiten	V;IND;PL;1;PRS
tragen	trug	V;IND;SG;3;PST
Eidechse	Eidechse	N;NOM;FEM;SG
kürzen	kürzen	V;IND;PL;3;PRS
absteigen	steigen ab	V;IND;PL;3;PRS
überlegen	überlege	V;IND;SG;1;PRS
verbinden	verbindest	V;IND;SG;2;PRS
baden	badest	V;IND;SG;2;PRS
vorkommen	kommen vor	V;IND;PL;3;PRS
hupen	hupe	V;IND;SG;1;PRS
Brot	Broten	N;DAT;NEUT;PL
Boot	Boote	N;NOM;NEUT;PL
messen	misst	V;IND;SG;2;PRS
genügen	genügen	V;IND;PL;1;PRS
berücksichtigen	berücksichtigen	V;IND;PL;1;PRS
aushalten	halte aus	V;IND;SG;1;PRS
gurgeln	gurgeln	V;IND;PL;3;PRS
Puppe	Puppe	N;GEN;FEM;SG
reisen	reisen	V;IND;PL;1;PRS
inszenieren	inszenierst	V;IND;SG;2;PRS
kosten	kosten	V;IND;PL;1;PRS
schnurren	schnurren	V;IND;PL;3;PRS
segeln	segeln	V;IND;PL;3;PRS
biegen	biegen	V;IND;PL;1;PRS
staunen	staunst	V;IND;SG;2;PRS
walzen	walzen	V;IND;PL;1;PRS
schmieren	schmieren	V;IND;PL;3;PRS
krähen	krähen	V;IND;PL;1;PRS
erklären	erklär	V;IMP;SG;2
freuen	freuten	V;SBJV;PL;1;PST
drehen	drehten	V;SBJV;PL;1;PST
Weiche	Weiche	N;NOM;FEM;SG
Inspektion	Inspektion	N;GEN;FEM;SG
knüllen	knüllen	V;IND;PL;1;PRS
abknabbern	knabber ab	V;IMP;SG;2
wissen	wisst	V;IND;PL;2;PRS
absetzen	setzen ab	V;IND;PL;3;PRS
ausgehen	ging aus	V;IND;SG;3;PST
müssen	müssen	V;IND;PL;1;PRS
Eule	Eule	N;NOM;FEM;SG
Lösung	Lösungen	N;NOM;FEM;PL
erklären	erklärst	V;IND;SG;2;PRS
wiehern	wiehern	V;IND;PL;3;PRS
Känguru	Kängurus	N;NOM;NEUT;PL
Ausnahme	Ausnahme	N;NOM;FEM;SG
Dame	Dame	N;NOM;FEM;SG
prangen	prangen	V;IND;PL;3;PRS
Erdoberfläche	Erdoberfläche	N;NOM;FEM;SG
fluchen	fluchen	V;IND;PL;1;PRS
jubeln	jubelten	V;SBJV;PL;1;PST
ersehen	ersehen	V;IND;PL;1;PRS
schimpfen	schimpfen	V;IND;PL;1;PRS
ausbessern	bessern an	V;IND;PL;3;PRS
ausrollen	rollen aus	V;IND;PL;1;PRS
hinlegen	legst hin	V;IND;SG;2;PRS
akzeptieren	akzeptieren	V;IND;PL;1;PRS
Stuhl	Stühle	N;NOM;MASC;PL
verkraften	verkraften	V;IND;PL;3;PRS
Klapper	Klappern	N;NOM;MASC;PL
stempeln	stempeln	V;IND;PL;1;PRS
Matratze	Matratze	N;GEN;FEM;SG
heilen	heile	V;IND;SG;1;PRS
Fahrkarte	Fahrkarte	N;NOM;FEM;SG
Haufen	Haufen	N;NOM;MASC;PL
steuern	steuern	V;IND;PL;3;PRS
röntgen	röntgen	V;IND;PL;3;PRS
Kehle	Kehle	N;NOM;FEM;SG
rascheln	rascheln	V;IND;PL;1;PRS
erinnern	erinnerst	V;IND;SG;2;PRS
Plättchen	Plättchen	N;NOM;MASC;PL
müssen	musste	V;IND;SG;3;PST
schütteln	schütteln	V;IND;PL;1;PRS
Mittellinie	Mittellinie	N;NOM;FEM;SG
entführen	entführen	V;IND;PL;1;PRS
umfahren	fahren um	V;IND;PL;1;PRS
Angewohnheit	Angewohnheit	N;NOM;FEM;SG
weichen	weichen	V;IND;PL;3;PRS
liegen	lag	V;IND;SG;3;PST
erwachen	erwachen	V;IND;PL;3;PRS
Elch	Elche	N;NOM;MASC;PL
durchblättern	blättern durch	V;IND;PL;3;PRS
kommen	kommst	V;IND;SG;2;PRS
Badewanne	Badewanne	N;NOM;FEM;SG
kippen	kippst	V;IND;SG;2;PRS
Zauberer	Zauberer	N;NOM;MASC;PL
wegwerfen	werfen weg	V;IND;PL;3;PRS
Elf	Elf	N;NOM;FEM;SG
bringen	bringst	V;IND;SG;2;PRS
Fahrrad	Fahrräder	N;NOM;NEUT;PL
bedrucken	bedruckten	V;SBJV;PL;1;PST
hocken	hockst	V;IND;SG;2;PRS
Fensterbank	Fensterbank	N;GEN;FEM;SG
stürmen	stürmen	V;IND;PL;3;PRS
probieren	probierst	V;IND;SG;2;PRS
Größe	Größe	N;GEN;FEM;SG
blähen	blähen	V;IND;PL;1;PRS
erreichen	erreichen	V;IND;PL;1;PRS
anbauen	baust an	V;IND;SG;2;PRS
Taschentuch	Taschentuch	N;DAT;NEUT;SG
vorgehen	gehen vor	V;IND;PL;3;PRS
erzählen	erzähle	V;IND;SG;1;PRS
zusehen	sehen zu	V;IND;PL;3;PRS
Arie	Arie	N;GEN;FEM;SG
gestehen	gestehen	V;IND;PL;1;PRS
denunzieren	denunzieren	V;IND;PL;1;PRS
verschenken	verschenken	V;IND;PL;3;PRS
verderben	verderben	V;IND;PL;3;PRS
Kontrolle	Kontrolle	N;GEN;FEM;SG
Kost	Kost	N;NOM;FEM;SG
Waage	Waage	N;NOM;FEM;SG
finden	finde	V;IND;SG;1;PRS
abzählen	zählen ab	V;IND;PL;3;PRS
probieren	probiere	V;IND;SG;1;PRS
Blau	Blau	N;DAT;NEUT;SG
auswischen	wischen aus	V;IND;PL;3;PRS
Stamm	Stämme	N;NOM;MASC;PL
abstürzen	stürzen ab	V;IND;PL;1;PRS
Seepferdchen	Seepferdchen	N;NOM;NEUT;PL
öffnen	öffnet	V;IND;PL;2;PRS
öffnen	öffnest	V;IND;SG;2;PRS
Lenkrad	Lenkrade	N;DAT;NEUT;SG
ruinieren	ruinieren	V;IND;PL;3;PRS
Puzzle	Puzzles	N;DAT;NEUT;PL
starren	starren	V;IND;PL;3;PRS
Steckdose	Steckdose	N;GEN;FEM;SG
zerstören	zerstör	V;IMP;SG;2
aussetzen	setzen aus	V;IND;PL;3;PRS
spitzen	spitzen	V;IND;PL;1;PRS
folgen	folge	V;IND;SG;1;PRS
Fuß	Füße	N;NOM;MASC;PL
kommen	kamen	V;IND;PL;1;PST
Landung	Landung	N;NOM;FEM;SG
durchfahren	fahren durch	V;IND;PL;3;PRS
Leberwurst	Leberwurst	N;NOM;FEM;SG
Reihe	Reihe	N;GEN;FEM;SG
Muschel	Muscheln	N;NOM;FEM;PL
büßen	büßen	V;IND;PL;3;PRS
ausbessern	bessern an	V;IND;PL;1;PRS
Möglichkeit	Möglichkeiten	N;NOM;FEM;PL
bauen	bau	V;IMP;SG;2
randalieren	randalieren	V;IND;PL;1;PRS
suchen	suchst	V;IND;SG;2;PRS
trudeln	trudeln	V;IND;PL;1;PRS
Schmerz	Schmerzen	N;NOM;MASC;PL
runterfallen	fällst runter	V;IND;SG;2;PRS
Ausflug	Ausflüge	N;NOM;MASC;PL
Scholle	Scholle	N;NOM;FEM;SG
einigen	einig	V;IMP;SG;2
Gesellschaft	Gesellschaft	N;GEN;FEM;SG
benötigen	benötigten	V;SBJV;PL;1;PST
Schnalle	Schnalle	N;NOM;FEM;SG
abbinden	binden ab	V;IND;PL;1;PRS
angeln	angel	V;IND;SG;1;PRS
Mappe	Mappe	N;NOM;FEM;SG
schicken	schicke	V;IND;SG;1;PRS
Rohr	Rohre	N;GEN;NEUT;PL
Raumstation	Raumstation	N;NOM;FEM;SG
tragen	trag	V;IMP;SG;2
Birne	Birne	N;GEN;FEM;SG
fangen	fing	V;IND;SG;3;PST
enden	enden	V;IND;PL;3;PRS
Frau	Frau	N;NOM;FEM;SG
steigern	steigern	V;IND;PL;3;PRS
fernhalten	halten fern	V;IND;PL;3;PRS
Gebüsch	Gebüschen	N;DAT;NEUT;PL
schreiben	schreiben	V;IND;PL;1;PRS
sägen	sägen	V;IND;PL;3;PRS
teilen	teilst	V;IND;SG;2;PRS
schätzen	schätz	V;IMP;SG;2
abhauen	hauen ab	V;IND;PL;1;PRS
mögen	mag	V;IND;SG;1;PRS
Zeug	Zeuge	N;DAT;NEUT;SG
beschweren	beschweren	V;IND;PL;1;PRS
beißen	beiß	V;IMP;SG;2
sondern	sondern	V;IND;PL;3;PRS
jagen	jag	V;IMP;SG;2
wünschen	wünschst	V;IND;SG;2;PRS
können	könnest	V;SBJV;SG;2;PRS
Schuh	Schuh	N;NOM;MASC;PL
verschieben	verschieb	V;IMP;SG;2
säubern	säuber	V;IND;SG;1;PRS
abbauen	bauen ab	V;IND;PL;3;PRS
Orange	Orange	N;NOM;FEM;SG
umblättern	blättern um	V;IND;PL;1;PRS
Stall	Ställe	N;NOM;MASC;PL
abbiegen	bogen ab	V;IND;PL;3;PST
Laufen	Laufen	N;DAT;NEUT;SG
pinkeln	pinkeln	V;IND;PL;3;PRS
nachlesen	lesen nach	V;IND;PL;1;PRS
spucken	spuckst	V;IND;SG;2;PRS
tanken	tanken	V;IND;PL;1;PRS
gackern	gackern	V;IND;PL;3;PRS
abfahren	fahren ab	V;IND;PL;1;PRS
gelingen	gelingen	V;IND;PL;1;PRS
Brötchen	Brötchen	N;DAT;NEUT;SG
fahren	fuhr	V;IND;SG;3;PST
trampeln	trampelst	V;IND;SG;2;PRS
Gruppe	Gruppe	N;GEN;FEM;SG
schnupfen	schnupfen	V;IND;PL;1;PRS
Zahnärztin	Zahnärztin	N;GEN;FEM;SG
Adresse	Adresse	N;NOM;FEM;SG
Kunst	Kunst	N;NOM;FEM;SG
fädeln	fädeln	V;IND;PL;1;PRS
fetten	fetten	V;IND;PL;3;PRS
Regal	Regale	N;DAT;NEUT;SG
Strafe	Strafe	N;GEN;FEM;SG
herausziehen	ziehen heraus	V;IND;PL;3;PRS
verweigern	verweigern	V;IND;PL;1;PRS
verladen	verladen	V;IND;PL;1;PRS
Sitz	Sitze	N;NOM;MASC;PL
weglassen	lassen weg	V;IND;PL;3;PRS
Mauer	Mauer	N;NOM;FEM;SG
Segelschiff	Segelschiff	N;DAT;NEUT;SG
Spinne	Spinne	N;GEN;FEM;SG
Glut	Glut	N;NOM;FEM;SG
kacken	kack	V;IMP;SG;2
beruhigen	beruhigen	V;IND;PL;3;PRS
trösten	tröste	V;IND;SG;1;PRS
warten	wartet	V;IND;PL;2;PRS
Zeitlang	Zeitlang	N;NOM;FEM;SG
Doppeldecker	Doppeldecker	N;NOM;MASC;PL
Tafel	Tafel	N;NOM;FEM;SG
Segel	Segel	N;NOM;NEUT;PL
Verkehrsschild	Verkehrsschilde	N;DAT;NEUT;SG
tranchieren	tranchieren	V;IND;PL;1;PRS
grabbeln	grabbeln	V;IND;PL;1;PRS
Elster	Elster	N;NOM;FEM;SG
Auswahl	Auswahl	N;GEN;FEM;SG
Eins	Eins	N;GEN;FEM;SG
klopfen	klopfen	V;IND;PL;1;PRS
erweitern	erweitern	V;IND;PL;1;PRS
rechnen	rechnet	V;IND;PL;2;PRS
abspülen	spülen ab	V;IND;PL;1;PRS
Frühstück	Frühstücke	N;DAT;NEUT;SG
Eingang	Eingänge	N;NOM;MASC;PL
Sehenswürdigkeit	Sehenswürdigkeiten	N;NOM;FEM;PL
Geräusch	Geräusche	N;NOM;NEUT;PL
legen	legen	V;IND;PL;3;PRS
umbauen	bauen um	V;IND;PL;1;PRS
aufstehen	stehe auf	V;IND;SG;1;PRS
