bribe	bribed	V;PST
sleaze	countable	N;PL
spot	spotted	V;PST
squeal	squealed	V;PST
curl	curled	V;PST
electrolyte	electrolytes	N;PL
peach	peaches	N;PL
germinate	germinated	V;V.PTCP;PST
footprint	footprints	N;PL
destroy	destroyed	V;V.PTCP;PST
tip	tips	N;PL
tattoo	tattoed	V;V.PTCP;PST
squeeze	squeezes	N;PL
recognize	recognized	V;V.PTCP;PST
spoon	spoons	N;PL
puree	countable	N;PL
consequence	consequences	N;PL
tack	tacks	N;PL
repack	repacked	V;V.PTCP;PST
open	opens	N;PL
divorce	divorced	V;V.PTCP;PST
mush	mushed	V;V.PTCP;PST
burrow	burrows	N;PL
decorate	decorated	V;V.PTCP;PST
carve	carved	V;V.PTCP;PST
supersize	supersized	V;V.PTCP;PST
gill	gills	N;PL
estimate	estimated	V;PST
glaze	glazed	V;V.PTCP;PST
towboat	towboats	N;PL
cluck	clucked	V;V.PTCP;PST
glitch	glitches	N;PL
bracelet	bracelets	N;PL
push	countable	N;PL
microscope	microscopes	N;PL
clobber	clobbered	V;V.PTCP;PST
grampa	grampas	N;PL
crocodile	crocodiles	N;PL
spook	spooked	V;PST
unpop	unpopped	V;V.PTCP;PST
tray	trays	N;PL
grade	grades	N;PL
flop	flopped	V;V.PTCP;PST
doll	dolls	N;PL
poach	poaches	N;PL
suspend	suspended	V;PST
dada	dadas	N;PL
circus	circuses	N;PL
like	liked	V;V.PTCP;PST
spoil	spoiled	V;V.PTCP;PST
crown	crowns	N;PL
email	countable	N;PL
minnow	minnows	N;PL
shock	shocked	V;V.PTCP;PST
feel	feels	N;PL
referee	referees	N;PL
oscillate	oscillated	V;V.PTCP;PST
site	sites	N;PL
buy	bought	V;PST
quince	quinces	N;PL
blouse	blouses	N;PL
squeal	squeals	N;PL
shock	countable	N;PL
seek	sought	V;PST
water	watered	V;V.PTCP;PST
crawl	crawled	V;V.PTCP;PST
ski	skis	N;PL
statue	statues	N;PL
pinch	pinched	V;PST
have	had	V;PST
annotate	annotated	V;PST
swell	swelled	V;V.PTCP;PST
scramble	scrambles	N;PL
fixture	fixtured	V;V.PTCP;PST
blurb	blurbed	V;V.PTCP;PST
witch	witches	N;PL
number	numbers	N;PL
premeasure	premeasured	V;V.PTCP;PST
wake	wakes	N;PL
press	countable	N;PL
restaurant	restaurants	N;PL
branch	branched	V;PST
sprain	sprained	V;PST
dip	dipped	V;V.PTCP;PST
tit	tits	N;PL
honk	countable	N;PL
marshmallow	marshmallows	N;PL
cause	caused	V;PST
throat	throats	N;PL
sound	sounded	V;PST
coil	coils	N;PL
bone	bones	N;PL
tepee	tepees	N;PL
cheese	countable	N;PL
tour	tours	N;PL
step	stepped	V;PST
stab	stabbed	V;PST
orange	countable	N;PL
pen	pens	N;PL
participant	participants	N;PL
wig	wigs	N;PL
trick	tricked	V;PST
rhino	rhinos	N;PL
doll	dolled	V;V.PTCP;PST
spook	spooks	N;PL
legging	leggings	N;PL
packet	packets	N;PL
halve	halved	V;V.PTCP;PST
drool	drooled	V;V.PTCP;PST
detector	detectors	N;PL
disguise	disguised	V;V.PTCP;PST
unscrew	unscrewed	V;PST
finish	finished	V;V.PTCP;PST
depress	depressed	V;V.PTCP;PST
escape	escaped	V;V.PTCP;PST
fern	ferns	N;PL
hide	hid	V;V.PTCP;PST
gremlin	gremlins	N;PL
volunteer	volunteered	V;PST
swoop	swooped	V;V.PTCP;PST
zoom	zoomed	V;V.PTCP;PST
sort	sorted	V;V.PTCP;PST
bangle	bangles	N;PL
surf	countable	N;PL
speckle	speckled	V;PST
mutter	muttered	V;PST
fetch	fetched	V;PST
tan	tanned	V;V.PTCP;PST
unwrap	unwrapped	V;PST
grate	grates	N;PL
vent	vents	N;PL
paycheck	paychecks	N;PL
bury	buried	V;V.PTCP;PST
bandage	bandages	N;PL
kibble	countable	N;PL
find	found	V;V.PTCP;PST
trip	tripped	V;V.PTCP;PST
nickle	nickles	N;PL
magnetize	magnetized	V;PST
draw	drawn	V;V.PTCP;PST
bit	bits	N;PL
automobile	automobiles	N;PL
fasten	fastened	V;PST
insult	insulted	V;V.PTCP;PST
oblige	obliged	V;V.PTCP;PST
smock	smocks	N;PL
fund	funded	V;V.PTCP;PST
encourage	encouraged	V;PST
remake	remade	V;V.PTCP;PST
skull	skulls	N;PL
seamstress	seamstresses	N;PL
exalt	exalted	V;V.PTCP;PST
kill	kills	N;PL
fan	fans	N;PL
oversize	oversized	V;V.PTCP;PST
upload	uploaded	V;V.PTCP;PST
oppose	opposed	V;PST
drape	draped	V;PST
smush	smushed	V;V.PTCP;PST
gland	glands	N;PL
juice	juiced	V;PST
dump	dumped	V;PST
blast	blasted	V;PST
trumpet	trumpets	N;PL
gang	gangs	N;PL
follow	follows	N;PL
insert	inserted	V;PST
team	teams	N;PL
crescent	crescents	N;PL
firework	fireworks	N;PL
knot	knotted	V;V.PTCP;PST
hurt	hurt	V;V.PTCP;PST
timpanist	timpanists	N;PL
epee	epees	N;PL
stare	stared	V;V.PTCP;PST
crepe	countable	N;PL
determine	determined	V;PST
chapter	chapters	N;PL
dock	docked	V;PST
cashew	cashews	N;PL
interest	interested	V;PST
image	imaged	V;PST
stab	stabbed	V;V.PTCP;PST
rise	rises	N;PL
mike	mikes	N;PL
bust	busted	V;V.PTCP;PST
cause	countable	N;PL
messenger	messengers	N;PL
knit	knits	N;PL
gaze	gazed	V;V.PTCP;PST
bop	bopped	V;PST
scramble	scrambled	V;V.PTCP;PST
davenport	davenports	N;PL
study	studied	V;V.PTCP;PST
niche	niches	N;PL
belch	belches	N;PL
low	lowed	V;PST
desert	deserted	V;PST
chain	chains	N;PL
tugboat	tugboats	N;PL
noun	nouns	N;PL
run	ran	V;PST
clarinet	clarinets	N;PL
slumber	slumbers	N;PL
tinkle	tinkled	V;PST
teenager	teenagers	N;PL
inside	insides	N;PL
press	pressed	V;PST
exit	exits	N;PL
gallop	gallops	N;PL
slave	slaves	N;PL
reduce	reduced	V;V.PTCP;PST
unbalance	unbalanced	V;V.PTCP;PST
mitten	mittens	N;PL
read	reads	N;PL
domino	dominos	N;PL
poo	pooed	V;V.PTCP;PST
appear	appeared	V;V.PTCP;PST
pig	pigs	N;PL
watch	watches	N;PL
stile	stiles	N;PL
vowel	vowels	N;PL
chow	chowed	V;PST
boost	boosts	N;PL
lace	countable	N;PL
twinkie	twinkies	N;PL
locate	located	V;V.PTCP;PST
grin	grinned	V;PST
soak	soaked	V;V.PTCP;PST
barbie	barbies	N;PL
plaster	plastered	V;V.PTCP;PST
stuff	stuffed	V;V.PTCP;PST
whack	whacks	N;PL
suck	sucked	V;PST
ply	countable	N;PL
foal	foals	N;PL
sip	sips	N;PL
suitcase	suitcases	N;PL
saber	sabers	N;PL
paw	pawed	V;PST
coffee	countable	N;PL
grind	countable	N;PL
hold	held	V;V.PTCP;PST
liver	countable	N;PL
pickle	pickled	V;PST
bruise	bruised	V;V.PTCP;PST
chew	chewed	V;PST
flush	flushed	V;V.PTCP;PST
litter	littered	V;V.PTCP;PST
swap	swapped	V;V.PTCP;PST
inch	inches	N;PL
spend	spent	V;PST
tab	tabs	N;PL
unhook	unhooked	V;PST
raid	raided	V;PST
deflate	deflated	V;V.PTCP;PST
download	downloaded	V;V.PTCP;PST
pound	pounded	V;PST
untack	untacked	V;V.PTCP;PST
synthesize	synthesized	V;PST
lick	licked	V;V.PTCP;PST
swear	sweared	V;PST
echo	echoed	V;PST
costume	countable	N;PL
phoneme	phonemes	N;PL
blanket	blankets	N;PL
shrink	shrank	V;PST
worry	countable	N;PL
circle	circled	V;PST
start	starts	N;PL
toast	toasted	V;PST
discourage	discouraged	V;PST
bong	bonged	V;V.PTCP;PST
rapture	countable	N;PL
exhaust	exhausted	V;V.PTCP;PST
stumble	stumbled	V;PST
sleepover	sleepovers	N;PL
mulberry	mulberries	N;PL
primate	primates	N;PL
ouch	ouches	N;PL
eye	eyed	V;PST
please	pleased	V;PST
clove	countable	N;PL
explain	explained	V;V.PTCP;PST
screw	screwed	V;V.PTCP;PST
alarm	alarmed	V;V.PTCP;PST
match	matched	V;V.PTCP;PST
lifeguard	lifeguards	N;PL
litter	littered	V;PST
march	marches	N;PL
pet	petted	V;V.PTCP;PST
starch	countable	N;PL
camp	camped	V;PST
grade	graded	V;PST
fun	uncountable	N;PL
gap	gaps	N;PL
rosebud	rosebuds	N;PL
iceberg	icebergs	N;PL
boulder	boulders	N;PL
sell	sold	V;PST
cadet	cadets	N;PL
use	used	V;V.PTCP;PST
system	systems	N;PL
compute	uncountable	N;PL
note	noted	V;PST
obsess	obsessed	V;PST
sweep	sweeps	N;PL
situate	situated	V;V.PTCP;PST
dye	dyed	V;V.PTCP;PST
figure	figured	V;V.PTCP;PST
spacesuit	spacesuits	N;PL
spear	spears	N;PL
attack	attacks	N;PL
rib	ribs	N;PL
crunch	crunches	N;PL
cheat	cheated	V;PST
prune	prunes	N;PL
scrap	scrapped	V;PST
magnetize	magnetized	V;V.PTCP;PST
structure	structured	V;V.PTCP;PST
ship	shipped	V;PST
operate	operated	V;PST
hornet	hornets	N;PL
place	places	N;PL
race	raced	V;V.PTCP;PST
propel	propelled	V;V.PTCP;PST
omelet	omelets	N;PL
thank	thanks	N;PL
pail	pails	N;PL
sob	sobs	N;PL
slobber	slobbered	V;V.PTCP;PST
terrify	terrified	V;V.PTCP;PST
spit	spat	V;V.PTCP;PST
derive	derived	V;PST
install	installed	V;V.PTCP;PST
antler	antlers	N;PL
moth	moths	N;PL
immigrant	immigrants	N;PL
flunk	flunked	V;V.PTCP;PST
rein	reins	N;PL
pen	penned	V;PST
mallet	mallets	N;PL
husband	husbands	N;PL
gorilla	gorillas	N;PL
unzip	unzipped	V;V.PTCP;PST
shiver	shivered	V;PST
toot	tooted	V;PST
rot	countable	N;PL
sneeze	sneezed	V;PST
locate	located	V;PST
message	messages	N;PL
whisk	whisked	V;V.PTCP;PST
erase	erases	N;PL
barrier	barriers	N;PL
decide	decided	V;PST
source	sources	N;PL
charge	charged	V;V.PTCP;PST
fight	fought	V;PST
marble	countable	N;PL
dapple	dappled	V;V.PTCP;PST
open	opened	V;PST
spiral	spiraled	V;V.PTCP;PST
dust	dusted	V;PST
handle	handled	V;V.PTCP;PST
whim	countable	N;PL
shave	shaved	V;PST
inhibit	inhibited	V;V.PTCP;PST
help	helped	V;V.PTCP;PST
female	females	N;PL
shorten	shortened	V;PST
boink	boinked	V;PST
balance	countable	N;PL
clinic	clinics	N;PL
boo	booed	V;V.PTCP;PST
notice	countable	N;PL
fall	fell	V;PST
overcast	overcast	V;V.PTCP;PST
flush	flushes	N;PL
dilapidate	dilapidated	V;V.PTCP;PST
amateur	amateurs	N;PL
haul	hauled	V;PST
daze	dazed	V;V.PTCP;PST
bang	banged	V;V.PTCP;PST
hurry	hurried	V;V.PTCP;PST
cram	crammed	V;V.PTCP;PST
bawl	bawled	V;PST
choke	choked	V;PST
wok	woks	N;PL
climate	climates	N;PL
dress	countable	N;PL
outrun	outran	V;PST
restore	restored	V;PST
landscape	landscaped	V;PST
pretend	pretended	V;PST
restore	restored	V;V.PTCP;PST
muscle	countable	N;PL
trapeze	trapezes	N;PL
fake	faked	V;PST
rustle	rustled	V;PST
sub	subs	N;PL
poison	poisoned	V;PST
centaur	centaurs	N;PL
remove	removed	V;PST
bore	bored	V;V.PTCP;PST
base	based	V;V.PTCP;PST
strut	strutted	V;PST
electrify	electrified	V;V.PTCP;PST
possible	possibles	N;PL
honk	honked	V;PST
seesaw	seesaws	N;PL
attract	attracted	V;V.PTCP;PST
song	songs	N;PL
metal	countable	N;PL
category	categories	N;PL
rain	rained	V;PST
sunflower	sunflowers	N;PL
stop	stopped	V;PST
deliver	delivered	V;V.PTCP;PST
crutch	crutches	N;PL
extract	extracted	V;V.PTCP;PST
college	colleges	N;PL
teepee	teepees	N;PL
cavern	caverns	N;PL
haw	hawed	V;PST
bungle	bungled	V;PST
sprout	sprouted	V;V.PTCP;PST
powder	powdered	V;V.PTCP;PST
bush	bushes	N;PL
unscrew	unscrewed	V;V.PTCP;PST
fan	fanned	V;PST
glow	glowed	V;PST
mine	mines	N;PL
fart	farts	N;PL
fill	filled	V;PST
eel	eels	N;PL
puggle	puggles	N;PL
soil	soiled	V;PST
tuck	tucked	V;V.PTCP;PST
kill	killed	V;V.PTCP;PST
refrigerate	refrigerated	V;V.PTCP;PST
bag	bags	N;PL
torch	torches	N;PL
stone	countable	N;PL
treasure	countable	N;PL
squoosh	squooshed	V;PST
stop	stops	N;PL
follow	followed	V;V.PTCP;PST
fort	forts	N;PL
check	checked	V;PST
hitch	hitched	V;V.PTCP;PST
add	added	V;PST
crabapple	crabapples	N;PL
supper	countable	N;PL
edge	edged	V;V.PTCP;PST
consume	consumed	V;V.PTCP;PST
microwave	microwaved	V;V.PTCP;PST
comet	comets	N;PL
tire	tires	N;PL
bewitch	bewitched	V;V.PTCP;PST
last	lasted	V;PST
bugger	buggers	N;PL
excuse	excused	V;PST
spring	sprung	V;V.PTCP;PST
stomp	stomped	V;V.PTCP;PST
brick	bricked	V;V.PTCP;PST
apologize	apologized	V;V.PTCP;PST
view	viewed	V;PST
inquire	inquired	V;PST
constellation	constellations	N;PL
mask	masked	V;V.PTCP;PST
untwist	untwisted	V;V.PTCP;PST
splash	splashes	N;PL
bruise	bruised	V;PST
erase	erased	V;V.PTCP;PST
apartment	apartments	N;PL
disguise	countable	N;PL
rust	rusted	V;V.PTCP;PST
slip	slipped	V;V.PTCP;PST
abuse	abused	V;V.PTCP;PST
comfort	comforted	V;V.PTCP;PST
bottle	bottled	V;PST
scenario	scenarios	N;PL
increment	increments	N;PL
rumble	rumbled	V;V.PTCP;PST
bum	bums	N;PL
drill	drills	N;PL
plus	pluses	N;PL
engineer	engineers	N;PL
shin	shins	N;PL
citizen	citizens	N;PL
inventor	inventors	N;PL
distort	distorted	V;PST
switch	switched	V;V.PTCP;PST
kink	kinks	N;PL
precede	preceded	V;PST
cutlet	cutlets	N;PL
bike	bikes	N;PL
blossom	blossomed	V;V.PTCP;PST
trim	countable	N;PL
contact	contacted	V;V.PTCP;PST
rack	racks	N;PL
raise	raised	V;V.PTCP;PST
develop	developed	V;PST
grab	grabbed	V;PST
scene	scenes	N;PL
mask	masks	N;PL
bribe	bribed	V;V.PTCP;PST
jerk	jerked	V;PST
muppet	muppets	N;PL
slinky	slinkies	N;PL
carry	carries	N;PL
freak	freaked	V;PST
dad	dads	N;PL
mutt	mutts	N;PL
embed	embedded	V;V.PTCP;PST
jam	countable	N;PL
jackal	jackals	N;PL
announce	announced	V;PST
skip	skips	N;PL
pace	paced	V;PST
interact	interacted	V;V.PTCP;PST
footstep	footsteps	N;PL
read	read	V;PST
poke	poked	V;PST
bible	bibles	N;PL
trickle	trickled	V;PST
charge	countable	N;PL
untie	untied	V;PST
prediction	predictions	N;PL
imagine	imagined	V;PST
grave	graves	N;PL
screw	screwed	V;PST
refresh	refreshes	N;PL
quiz	quizzes	N;PL
spot	spotted	V;V.PTCP;PST
wash	washes	N;PL
wildcat	wild	N;PL
unfurl	unfurled	V;V.PTCP;PST
copy	copies	N;PL
sort	sorted	V;PST
weenie	weenies	N;PL
bagel	bagels	N;PL
parent	parents	N;PL
drink	drank	V;V.PTCP;PST
parade	countable	N;PL
fold	folds	N;PL
run	run	V;V.PTCP;PST
exercise	exercised	V;PST
twirl	twirled	V;PST
plunge	plunged	V;PST
clementine	clementines	N;PL
favorite	favorites	N;PL
expert	experts	N;PL
con	conned	V;PST
guitar	guitars	N;PL
cover	covered	V;PST
bolt	bolted	V;PST
fluke	flukes	N;PL
cry	cries	N;PL
candidate	candidates	N;PL
trinket	trinkets	N;PL
choose	chose	V;PST
tire	tired	V;PST
halve	halved	V;PST
latch	latched	V;V.PTCP;PST
salt	salted	V;PST
zap	zaps	N;PL
impress	impressed	V;V.PTCP;PST
sign	signed	V;PST
retrieve	retrieves	N;PL
compose	composed	V;PST
walk	walked	V;V.PTCP;PST
sad	sads	N;PL
rebreak	rebroke	V;PST
heap	heaped	V;PST
camera	cameras	N;PL
punish	punished	V;V.PTCP;PST
kiwi	kiwis	N;PL
flick	flicked	V;PST
queen	queens	N;PL
collie	collies	N;PL
tic	tics	N;PL
produce	produced	V;PST
trust	trusted	V;PST
attach	attached	V;PST
care	countable	N;PL
supply	supplied	V;V.PTCP;PST
threat	threats	N;PL
granulate	granulated	V;V.PTCP;PST
embarrass	embarrassed	V;PST
pirate	pirates	N;PL
sled	sleds	N;PL
stage	stages	N;PL
begin	begun	V;V.PTCP;PST
boast	boasted	V;PST
owie	owies	N;PL
toil	toiled	V;PST
graveyard	graveyards	N;PL
look	looks	N;PL
love	loved	V;V.PTCP;PST
rat	rats	N;PL
sneer	sneered	V;V.PTCP;PST
unstaple	unstapled	V;PST
pa	pas	N;PL
boo	boos	N;PL
swear	sweared	V;V.PTCP;PST
lane	lanes	N;PL
spit	spits	N;PL
spank	spanked	V;PST
amaze	amazed	V;V.PTCP;PST
graduate	graduated	V;V.PTCP;PST
lemon	lemons	N;PL
fig	figs	N;PL
sweater	sweaters	N;PL
amuse	amused	V;PST
tuck	tucked	V;PST
coke	uncountable	N;PL
zed	zeds	N;PL
oversleep	overslept	V;V.PTCP;PST
wade	waded	V;PST
burp	burped	V;V.PTCP;PST
taxi	taxied	V;PST
irritate	irritated	V;V.PTCP;PST
nudge	nudged	V;PST
nibble	nibbled	V;V.PTCP;PST
flourish	flourished	V;PST
group	groups	N;PL
megablock	megablocks	N;PL
crystallize	crystallized	V;V.PTCP;PST
pause	pauses	N;PL
staple	stapled	V;V.PTCP;PST
flow	countable	N;PL
cud	countable	N;PL
channel	channels	N;PL
hurl	hurled	V;PST
triangle	triangles	N;PL
portray	portrayed	V;V.PTCP;PST
turn	turned	V;PST
squeak	squeaks	N;PL
scallop	scalloped	V;PST
reflect	reflected	V;V.PTCP;PST
obtain	obtained	V;V.PTCP;PST
star	starred	V;V.PTCP;PST
rhyme	countable	N;PL
empower	empowered	V;V.PTCP;PST
untape	untaped	V;V.PTCP;PST
goblin	goblins	N;PL
drug	drugged	V;V.PTCP;PST
underestimate	underestimated	V;V.PTCP;PST
hammock	hammocks	N;PL
repair	repaired	V;PST
peek	peeked	V;V.PTCP;PST
soil	soiled	V;V.PTCP;PST
file	filed	V;V.PTCP;PST
synagogue	synagogues	N;PL
jowl	jowls	N;PL
perch	perched	V;PST
crib	countable	N;PL
bootie	booties	N;PL
teeter	teetered	V;PST
heron	herons	N;PL
have	had	V;V.PTCP;PST
perform	performed	V;V.PTCP;PST
shovel	shovels	N;PL
discover	discovered	V;V.PTCP;PST
slat	slats	N;PL
listen	listened	V;PST
trim	trimmed	V;PST
supervise	supervised	V;PST
undress	undressed	V;PST
nurse	nursed	V;V.PTCP;PST
warrior	warriors	N;PL
scam	scammed	V;V.PTCP;PST
offend	offended	V;V.PTCP;PST
gate	gated	V;V.PTCP;PST
instigate	instigated	V;PST
stink	stinks	N;PL
fawn	fawns	N;PL
road	roads	N;PL
unlock	unlocked	V;PST
rent	rented	V;V.PTCP;PST
snatch	snatched	V;PST
love	loved	V;PST
flower	flowered	V;V.PTCP;PST
appear	appeared	V;PST
cuff	cuffs	N;PL
germ	germs	N;PL
explode	exploded	V;PST
desert	deserted	V;V.PTCP;PST
chime	chimed	V;PST
recipe	recipes	N;PL
gum	gums	N;PL
hate	hated	V;V.PTCP;PST
wrinkle	wrinkled	V;PST
splatter	splattered	V;PST
cassette	cassettes	N;PL
back	backed	V;PST
coffin	coffins	N;PL
scribble	countable	N;PL
squeeze	squeezed	V;PST
pass	passes	N;PL
picture	pictured	V;V.PTCP;PST
periwinkle	periwinkles	N;PL
beard	beards	N;PL
nut	nuts	N;PL
melt	melted	V;V.PTCP;PST
weasel	weasels	N;PL
lay	laid	V;V.PTCP;PST
meow	meowed	V;PST
caboose	cabooses	N;PL
clang	clanged	V;PST
wristband	wristbands	N;PL
eat	eats	N;PL
key	keyed	V;V.PTCP;PST
shack	shacks	N;PL
hatch	hatched	V;V.PTCP;PST
buttock	buttocks	N;PL
rate	rates	N;PL
starve	starf	V;PST
aim	aimed	V;PST
title	titles	N;PL
campaign	campaigned	V;PST
bandit	bandits	N;PL
decorate	decorated	V;PST
stirrup	stirrups	N;PL
undecide	undecided	V;V.PTCP;PST
vote	voted	V;PST
belly	bellies	N;PL
saucer	saucers	N;PL
slipper	slippers	N;PL
halo	halos	N;PL
fly	flew	V;PST
tap	tapped	V;V.PTCP;PST
dentist	dentists	N;PL
slam	countable	N;PL
incapacitate	incapacitated	V;V.PTCP;PST
sopaipilla	sopaipillas	N;PL
coupon	coupons	N;PL
want	wanted	V;PST
hunt	hunts	N;PL
choke	choked	V;V.PTCP;PST
cell	cells	N;PL
gnash	gnashed	V;PST
heat	heated	V;PST
hatchet	hatchets	N;PL
taillight	taillights	N;PL
bag	bagged	V;V.PTCP;PST
placemat	placemats	N;PL
splat	splatted	V;PST
zip	zips	N;PL
premake	premade	V;PST
calculate	calculated	V;PST
splutter	spluttered	V;V.PTCP;PST
spam	spammed	V;V.PTCP;PST
flat	flats	N;PL
renew	renewed	V;V.PTCP;PST
burst	burst	V;V.PTCP;PST
motorcycle	motorcycles	N;PL
peel	peeled	V;V.PTCP;PST
create	created	V;V.PTCP;PST
burn	burned	V;V.PTCP;PST
stickleback	sticklebacks	N;PL
slot	slotted	V;V.PTCP;PST
alphabet	alphabets	N;PL
tail	tails	N;PL
terrorize	terrorized	V;PST
grind	grinded	V;V.PTCP;PST
occur	occurred	V;PST
robe	robes	N;PL
pumpkin	pumpkins	N;PL
practice	practiced	V;V.PTCP;PST
electrocute	electrocuted	V;V.PTCP;PST
dip	dipped	V;PST
fanatic	fanatics	N;PL
growl	growls	N;PL
frog	frogged	V;V.PTCP;PST
call	calls	N;PL
dingbat	dingbats	N;PL
rebel	rebels	N;PL
glue	glued	V;V.PTCP;PST
presume	presumed	V;V.PTCP;PST
wet	wet	V;V.PTCP;PST
glow	glowed	V;V.PTCP;PST
hose	hosed	V;V.PTCP;PST
explore	explored	V;PST
denture	dentures	N;PL
flush	flushed	V;PST
swamp	swamps	N;PL
tip	tipped	V;PST
index	indexes	N;PL
receive	received	V;PST
publicize	publicized	V;V.PTCP;PST
reinjure	reinjured	V;V.PTCP;PST
spark	sparked	V;PST
snow	countable	N;PL
copy	copied	V;PST
calibrate	calibrated	V;V.PTCP;PST
tangle	tangled	V;PST
rock	rocked	V;PST
observe	observed	V;PST
lick	licked	V;PST
represent	represented	V;V.PTCP;PST
rid	rid	V;V.PTCP;PST
ruin	ruined	V;PST
clobber	clobbered	V;PST
establish	established	V;V.PTCP;PST
trilogy	trilogies	N;PL
send	sent	V;PST
cut	cut	V;PST
coordinate	coordinated	V;V.PTCP;PST
connect	connected	V;V.PTCP;PST
boil	boiled	V;V.PTCP;PST
rave	raved	V;PST
fill	filled	V;V.PTCP;PST
refuse	refused	V;V.PTCP;PST
linger	lingered	V;PST
fixture	fixtures	N;PL
splash	splashed	V;PST
touch	touched	V;V.PTCP;PST
scour	scoured	V;PST
uncle	uncles	N;PL
notion	notions	N;PL
whiz	whizzed	V;PST
hangnail	hangnails	N;PL
menu	menus	N;PL
mug	mugs	N;PL
crouton	croutons	N;PL
scare	scares	N;PL
bloom	countable	N;PL
puree	pureed	V;PST
tenement	tenements	N;PL
ride	rode	V;PST
bully	countable	N;PL
root	rooted	V;V.PTCP;PST
make	made	V;PST
scatter	scattered	V;PST
dig	digs	N;PL
jay	jays	N;PL
tilt	tilted	V;PST
weigh	weighed	V;PST
airplane	airplanes	N;PL
delay	delayed	V;PST
bag	bagged	V;PST
hurry	hurried	V;PST
knight	knights	N;PL
goal	goals	N;PL
recover	recovered	V;V.PTCP;PST
martyr	martyrs	N;PL
kick	kicked	V;PST
estimate	estimates	N;PL
office	offices	N;PL
faucet	faucets	N;PL
hug	hugs	N;PL
chomp	chomped	V;PST
fire	fired	V;PST
pincer	pincers	N;PL
stake	stakes	N;PL
dependent	dependents	N;PL
matey	mateys	N;PL
mother	mothers	N;PL
drum	drummed	V;PST
tourist	tourists	N;PL
case	cases	N;PL
rubber	uncountable	N;PL
pat	pats	N;PL
gain	gained	V;PST
totter	tottered	V;PST
reduce	reduced	V;PST
lunch	countable	N;PL
rash	uncountable	N;PL
cardinal	cardinals	N;PL
lid	lids	N;PL
thong	thongs	N;PL
twenty	twenties	N;PL
pineapple	pineapples	N;PL
prickle	prickles	N;PL
dimple	dimples	N;PL
rake	raked	V;V.PTCP;PST
crunch	crunched	V;V.PTCP;PST
startle	startled	V;PST
one	ones	N;PL
bread	countable	N;PL
inspire	inspired	V;PST
quack	quacked	V;V.PTCP;PST
embrace	embraced	V;PST
gnaw	gnawed	V;PST
quest	quests	N;PL
sewer	sewers	N;PL
thunder	thundered	V;PST
drench	drenched	V;V.PTCP;PST
household	households	N;PL
defeat	defeated	V;V.PTCP;PST
bundle	bundled	V;V.PTCP;PST
cream	creamed	V;PST
hang	hanged	V;V.PTCP;PST
giggle	giggles	N;PL
brush	countable	N;PL
corral	corrals	N;PL
bulb	bulbs	N;PL
stand	stands	N;PL
issue	issues	N;PL
maze	mazes	N;PL
stutter	stuttered	V;PST
cheer	cheered	V;PST
meal	meals	N;PL
hen	hens	N;PL
hypnotist	hypnotists	N;PL
prairie	prairies	N;PL
yak	yaks	N;PL
confess	confessed	V;PST
apple	apples	N;PL
grumble	grumbled	V;V.PTCP;PST
tomahawk	tomahawks	N;PL
lighthouse	lighthouses	N;PL
meet	met	V;V.PTCP;PST
disappear	disappeared	V;PST
hatch	hatched	V;PST
jam	jammed	V;PST
cuddle	cuddled	V;PST
jiggle	jiggled	V;PST
leave	leaved	V;PST
put	put	V;PST
tum	tums	N;PL
break	broken	V;V.PTCP;PST
well	wells	N;PL
toddle	toddles	N;PL
curl	curls	N;PL
flood	flooded	V;V.PTCP;PST
adjust	adjusted	V;V.PTCP;PST
rise	risen	V;V.PTCP;PST
clean	cleans	N;PL
capture	captured	V;PST
support	supported	V;V.PTCP;PST
pickle	pickles	N;PL
swallow	swallowed	V;PST
swim	swims	N;PL
weight	weighted	V;V.PTCP;PST
string	countable	N;PL
control	countable	N;PL
slack	slacked	V;V.PTCP;PST
page	paged	V;V.PTCP;PST
relative	relatives	N;PL
whatchamacallit	whatchamacallits	N;PL
huff	huffed	V;V.PTCP;PST
reach	reached	V;V.PTCP;PST
dream	dreamed	V;V.PTCP;PST
criterium	criteriums	N;PL
mile	miles	N;PL
embroider	embroidered	V;PST
pit	pits	N;PL
ruffle	ruffled	V;PST
intestine	intestines	N;PL
trail	trailed	V;PST
pry	pried	V;PST
whack	whacked	V;PST
component	components	N;PL
bug	bugs	N;PL
prisoner	prisoners	N;PL
thing	things	N;PL
stump	stumps	N;PL
sigh	sighs	N;PL
babble	babbled	V;PST
passport	passports	N;PL
reassure	reassured	V;V.PTCP;PST
occupy	occupied	V;V.PTCP;PST
plunge	plunges	N;PL
bun	buns	N;PL
dance	danced	V;V.PTCP;PST
motor	motors	N;PL
cater	caters	N;PL
chuck	chucked	V;V.PTCP;PST
reflect	reflected	V;PST
strike	stricken	V;V.PTCP;PST
blind	blinds	N;PL
gene	genes	N;PL
believe	believed	V;V.PTCP;PST
dribble	dribbled	V;V.PTCP;PST
fool	fooled	V;PST
addict	addicts	N;PL
bam	bammed	V;PST
ship	ships	N;PL
strip	stripped	V;V.PTCP;PST
die	died	V;PST
quart	quarts	N;PL
client	clients	N;PL
overlook	overlooked	V;V.PTCP;PST
lord	lords	N;PL
tyke	tykes	N;PL
spike	spiked	V;V.PTCP;PST
shadow	shadowed	V;PST
rip	ripped	V;PST
whip	whips	N;PL
shake	shakes	N;PL
deidentify	deidentified	V;V.PTCP;PST
subject	subjects	N;PL
braid	braided	V;V.PTCP;PST
itch	itched	V;PST
elder	elders	N;PL
swim	swam	V;PST
shove	shoved	V;PST
buck	bucks	N;PL
arm	arms	N;PL
process	processed	V;PST
thrill	thrills	N;PL
gain	gained	V;V.PTCP;PST
venture	ventured	V;PST
diary	diaries	N;PL
spy	spies	N;PL
vegetable	vegetables	N;PL
block	blocked	V;PST
opinion	opinions	N;PL
appendage	appendages	N;PL
invite	invited	V;V.PTCP;PST
toad	toads	N;PL
face	faced	V;PST
weather	weathered	V;PST
squid	squids	N;PL
need	needed	V;PST
scallop	scalloped	V;V.PTCP;PST
name	named	V;PST
mix	mixed	V;PST
row	rowed	V;V.PTCP;PST
kipper	kippers	N;PL
zombie	zombies	N;PL
depend	depended	V;PST
afternoon	afternoons	N;PL
separate	separated	V;PST
stutter	stuttered	V;V.PTCP;PST
bamboozle	bamboozled	V;V.PTCP;PST
name	named	V;V.PTCP;PST
fridge	fridges	N;PL
acre	acres	N;PL
author	authors	N;PL
lecture	lectured	V;PST
pee	countable	N;PL
ceiling	ceilings	N;PL
artery	arteries	N;PL
satisfy	satisfied	V;PST
unlock	unlocked	V;V.PTCP;PST
price	priced	V;V.PTCP;PST
hat	hats	N;PL
chuck	chucked	V;PST
dispose	disposed	V;V.PTCP;PST
cripple	crippled	V;V.PTCP;PST
modify	modified	V;V.PTCP;PST
necklace	necklaces	N;PL
interject	interjected	V;PST
moon	moons	N;PL
wiggle	wiggled	V;V.PTCP;PST
confirm	confirmed	V;V.PTCP;PST
ear	ears	N;PL
smear	smeared	V;PST
overhear	overheard	V;V.PTCP;PST
collect	collected	V;V.PTCP;PST
peak	peaked	V;V.PTCP;PST
mole	moles	N;PL
spurt	spurts	N;PL
huff	huffed	V;PST
freeze	froze	V;PST
story	stories	N;PL
tease	teased	V;V.PTCP;PST
nasal	nasals	N;PL
muffin	muffins	N;PL
yuck	yucks	N;PL
touch	countable	N;PL
quilt	quilted	V;PST
mouse	mice	N;PL
distance	countable	N;PL
surprise	surprised	V;V.PTCP;PST
perfect	perfected	V;V.PTCP;PST
funeral	funerals	N;PL
raisin	raisins	N;PL
pile	piled	V;PST
pay	paid	V;V.PTCP;PST
see	seen	V;V.PTCP;PST
disinterest	disinterested	V;V.PTCP;PST
anger	angered	V;PST
hiccough	hiccoughs	N;PL
disease	countable	N;PL
uncover	uncovered	V;V.PTCP;PST
aah	aahed	V;PST
banner	banners	N;PL
workbook	workbooks	N;PL
locker	lockers	N;PL
quote	quoted	V;PST
wean	weaned	V;V.PTCP;PST
servant	servants	N;PL
spud	spuds	N;PL
outdate	outdated	V;V.PTCP;PST
autograph	autographs	N;PL
cinder	cinders	N;PL
yell	yelled	V;V.PTCP;PST
spike	spiked	V;PST
machine	machines	N;PL
wind	winds	N;PL
lightning	lightninged	V;V.PTCP;PST
spread	spread	V;V.PTCP;PST
clunk	clunked	V;PST
expire	expired	V;PST
injure	injured	V;PST
score	scored	V;V.PTCP;PST
find	finds	N;PL
arch	arches	N;PL
fin	fins	N;PL
strand	strands	N;PL
specialize	specialized	V;V.PTCP;PST
scan	scans	N;PL
prime	primed	V;PST
pixie	pixies	N;PL
experience	countable	N;PL
stutter	stutters	N;PL
beast	beasts	N;PL
fly	flys	N;PL
overfill	overfilled	V;PST
buy	bought	V;V.PTCP;PST
capture	captured	V;V.PTCP;PST
plow	plowed	V;PST
pun	puns	N;PL
skirt	skirts	N;PL
freeze	freezes	N;PL
theme	themes	N;PL
rhyme	rhymed	V;PST
bounce	bounced	V;PST
pony	ponies	N;PL
joke	jokes	N;PL
faint	fainted	V;PST
carry	carried	V;PST
diet	diets	N;PL
bleep	bleeped	V;PST
stair	stairs	N;PL
tilt	tilted	V;V.PTCP;PST
peg	pegged	V;PST
shape	shaped	V;PST
kiss	kisses	N;PL
bastard	bastards	N;PL
misstate	misstated	V;V.PTCP;PST
trudge	trudged	V;PST
tape	taped	V;V.PTCP;PST
gasp	gasps	N;PL
lie	lay	V;PST
guide	guides	N;PL
able	uncountable	N;PL
doily	doilies	N;PL
resign	resigned	V;PST
wave	waved	V;PST
hide	hides	N;PL
charge	charged	V;PST
shunt	shunted	V;PST
cheer	cheered	V;V.PTCP;PST
vocal	vocals	N;PL
octagon	octagons	N;PL
pile	piles	N;PL
course	courses	N;PL
sliver	slivers	N;PL
cook	cooked	V;PST
instruct	instructed	V;PST
visit	visited	V;PST
fall	fallen	V;V.PTCP;PST
undershirt	undershirts	N;PL
trap	trapped	V;PST
toilet	toilets	N;PL
collage	countable	N;PL
cremate	cremated	V;V.PTCP;PST
dent	dents	N;PL
boat	boats	N;PL
puddle	puddles	N;PL
refrigerate	refrigerated	V;PST
unwind	unwinds	N;PL
hurricane	hurricanes	N;PL
emphasize	emphasized	V;PST
moustache	moustaches	N;PL
wire	wired	V;V.PTCP;PST
drug	drugs	N;PL
cork	corked	V;PST
punch	countable	N;PL
tap	tapped	V;PST
secure	secured	V;V.PTCP;PST
throw	threw	V;PST
welcome	welcomed	V;V.PTCP;PST
dart	darted	V;PST
undergeneralize	undergeneralized	V;V.PTCP;PST
size	sized	V;V.PTCP;PST
creak	creaked	V;PST
abandon	abandoned	V;PST
forgive	forgave	V;PST
star	starred	V;PST
musician	musicians	N;PL
mama	mamas	N;PL
dumpster	dumpsters	N;PL
endanger	endangered	V;PST
begin	begins	N;PL
prawn	countable	N;PL
musketeer	musketeers	N;PL
marigold	marigolds	N;PL
detect	detected	V;PST
barb	barbed	V;V.PTCP;PST
taste	tasted	V;V.PTCP;PST
monkey	monkeys	N;PL
mix	mixes	N;PL
groan	groans	N;PL
trample	trampled	V;PST
hay	countable	N;PL
tissue	countable	N;PL
eight	eights	N;PL
kindergartener	kindergarteners	N;PL
creep	creeped	V;PST
cripple	crippled	V;PST
braid	braids	N;PL
saw	saws	N;PL
nun	nuns	N;PL
raindrop	raindrops	N;PL
flash	flashed	V;V.PTCP;PST
deck	decks	N;PL
stretch	straight	V;PST
scooter	scooters	N;PL
necktie	neckties	N;PL
preference	uncountable	N;PL
respond	responded	V;PST
declare	declared	V;PST
dedicate	dedicated	V;V.PTCP;PST
skip	skipped	V;PST
cheetah	cheetahs	N;PL
extreme	extremes	N;PL
try	tried	V;V.PTCP;PST
milk	milked	V;V.PTCP;PST
sack	sacks	N;PL
rag	rags	N;PL
float	floated	V;V.PTCP;PST
hick	hicks	N;PL
meaning	countable	N;PL
goo	uncountable	N;PL
transfer	transferred	V;PST
rinse	rinsed	V;V.PTCP;PST
plop	plopped	V;PST
unprotect	unprotected	V;V.PTCP;PST
mistake	mistook	V;PST
baseball	baseballs	N;PL
incinerator	incinerators	N;PL
toot	tooted	V;V.PTCP;PST
trespass	countable	N;PL
hop	hopped	V;V.PTCP;PST
state	stated	V;V.PTCP;PST
slice	slices	N;PL
apology	apologies	N;PL
no	noes	N;PL
recognize	recognized	V;PST
want	wanted	V;V.PTCP;PST
muskrat	muskrats	N;PL
unfocus	unfocused	V;V.PTCP;PST
tree	trees	N;PL
cave	caved	V;V.PTCP;PST
robin	robins	N;PL
pipe	piped	V;PST
engrave	engraved	V;V.PTCP;PST
tortoise	tortoises	N;PL
blind	blinded	V;V.PTCP;PST
manage	managed	V;V.PTCP;PST
dollar	dollars	N;PL
lesson	lessons	N;PL
tramp	tramped	V;V.PTCP;PST
venture	ventured	V;V.PTCP;PST
man	manned	V;V.PTCP;PST
pilgrim	pilgrims	N;PL
wake	woke	V;PST
raid	raids	N;PL
line	lines	N;PL
divide	divided	V;PST
complete	completed	V;PST
tart	tarts	N;PL
veterinarian	veterinarians	N;PL
patrol	countable	N;PL
fix	fixed	V;PST
blow	blown	V;V.PTCP;PST
brief	briefs	N;PL
unlace	unlaced	V;V.PTCP;PST
strike	struck	V;PST
whirl	whirled	V;PST
ski	skied	V;V.PTCP;PST
whoop	whooped	V;V.PTCP;PST
build	built	V;V.PTCP;PST
moisturize	moisturized	V;V.PTCP;PST
learn	learned	V;PST
speak	spake	V;PST
reserve	reserved	V;V.PTCP;PST
affair	affairs	N;PL
consider	considered	V;V.PTCP;PST
order	ordered	V;V.PTCP;PST
unlead	unleaded	V;V.PTCP;PST
plan	planned	V;PST
renovate	renovated	V;V.PTCP;PST
snow	snew	V;PST
age	countable	N;PL
jerk	jerked	V;V.PTCP;PST
jack	jacked	V;PST
shake	shaken	V;V.PTCP;PST
freckle	freckles	N;PL
dangle	dangled	V;PST
delay	delayed	V;V.PTCP;PST
thigh	thighs	N;PL
mop	mops	N;PL
lie	lies	N;PL
advance	advanced	V;V.PTCP;PST
program	programs	N;PL
maid	maids	N;PL
kinkajou	kinkajous	N;PL
parsnip	parsnips	N;PL
study	studied	V;PST
strangle	strangled	V;V.PTCP;PST
echo	countable	N;PL
trip	tripped	V;PST
ripen	ripened	V;V.PTCP;PST
disguise	disguised	V;PST
attract	attracted	V;PST
barbecue	barbecued	V;PST
unite	united	V;PST
tribe	tribes	N;PL
finger	fingers	N;PL
cigar	cigars	N;PL
do	done	V;V.PTCP;PST
land	landed	V;V.PTCP;PST
tick	ticked	V;V.PTCP;PST
embed	embedded	V;PST
join	joined	V;PST
interpret	interpreted	V;PST
grate	grated	V;V.PTCP;PST
boil	boils	N;PL
suspend	suspended	V;V.PTCP;PST
chin	chins	N;PL
phrase	phrases	N;PL
blimp	blimps	N;PL
prime	primed	V;V.PTCP;PST
stalk	stalked	V;PST
relax	relaxed	V;PST
snuggle	snuggled	V;PST
grandpa	grandpas	N;PL
grandparent	grandparents	N;PL
knock	knocked	V;V.PTCP;PST
cake	caked	V;V.PTCP;PST
clang	clangs	N;PL
party	parties	N;PL
gulp	gulps	N;PL
frown	frowned	V;V.PTCP;PST
romp	romped	V;PST
date	dates	N;PL
berry	berries	N;PL
screen	screens	N;PL
roast	roasted	V;PST
crow	crew	V;PST
amphibian	amphibians	N;PL
scamper	scampered	V;PST
bit	bitted	V;V.PTCP;PST
hinge	hinges	N;PL
ice	iced	V;PST
disease	diseased	V;V.PTCP;PST
triple	tripled	V;PST
hamper	hampered	V;V.PTCP;PST
tablet	tablets	N;PL
ghost	ghosts	N;PL
assign	assigns	N;PL
reign	reigns	N;PL
labor	labored	V;PST
sprinkle	sprinkled	V;V.PTCP;PST
alien	aliens	N;PL
smear	smeared	V;V.PTCP;PST
sponge	countable	N;PL
cross	crossed	V;PST
brush	brushed	V;V.PTCP;PST
win	wins	N;PL
situation	situations	N;PL
snake	snakes	N;PL
rink	rinks	N;PL
soak	soaked	V;PST
talent	talents	N;PL
poo	pooed	V;PST
jump	jumped	V;V.PTCP;PST
poke	poked	V;V.PTCP;PST
fasten	fastened	V;V.PTCP;PST
tantrum	tantrums	N;PL
threaten	threatened	V;V.PTCP;PST
winkle	winkles	N;PL
wound	wounds	N;PL
stripe	striped	V;PST
bark	barked	V;PST
motivate	motivated	V;V.PTCP;PST
balance	balanced	V;PST
hone	honed	V;PST
ring	ringed	V;V.PTCP;PST
work	worked	V;V.PTCP;PST
flourish	flourished	V;V.PTCP;PST
begin	began	V;PST
burst	bursts	N;PL
broil	broiled	V;PST
scream	screams	N;PL
cycle	cycles	N;PL
dirty	dirtied	V;PST
do	did	V;PST
fumble	fumbled	V;PST
telescope	telescopes	N;PL
hawk	hawks	N;PL
bale	uncountable	N;PL
associate	associated	V;V.PTCP;PST
seclude	secluded	V;V.PTCP;PST
steer	steers	N;PL
reel	reels	N;PL
sue	sued	V;V.PTCP;PST
puss	pusses	N;PL
dodge	dodged	V;PST
instruct	instructed	V;V.PTCP;PST
lip	lipped	V;V.PTCP;PST
tag	tags	N;PL
pattern	patterns	N;PL
empty	emptied	V;V.PTCP;PST
barn	barns	N;PL
gurgle	gurgles	N;PL
tortilla	tortillas	N;PL
fool	fools	N;PL
store	stores	N;PL
miss	misses	N;PL
recommend	recommended	V;PST
mow	mows	N;PL
sixer	sixers	N;PL
flap	flaps	N;PL
disinfect	disinfected	V;PST
climb	climbed	V;V.PTCP;PST
fellow	fellows	N;PL
drink	countable	N;PL
tremble	trembled	V;PST
meatball	meatballs	N;PL
tumble	tumbled	V;PST
long	longed	V;V.PTCP;PST
sip	sipped	V;V.PTCP;PST
pimiento	pimientos	N;PL
correct	corrected	V;V.PTCP;PST
slice	sliced	V;PST
shave	shaved	V;V.PTCP;PST
beam	beamed	V;PST
bake	baked	V;V.PTCP;PST
astronomer	astronomers	N;PL
raspberry	raspberried	V;PST
unbraid	unbraided	V;V.PTCP;PST
shrivel	shriveled	V;PST
garble	garbled	V;V.PTCP;PST
blintz	blintzes	N;PL
factory	factories	N;PL
kneel	kneeled	V;PST
rail	rails	N;PL
lunge	lunged	V;PST
storm	storms	N;PL
shield	shields	N;PL
bunny	bunnies	N;PL
response	responses	N;PL
guess	guessed	V;PST
lilac	lilacs	N;PL
astonish	astonished	V;V.PTCP;PST
smurf	smurfs	N;PL
amount	amounts	N;PL
corner	cornered	V;PST
route	routes	N;PL
burn	burned	V;PST
bellow	bellows	N;PL
marine	marines	N;PL
saddle	saddles	N;PL
rod	rods	N;PL
snore	snored	V;PST
crop	cropped	V;V.PTCP;PST
woo	wooed	V;PST
prince	princes	N;PL
rumble	rumbles	N;PL
track	tracks	N;PL
intend	intended	V;V.PTCP;PST
inspire	inspired	V;V.PTCP;PST
stub	stubbed	V;PST
defrost	defrosted	V;V.PTCP;PST
unplug	unplugged	V;PST
arrow	arrows	N;PL
overcook	overcooked	V;V.PTCP;PST
handicap	handicapped	V;V.PTCP;PST
hush	hushed	V;V.PTCP;PST
stroll	strolls	N;PL
curl	curled	V;V.PTCP;PST
cruise	cruised	V;PST
bow	bowed	V;PST
master	masters	N;PL
publish	published	V;PST
stilt	stilts	N;PL
yip	yips	N;PL
knee	knees	N;PL
inspect	inspected	V;PST
lapel	lapels	N;PL
strip	stripped	V;PST
taxpayer	taxpayers	N;PL
rung	rungs	N;PL
second	seconds	N;PL
trench	trenches	N;PL
loosen	loosened	V;PST
point	points	N;PL
pet	pets	N;PL
gravitate	gravitated	V;PST
descend	descended	V;V.PTCP;PST
lens	lenses	N;PL
snarl	snarled	V;V.PTCP;PST
warm	warmed	V;PST
scrapbook	scrapbooks	N;PL
pave	paved	V;V.PTCP;PST
hotel	hotels	N;PL
portion	portions	N;PL
cockle	cockled	V;V.PTCP;PST
tag	tagged	V;V.PTCP;PST
ninja	ninjas	N;PL
wad	wadded	V;V.PTCP;PST
act	acted	V;PST
hook	hooked	V;V.PTCP;PST
say	said	V;V.PTCP;PST
choose	chosen	V;V.PTCP;PST
bend	bended	V;V.PTCP;PST
wreck	wrecks	N;PL
half	halves	N;PL
sleep	slept	V;V.PTCP;PST
happen	happened	V;V.PTCP;PST
wag	wagged	V;PST
spill	spilled	V;V.PTCP;PST
tempt	tempted	V;V.PTCP;PST
undo	undid	V;PST
transcript	transcripts	N;PL
open	opened	V;V.PTCP;PST
talk	talked	V;V.PTCP;PST
coax	coaxed	V;PST
discover	discovered	V;PST
oval	ovals	N;PL
sneak	sneaks	N;PL
razor	razors	N;PL
feather	feathered	V;V.PTCP;PST
go	countable	N;PL
minute	minutes	N;PL
castanet	castanets	N;PL
improvise	improvised	V;V.PTCP;PST
ask	asked	V;PST
package	packaged	V;V.PTCP;PST
flash	flashes	N;PL
prick	pricks	N;PL
waterfall	waterfalls	N;PL
slip	slipped	V;PST
leotard	leotards	N;PL
focus	focused	V;V.PTCP;PST
hermit	hermits	N;PL
remedy	remedies	N;PL
jug	jugs	N;PL
rope	roped	V;PST
trough	troughs	N;PL
rent	rented	V;PST
investigate	investigated	V;PST
fit	fit	V;V.PTCP;PST
duckling	ducklings	N;PL
sauce	countable	N;PL
viola	violas	N;PL
villager	villagers	N;PL
pothole	potholes	N;PL
table	tables	N;PL
skedaddle	skedaddled	V;PST
slice	sliced	V;V.PTCP;PST
orient	oriented	V;PST
mattress	mattresses	N;PL
feast	feasted	V;PST
sail	sailed	V;PST
sweat	uncountable	N;PL
scratch	countable	N;PL
fang	fangs	N;PL
organize	organized	V;V.PTCP;PST
damn	damned	V;PST
smother	smothered	V;PST
expose	exposed	V;V.PTCP;PST
shout	shouts	N;PL
turd	turds	N;PL
ashtray	ashtrays	N;PL
spill	spilled	V;PST
plane	planed	V;PST
ray	rays	N;PL
shoemaker	shoemakers	N;PL
pre	uncountable	N;PL
mark	marks	N;PL
shampoo	shampooed	V;V.PTCP;PST
offend	offended	V;PST
floor	floors	N;PL
gerbil	gerbils	N;PL
back	backed	V;V.PTCP;PST
wiggle	wiggled	V;PST
overflow	overflowed	V;V.PTCP;PST
graph	graphs	N;PL
cheerio	cheerios	N;PL
mom	moms	N;PL
border	bordered	V;V.PTCP;PST
straighten	straightened	V;V.PTCP;PST
trophy	trophies	N;PL
bleach	countable	N;PL
hike	hikes	N;PL
end	ended	V;V.PTCP;PST
artichoke	artichokes	N;PL
button	buttoned	V;V.PTCP;PST
beam	beams	N;PL
cue	cues	N;PL
