حاكِم	حاكِمُونَ	ADJ;NOM;INDF;MASC;PL
تَحْلِيَة	تَحْلِياتِ	N;NHUM;GEN;SPEC;FEM;PL
حاصَر	حاصَرُوا	V;PFV;MASC;IND;PL;3;ACT
صِيام	الصِّيامِ	N;NHUM;GEN;DEF;MASC;SG
ثَمِين	ثَمِينات	ADJ;INDF;FEM;PL
عُمُولَة	عُمُولَتانِ	N;NHUM;NOM;INDF;FEM;DU
مُؤْمِن	مُؤْمِنَتَيْ	N;HUM;GEN;FEM;DU;PSSD
وُقِّع	يُوَقَّعُوا	V;IPFV;MASC;PL;3;PASS
أَقْصَى	الأَقْصَيانِ	ADJ;NOM;DEF;MASC;DU
جَوْهَر	جَوْهَرَيْ	N;NHUM;ACC;SPEC;MASC;DU
شاهِد	شاهِدَةً	ADJ;ACC;INDF;FEM;SG
دار	الدّارَيْ	N;NHUM;GEN;DEF;FEM;DU
حَرِيرِيّ	حَرِيرِيّاتِ	ADJ;ACC;FEM;PL;PSSD
مَيَّز	تُمَيِّزِي	V;IPFV;FEM;SG;2;ACT
عاقِد	عاقِدَة	N;HUM;SPEC;FEM;SG
مُتَدَلِّي	المُتَدَلِّيانِ	ADJ;NOM;DEF;MASC;DU
ٱِسْتَنْفَر	يَسْتَنْفِرانِ	V;IPFV;MASC;IND;DU;3;ACT
مُكْتَشِف	المُكْتَشِفَ	N;HUM;ACC;DEF;MASC;SG
مُنْتَخِب	مُنْتَخِبَةِ	N;HUM;GEN;FEM;SG;PSSD
مُرْتَفِع	مُرْتَفِعاتٍ	ADJ;ACC;INDF;FEM;PL
تَوَسَّط	تَوَسَّطْنا	V;PFV;IND;PL;1;ACT
جِراحَة	جِراحَةَ	N;NHUM;ACC;SPEC;FEM;SG
مُكْرَه	المُكْرَهَتَيْ	ADJ;ACC;DEF;FEM;DU;PSSD
دِرايَة	دِرايَةٌ	N;NHUM;NOM;INDF;FEM;SG
مُرادِف	مُرادِفَيْنِ	N;NHUM;GEN;INDF;MASC;DU
كامِل	كَمَلَةَ	ADJ;ACC;MASC;PL;PSSD
فاجِر	الفُجّارِ	N;HUM;GEN;DEF;MASC;PL
عُمْرانِيّ	عُمْرانِيِّ	ADJ;GEN;SPEC;MASC;SG
مُمَتِّع	المُمَتِّعُ	ADJ;NOM;DEF;MASC;SG;PSSD
مُتَظاهِر	مُتَظاهِرات	ADJ;SPEC;FEM;PL
أَرْجَع	تُرْجَعْ	V;IPFV;FEM;JUS;SG;3;PASS
جَوْلَة	جَوْلَتانِ	N;NHUM;NOM;INDF;FEM;DU
بُلُوغ	بُلُوغ	N;NHUM;INDF;MASC;SG
ضام	ضاما	V;PFV;MASC;IND;DU;3;ACT
مَلِيء	مَلِيئَةَ	ADJ;ACC;FEM;SG;PSSD
لِيرَة	لِيرَةٌ	N;NHUM;NOM;INDF;FEM;SG
جَرَد	أَجْرُدُ	V;IPFV;IND;SG;1;ACT
خَفِي	يَخْفَيانِ	V;IPFV;MASC;IND;DU;3;ACT
ٱِسْتَهْدَف	يَسْتَهْدِفُونَ	V;IPFV;MASC;IND;PL;3;ACT
مُتَقارِب	مُتَقارِباتُ	N;NHUM;NOM;SPEC;FEM;PL
مَهاجِر	مَهاجِر	N;NHUM;INDF;FEM;PL
نِيكاراغوِيّ	نِيكاراغوِيَّتَيْ	ADJ;ACC;SPEC;FEM;DU
مُناوَلَة	مُناوَلَتانِ	N;NHUM;NOM;SPEC;FEM;DU
مُتَطَوِّع	مُتَطَوِّعاتِ	ADJ;GEN;FEM;PL;PSSD
دُرِّيّ	دُرِّيَّتانِ	ADJ;NOM;INDF;FEM;DU
مَتَّع	تُمَتِّعَ	V;IPFV;MASC;SBJV;SG;2;ACT
فَرَّغ	نُفَرِّغَ	V;IPFV;SBJV;PL;1;ACT
نَشَر	نُشِرَت	V;PFV;FEM;IND;SG;3;PASS
قالِب	قالَبِ	N;NHUM;GEN;MASC;SG;PSSD
أَعْدَم	تُعْدَما	V;IPFV;MASC;DU;2;PASS
هَزَّة	هَزَّةٍ	N;NHUM;GEN;INDF;FEM;SG
مُجَمَّع	المُجَمَّعَتَيْ	ADJ;GEN;DEF;FEM;DU;PSSD
طَفِيف	الطَّفِيفَ	ADJ;ACC;DEF;MASC;SG;PSSD
مُنْتَخَب	مُنْتَخَبَيْنِ	ADJ;GEN;INDF;MASC;DU
إِدارَة	إِدارَة	N;NHUM;FEM;SG;PSSD
إِجْلال	إِجْلالاتٍ	N;NHUM;ACC;INDF;MASC;PL
ٱِلْتِحاق	اِلْتِحاقاتُ	N;NHUM;NOM;MASC;PL;PSSD
تَناوَل	تَتَناوَلْنَ	V;IPFV;FEM;PL;2;ACT
حَضَر	أَحْضُرُ	V;IPFV;IND;SG;1;ACT
مُخْتَلِط	المُخْتَلِطا	ADJ;NOM;DEF;MASC;DU;PSSD
نَعَى	تَنْعَيْ	V;IPFV;FEM;SG;2;ACT
كَذَب	أَكْذِبْ	V;IPFV;JUS;SG;1;ACT
مُحاصَر	المُحاصَراتِ	ADJ;ACC;DEF;FEM;PL
مَلَكِيّ	مَلَكِيّاتُ	ADJ;NOM;SPEC;FEM;PL
حَلِيف	حُلَفاءَ	ADJ;ACC;MASC;PL;PSSD
جافَى	تُجافَيْنَ	V;IPFV;FEM;IND;SG;2;PASS
قَلْعَة	قَلْعَةِ	N;NHUM;GEN;SPEC;FEM;SG
ٱِسْتَحْفَظ	يَسْتَحْفِظُونَ	V;IPFV;MASC;IND;PL;3;ACT
ٱِنْصَبّ	تَنْصَبّا	V;IPFV;MASC;DU;2;ACT
فَسِيح	فَسِيحَتَيْ	ADJ;GEN;SPEC;FEM;DU
فَرّار	فَرّارَ	N;HUM;ACC;SPEC;MASC;SG
سَجّادَة	سَجّادَة	N;NHUM;SPEC;FEM;SG
مُرَجِّح	المُرَجِّحَةِ	N;NHUM;GEN;DEF;FEM;SG
مُتَبَقِّي	مُتَبَقِّياتِ	N;NHUM;ACC;FEM;PL;PSSD
مَنْحُوتَة	مَنْحُوتَتا	N;NHUM;NOM;FEM;DU;PSSD
شَغْل	شَغْل	N;NHUM;INDF;MASC;SG
مُشَكِّك	مُشَكِّكَتَيْ	ADJ;ACC;SPEC;FEM;DU
إِجْمال	الإِجْمالُ	N;NHUM;NOM;DEF;MASC;SG
تَحْجِيم	تَحْجِيمَيْ	N;NHUM;ACC;MASC;DU;PSSD
عُمانِيّ	عُمانِيَّةٍ	N;HUM;GEN;INDF;FEM;SG
مُسْتَنْقَع	مُسْتَنْقَعِ	N;NHUM;GEN;SPEC;MASC;SG
مُرْتَدّ	مُرْتَدّات	N;HUM;FEM;PL;PSSD
مُعْتَدِي	مُعْتَدِيَتانِ	ADJ;NOM;SPEC;FEM;DU
كِينِيّ	كِينِيَّةَ	ADJ;ACC;FEM;SG;PSSD
عاجِل	العاجِلِينَ	ADJ;ACC;DEF;MASC;PL
تَرْفِيه	تَرْفِيهاتِ	N;NHUM;ACC;SPEC;MASC;PL
سامِي	سامِيات	ADJ;FEM;PL;PSSD
عِصامِيّ	العِصامِيَّتَيْنِ	ADJ;ACC;DEF;FEM;DU
فاعِل	فاعِلَ	ADJ;ACC;MASC;SG;PSSD
مَشْحُون	المَشْحُونِ	ADJ;GEN;DEF;MASC;SG;PSSD
مُحَيَّر	المُحَيَّرَةَ	ADJ;ACC;DEF;FEM;SG;PSSD
بَيْضاوِيّ	البَيْضاوِيَّ	ADJ;ACC;DEF;MASC;SG;PSSD
مُلاحَظَة	مُلاحَظَةَ	N;NHUM;ACC;SPEC;FEM;SG
مُنْتِج	المُنْتِج	ADJ;DEF;MASC;SG;PSSD
مَفْتُوح	المَفْتُوحاتِ	ADJ;GEN;DEF;FEM;PL;PSSD
مُبْتَكَر	المُبْتَكَرَةَ	ADJ;ACC;DEF;FEM;SG;PSSD
شاغِر	الشّاغِرَةَ	ADJ;ACC;DEF;FEM;SG
أَسْكَن	نُسْكِنْ	V;IPFV;JUS;PL;1;ACT
بَرْمَجَة	بَرْمَجاتِ	N;NHUM;GEN;FEM;PL;PSSD
مُسَجِّل	مُسَجِّلاتُ	ADJ;NOM;FEM;PL;PSSD
تَلاعُب	تَلاعُباتٌ	N;NHUM;NOM;INDF;MASC;PL
هَرْج	هَرْجَ	N;NHUM;ACC;SPEC;MASC;SG
مُتَعَثِّر	مُتَعَثِّرَيْنِ	N;NHUM;GEN;INDF;MASC;DU
مُزْعِج	المُزْعِج	ADJ;DEF;MASC;SG;PSSD
رِوْشِيّ	الرِّوْشِيَّةَ	ADJ;ACC;DEF;FEM;SG
مُخاطَب	مُخاطَبُو	N;HUM;NOM;SPEC;MASC;PL
خَطّ	يَخُطّانِ	V;IPFV;MASC;IND;DU;3;ACT
أُقْحُوان	أَقاحٍ	N;NHUM;NOM;INDF;MASC;PL
نَبَأ	نَبَأٍ	N;NHUM;GEN;INDF;MASC;SG
حَشَرِيّ	حَشَرِيّا	ADJ;NOM;MASC;DU;PSSD
نَبْض	نَبَضُ	N;NHUM;NOM;SPEC;MASC;SG
شَلّال	شَلّالاتِ	N;NHUM;GEN;MASC;PL;PSSD
سَمّاعَة	السَّمّاعَتانِ	N;NHUM;NOM;DEF;FEM;DU
أَوَّى	أَوَّيْتَ	V;PFV;MASC;IND;SG;2;ACT
مُندَلِع	مُنْدَلِعَتَيْ	ADJ;ACC;FEM;DU;PSSD
مُنْتَدَب	مُنْتَدَبُو	N;HUM;NOM;MASC;PL;PSSD
مُنْفَجِر	مُنْفَجِرٍ	ADJ;GEN;INDF;MASC;SG
أَرْجَع	تُرْجَعَ	V;IPFV;FEM;SBJV;SG;3;PASS
شَحْمِيّ	الشَّحْمِيّ	ADJ;DEF;MASC;SG
فَلْتان	فَلْتانَتَيْنِ	ADJ;GEN;INDF;FEM;DU
سَمْعِيّ	السَّمْعِيّانِ	ADJ;NOM;DEF;MASC;DU
خَلِيجِيّ	خَلِيجِيَّةِ	ADJ;GEN;FEM;SG;PSSD
مُجْبَر	مُجْبَرِي	N;NHUM;ACC;MASC;PL;PSSD
مَأْتَم	المَأْتَمُ	N;NHUM;NOM;DEF;MASC;SG
تَخْدِير	تَخْدِيرِ	N;NHUM;GEN;MASC;SG;PSSD
سارْتِرِيّ	السّارْتِرِيَّتَيْ	N;NHUM;ACC;DEF;FEM;DU
عاتِب	عاتِبِ	N;NHUM;GEN;MASC;SG;PSSD
ٱِنْزَعَج	اِنْزَعَجْتِ	V;PFV;FEM;IND;SG;2;ACT
ٱِسْتِعاضَة	الاِسْتِعاضَتَيْ	N;NHUM;GEN;DEF;FEM;DU
كَئِيب	الكَئِيبات	ADJ;DEF;FEM;PL
بَعِير	بَعِيرا	N;NHUM;NOM;MASC;DU;PSSD
مَرِيض	مَرِيضاتِ	N;HUM;GEN;SPEC;FEM;PL
طَيّار	طَيّار	N;HUM;INDF;MASC;SG
تَفاقَم	تَتَفاقَمانِ	V;IPFV;MASC;IND;DU;2;ACT
مِفَكّ	المِفَكَّيْ	N;NHUM;ACC;DEF;MASC;DU
مُمَرِّض	المُمَرِّضَةَ	N;HUM;ACC;DEF;FEM;SG
أَخْرَس	أَخْرَسَيْنِ	N;HUM;GEN;INDF;MASC;DU
ٱِسْتَحْرَم	أَسْتَحْرِمَ	V;IPFV;SBJV;SG;1;ACT
ٱِنْحِياز	الاِنْحِيازاتِ	N;NHUM;ACC;DEF;MASC;PL
رِقّ	الرِّقِّ	N;NHUM;GEN;DEF;MASC;SG
جَدّ	جَدَّةٌ	N;NHUM;NOM;INDF;FEM;SG
قُلْفَة	قُلْفَةَ	N;NHUM;ACC;FEM;SG;PSSD
تَنْقِيب	تَنْقِيباتٌ	N;NHUM;NOM;INDF;MASC;PL
أَدْهَش	تُدْهَشانِ	V;IPFV;MASC;IND;DU;2;PASS
تَماثَل	أَتَماثَلُ	V;IPFV;IND;SG;1;ACT
تَماثَل	تَتَماثَلْ	V;IPFV;FEM;JUS;SG;3;ACT
شِهاب	الشِّهابَ	N;NHUM;ACC;DEF;MASC;SG
نَقِيضَة	نَقائِضُ	N;NHUM;NOM;FEM;PL;PSSD
فَوْضَوِيّ	الفَوْضَوِيِّ	ADJ;GEN;DEF;MASC;SG;PSSD
حَدِيث	حَدِيثَةً	ADJ;ACC;INDF;FEM;SG
نَفَق	النَّفَقِ	N;NHUM;GEN;DEF;MASC;SG
سَمَّى	تُسَمَّيانِ	V;IPFV;FEM;IND;DU;3;PASS
مُكَسَّر	المُكَسَّرَتَيْ	ADJ;ACC;DEF;FEM;DU;PSSD
مُحَصَّن	المُحَصَّنَ	ADJ;ACC;DEF;MASC;SG;PSSD
غُدَّة	غُدَدٌ	N;NHUM;NOM;INDF;FEM;PL
زَهْر	زَهْرٌ	N;NHUM;NOM;INDF;MASC;SG
نَصْرانِيَّة	نَصْرانِيَّة	N;NHUM;INDF;FEM;SG
لَذِيذ	لَذِيذاتٌ	ADJ;NOM;INDF;FEM;PL
عاقِد	عاقِدَيْ	N;HUM;ACC;SPEC;MASC;DU
عُرْي	عُرْيَةِ	N;NHUM;GEN;SPEC;FEM;SG
سابَق	يُسابِقُونَ	V;IPFV;MASC;IND;PL;3;ACT
تَراكُمِيّ	التَّراكُمِيُّ	ADJ;NOM;DEF;MASC;SG;PSSD
مُخَرِّب	مُخَرِّبَتا	N;HUM;NOM;FEM;DU;PSSD
سَحَق	تُسْحَقا	V;IPFV;MASC;DU;2;PASS
كُرْدِيّ	كُرْدِيَّة	N;HUM;SPEC;FEM;SG
باحَث	نُباحِثُ	V;IPFV;IND;PL;1;ACT
عَيَّش	تُعَيِّشانِ	V;IPFV;MASC;IND;DU;2;ACT
بِنائِيّ	البِنائِيَّ	ADJ;ACC;DEF;MASC;SG;PSSD
شَلّ	تَشَلَّ	V;IPFV;MASC;JUS;SG;2;ACT
كَهْرَبائِيّ	كَهْرَبائِيَّتَيْ	ADJ;ACC;SPEC;FEM;DU
مُدْلَهِمّ	مُدْلَهِمٌّ	ADJ;NOM;INDF;MASC;SG
مُنْضَمّ	مُنْضَمَّةَ	ADJ;ACC;SPEC;FEM;SG
كَمّ	كَمّ	N;NHUM;INDF;MASC;SG
رَضِيّ	رَضِيّانِ	ADJ;NOM;INDF;MASC;DU
شَهِيد	شَهِيدَة	ADJ;FEM;SG;PSSD
ٱِعْتَرَض	اِعْتَرَضْتُما	V;PFV;MASC;IND;DU;2;ACT
صِفَة	صِفَة	N;NHUM;FEM;SG;PSSD
مَبْرُور	المَبْرُورَ	ADJ;ACC;DEF;MASC;SG
ٱِنْعِكاس	الاِنْعِكاس	N;NHUM;DEF;MASC;SG
مِقْوَد	مِقْوَدَ	N;NHUM;ACC;MASC;SG;PSSD
مَشَط	تَمْشُطا	V;IPFV;MASC;DU;2;ACT
مَزْهُوّ	المَزْهُوّات	ADJ;DEF;FEM;PL
أَيْضِيّ	الأَيْضِيَّة	ADJ;DEF;FEM;SG
دَخَل	تَدْخُلُ	V;IPFV;MASC;IND;SG;2;ACT
مُتَبَقِّي	مُتَبَقٍّ	N;NHUM;NOM;INDF;MASC;SG
ٱِسْتَعاد	نُسْتَعادَ	V;IPFV;SBJV;PL;1;PASS
جَدْوَل	جَدْوَلَيْ	N;NHUM;ACC;SPEC;MASC;DU
وَكَّد	وَكَّدَت	V;PFV;FEM;IND;SG;3;ACT
مُعْوِز	مُعْوِزِي	ADJ;GEN;SPEC;MASC;PL
تَزْيِين	تَزْيِينانِ	N;NHUM;NOM;INDF;MASC;DU
جَنُوبِيّ	جَنُوبِيَّيْنِ	ADJ;GEN;INDF;MASC;DU
تَناقَل	تَناقَلَت	V;PFV;FEM;IND;SG;3;ACT
مَسْؤُول	مَسْؤُولَيْنِ	N;HUM;GEN;INDF;MASC;DU
أَمّار	الأَمّاراتِ	N;NHUM;ACC;DEF;FEM;PL
ٱِخْتَزَن	تَخْتَزِنا	V;IPFV;MASC;DU;2;ACT
ظَرْف	ظُرُوفٍ	N;NHUM;GEN;INDF;MASC;PL
شِقاق	شِقاقَ	N;NHUM;ACC;SPEC;MASC;SG
هائِل	الهائِلَةِ	ADJ;GEN;DEF;FEM;SG
غَصّ	غَصِصْتُنَّ	V;PFV;FEM;IND;PL;2;ACT
حَمِيد	الحَمِيدانِ	ADJ;NOM;DEF;MASC;DU
قادِم	القادِمَةَ	ADJ;ACC;DEF;FEM;SG
ٱِنْدَفَع	اِنْدَفَعْنَ	V;PFV;FEM;IND;PL;3;ACT
مُؤَسِّس	مُؤَسِّسَة	N;HUM;SPEC;FEM;SG
مَعْدُوم	مَعْدُومَة	ADJ;INDF;FEM;SG
ٱِحْتِفالِيّ	الاِحْتِفالِيِّ	ADJ;GEN;DEF;MASC;SG;PSSD
جِنائِيّ	الجِنائِيَّتَيْ	ADJ;GEN;DEF;FEM;DU;PSSD
ٱِسْتَضاء	نَسْتَضِئْ	V;IPFV;JUS;PL;1;ACT
مُطْرِب	المُطْرِباتُ	N;HUM;NOM;DEF;FEM;PL
طابُور	طَوابِير	N;NHUM;INDF;MASC;PL
ٱِنْصَهَر	نَنْصَهِرُ	V;IPFV;IND;PL;1;ACT
قَتِيل	قَتِيلَتَيْ	N;HUM;GEN;FEM;DU;PSSD
مَدْخُول	مَدْخُولاتِ	N;NHUM;GEN;FEM;PL;PSSD
مُصَوِّر	مُصَوِّرَةُ	N;HUM;NOM;SPEC;FEM;SG
شَغُوف	شَغُوفاتِ	ADJ;GEN;SPEC;FEM;PL
آلِيَّة	آلِيَّة	N;NHUM;INDF;FEM;SG
تِجارِيّ	تِجارِيّاتِ	ADJ;GEN;FEM;PL;PSSD
رابِح	رابِحاتِ	N;HUM;ACC;SPEC;FEM;PL
رَمَق	الأَرْماقَ	N;NHUM;ACC;DEF;MASC;PL
حاشِد	الحاشِدَةَ	ADJ;ACC;DEF;FEM;SG;PSSD
تَشَرْذَم	تَشَرْذَمْتُ	V;PFV;IND;SG;1;ACT
مُعْتاد	مُعْتادَتانِ	N;NHUM;NOM;SPEC;FEM;DU
خَرّاط	خَرّاطاتِ	N;HUM;GEN;FEM;PL;PSSD
مُتَنازِع	مُتَنازِعَةٍ	ADJ;GEN;INDF;FEM;SG
مُلْهَم	المُلْهَماتُ	ADJ;NOM;DEF;FEM;PL
أَرْض	أَراضٍ	N;NHUM;GEN;INDF;MASC;PL
ماج	تَمُوجا	V;IPFV;MASC;DU;2;ACT
نَشَأ	تَنْشَأَ	V;IPFV;FEM;SBJV;SG;3;ACT
فَسَّر	تُفَسَّرْ	V;IPFV;FEM;JUS;SG;3;PASS
غارِق	الغارِق	ADJ;DEF;MASC;SG
غِرْبال	غَرابِيل	N;NHUM;INDF;MASC;PL
سَكَت	يَسْكُتَ	V;IPFV;MASC;SBJV;SG;3;ACT
خَلْفِيّ	الخَلْفِيَّتَيْنِ	ADJ;GEN;DEF;FEM;DU
أَسْعَد	تُسْعَدا	V;IPFV;FEM;DU;3;PASS
مَيْؤُوس	مَيْؤُوسَةٍ	ADJ;GEN;INDF;FEM;SG
أَسِير	أَسِيرانِ	N;HUM;NOM;INDF;MASC;DU
شَفَوِيّ	شَفَوِيّا	ADJ;NOM;MASC;DU;PSSD
هُمايُونِيّ	هُمايُونِيّاتِ	ADJ;GEN;FEM;PL;PSSD
أَقْنَع	تُقْنِعا	V;IPFV;MASC;DU;2;ACT
تَعَصُّب	تَعَصُّباتِ	N;NHUM;GEN;SPEC;MASC;PL
خالِق	الخالِقَةُ	N;HUM;NOM;DEF;FEM;SG
مُحَمَّل	مُحَمَّلُو	ADJ;NOM;MASC;PL;PSSD
ٱِنْقَلَب	أَنْقَلِبَ	V;IPFV;SBJV;SG;1;ACT
فَرْع	فَرْعُ	N;NHUM;NOM;SPEC;MASC;SG
أَجَر	يَأْجُرْ	V;IPFV;MASC;JUS;SG;3;ACT
هائِل	هائِلُ	ADJ;NOM;MASC;SG;PSSD
ظاهِر	ظاهِراتِ	ADJ;ACC;SPEC;FEM;PL
مُسْتَوْحَى	مُسْتَوْحَيَيْنِ	ADJ;GEN;INDF;MASC;DU
مُنَسِّق	المُنَسِّقات	N;HUM;DEF;FEM;PL
نُصْب	الأَنْصابَ	N;NHUM;ACC;DEF;MASC;PL
مُوَرِّد	المُوَرِّداتِ	N;HUM;ACC;DEF;FEM;PL
تَنَبَّأ	تَنَبَّأْتُم	V;PFV;MASC;IND;PL;2;ACT
فَخْرِيّ	الفَخْرِيُّو	ADJ;NOM;DEF;MASC;PL;PSSD
نِيابِيّ	النِّيابِيّا	ADJ;NOM;DEF;MASC;DU;PSSD
وارِث	وارِثِي	ADJ;ACC;MASC;PL;PSSD
مُسْتَنْقَع	مُسْتَنْقَعَيْ	N;NHUM;ACC;SPEC;MASC;DU
عَسِير	عَسِيرَتَيْنِ	N;NHUM;ACC;INDF;FEM;DU
أَقَلّ	الأَقَلِّ	ADJ;GEN;CMPR;DEF;FEM;SG
مِدْفَأ	مِدْفَأَةَ	N;NHUM;ACC;SPEC;FEM;SG
أَخْلاقِيّ	أَخْلاقِيّاتٌ	ADJ;NOM;INDF;FEM;PL
أَضْعَف	أَضْعَفِ	ADJ;GEN;CMPR;SPEC;FEM;PL
مُسْتَعْمِل	المُسْتَعْمِلُ	N;HUM;NOM;DEF;MASC;SG
مُناصَفَة	مُناصَفَتانِ	N;NHUM;NOM;INDF;FEM;DU
أَبْطَأ	أَبْطَأُ	ADJ;NOM;CMPR;FEM;SG;PSSD
حَلُو	أَحْلَى	V;IPFV;IND;SG;1;ACT
أَشْكِينازِيّ	الأَشْكِنازِيَّتَيْ	ADJ;ACC;DEF;FEM;DU;PSSD
نَجْو	نَجْواً	N;NHUM;ACC;INDF;MASC;SG
فِرْدَوْسِيّ	فِرْدَوْسِيَّةِ	ADJ;GEN;SPEC;FEM;SG
ضَبابِيَّة	ضَبابِيَّةٍ	N;NHUM;GEN;INDF;FEM;SG
أَنْجَع	أَنْجَعِ	ADJ;GEN;CMPR;MASC;SG;PSSD
راضِي	الرّاضِياتُ	ADJ;NOM;DEF;FEM;PL
داهِم	داهِما	ADJ;NOM;MASC;DU;PSSD
ران	تَرِينانِ	V;IPFV;MASC;IND;DU;2;ACT
ٱِسْتَأْصَل	يَسْتَأْصِلا	V;IPFV;MASC;DU;3;ACT
عُضال	العُضال	N;NHUM;DEF;MASC;SG
مُبْدِي	مُبْدِيَيْ	ADJ;GEN;SPEC;MASC;DU
جَهِل	تَجْهَلُ	V;IPFV;MASC;IND;SG;2;ACT
مُنَظِّم	مُنَظِّمَةَ	N;HUM;ACC;SPEC;FEM;SG
مُعَذِّب	المُعَذِّبَيْ	N;HUM;GEN;DEF;MASC;DU
مُنْهار	مُنْهارا	ADJ;NOM;SPEC;MASC;DU
مُتَضَرِّر	مُتَضَرِّرِينَ	ADJ;GEN;INDF;MASC;PL
ٱِتَّبَع	تَتَّبِعانِ	V;IPFV;FEM;IND;DU;3;ACT
صَعْب	الصَّعْبَةِ	ADJ;GEN;DEF;FEM;SG;PSSD
واثِق	واثِقَةِ	ADJ;GEN;SPEC;FEM;SG
مُخْتَفِي	مُخْتَفِياتِ	ADJ;GEN;FEM;PL;PSSD
سَلَّط	يُسَلِّطُوا	V;IPFV;MASC;PL;3;ACT
تَرَكَّز	تَرَكَّزا	V;PFV;MASC;IND;DU;3;ACT
مُتَغَيِّب	مُتَغَيِّبَ	N;HUM;ACC;MASC;SG;PSSD
قَصِيدَة	قَصِيدَتَيْ	N;NHUM;ACC;SPEC;FEM;DU
وَهْمِيّ	وَهْمِيَّيْ	ADJ;ACC;MASC;DU;PSSD
مَمْلُوك	المَمْلُوكَةَ	ADJ;ACC;DEF;FEM;SG;PSSD
رِيبُورْتاج	رِبُورْتاجاتِ	N;NHUM;ACC;MASC;PL;PSSD
هادِي	هادِيَةً	N;NHUM;ACC;INDF;FEM;SG
أُعْجُوبَة	أَعاجِيبَ	N;NHUM;ACC;SPEC;FEM;PL
ٱِزْدِهار	الاِزْدِهار	N;NHUM;DEF;MASC;SG
أَعْتَق	تُعْتِقا	V;IPFV;MASC;DU;2;ACT
مَقْرُون	المَقْرُونَتَيْنِ	ADJ;ACC;DEF;FEM;DU
ناقِص	النّاقِصانِ	ADJ;NOM;DEF;MASC;DU
تَمَثَّل	تَمَثَّلْنَ	V;PFV;FEM;IND;PL;3;ACT
مَصْرَفِيّ	مَصْرَفِيَّة	ADJ;FEM;SG;PSSD
تَيَقَّن	يَتَيَقَّنْ	V;IPFV;MASC;JUS;SG;3;ACT
مُحْتَرِف	مُحْتَرِفَيْ	N;HUM;GEN;SPEC;MASC;DU
تَثَبُّت	تَثَبُّتٌ	N;NHUM;NOM;INDF;MASC;SG
طَرِيح	طَرِيحَتَيْنِ	ADJ;GEN;INDF;FEM;DU
حُجَّة	حُجَّتانِ	N;NHUM;NOM;INDF;FEM;DU
قِشْر	قُشُورٍ	N;NHUM;GEN;INDF;MASC;PL
مُتَّخَذ	مُتَّخَذَ	ADJ;ACC;MASC;SG;PSSD
وَضَّح	يُوَضِّحُوا	V;IPFV;MASC;PL;3;ACT
تَساهُل	التَّساهُل	N;NHUM;DEF;MASC;SG
رابِح	رابِحَتَيْ	ADJ;ACC;FEM;DU;PSSD
ناقِد	ناقِداتِ	N;HUM;GEN;FEM;PL;PSSD
عَدِيد	العَدِيد	ADJ;DEF;MASC;SG
حُوت	حُوتِ	N;NHUM;GEN;MASC;SG;PSSD
وِراق	وِراقَةٌ	N;NHUM;NOM;INDF;FEM;SG
سِماك	الأَسْماكُ	N;NHUM;NOM;DEF;MASC;PL
مَغْرِبِيّ	مَغْرِبِيَّةَ	N;HUM;ACC;FEM;SG;PSSD
مُتَبادَل	مُتَبادَلات	ADJ;INDF;FEM;PL
تَفاضُلِيّ	تَفاضُلِيّا	ADJ;NOM;SPEC;MASC;DU
ضَخْم	ضَخْمَةِ	ADJ;GEN;FEM;SG;PSSD
شَتَم	شَتَمُوا	V;PFV;MASC;IND;PL;3;ACT
مُواجِه	مُواجِهُو	N;NHUM;NOM;SPEC;MASC;PL
ٱِخْتِيار	اِخْتِياراتِ	N;NHUM;ACC;SPEC;MASC;PL
مَهْرَجان	المَهْرَجانِ	N;NHUM;GEN;DEF;MASC;SG
تَرْتِيلَة	تَرْتِيلَتَيْ	N;NHUM;GEN;SPEC;FEM;DU
شَغّال	الشَّغّالَيْنِ	ADJ;ACC;DEF;MASC;DU
غافِل	غافِلَيْ	ADJ;ACC;MASC;DU;PSSD
إِنْدُونِيسِيّ	إِنْدُونِيسِيُّو	N;HUM;NOM;MASC;PL;PSSD
تَصْوِير	تَصْوِيرُ	N;NHUM;NOM;MASC;SG;PSSD
مُتَّهِم	مُتَّهِمَتانِ	N;HUM;NOM;INDF;FEM;DU
قُبَيْل	قُبَيْلُ	N;NHUM;NOM;MASC;SG;PSSD
مَعْذِرَة	المَعاذِرِ	N;NHUM;GEN;DEF;FEM;PL
مُنَوِّه	مُنَوِّهِي	N;NHUM;GEN;MASC;PL;PSSD
تَذْكارِيّ	التَّذْكارِيِّ	ADJ;GEN;DEF;MASC;SG
لاغِي	لاغِيَة	ADJ;INDF;FEM;SG
مُحارِب	مُحارِبَة	N;HUM;INDF;FEM;SG
قَرْض	قَرْضَيْنِ	N;NHUM;GEN;INDF;MASC;DU
لامَحْدُود	لامَحْدُودَيْ	ADJ;ACC;SPEC;MASC;DU
شَيَّد	يُشَيِّدُوا	V;IPFV;MASC;PL;3;ACT
ٱِخْتِيارِيّ	الاِخْتِيارِيِّينَ	ADJ;GEN;DEF;MASC;PL
ٱِنْحِناء	اِنْحِناءات	N;NHUM;SPEC;MASC;PL
هَرَّب	تُهَرِّبُونَ	V;IPFV;MASC;IND;PL;2;ACT
مَرْجانِيّ	المَرْجانِيَّتا	ADJ;NOM;DEF;FEM;DU;PSSD
شَطَّب	يُشَطِّبُونَ	V;IPFV;MASC;IND;PL;3;ACT
رَدْهَة	رَدَهاتِ	N;NHUM;ACC;FEM;PL;PSSD
راكِب	راكِباتٍ	N;HUM;GEN;INDF;FEM;PL
أَتْقَن	تُتْقَنَّ	V;IPFV;FEM;PL;2;PASS
إِحْداث	إِحْداثاتِ	N;NHUM;ACC;MASC;PL;PSSD
رَصِين	الرَّصِينَتَيْنِ	ADJ;GEN;DEF;FEM;DU
لامَحْدُود	اللّامَحْدُودَةَ	ADJ;ACC;DEF;FEM;SG;PSSD
مُفَوَّه	المُفَوَّها	ADJ;NOM;DEF;MASC;DU;PSSD
ثَلاثُون	الثَّلاثُو	ADJ;NOM;DEF;MASC;PL
عَضَلَة	العَضَلاتِ	N;NHUM;ACC;DEF;FEM;PL
مَخْطُوف	مَخْطُوفَةِ	ADJ;GEN;FEM;SG;PSSD
سِياق	السِّياقاتُ	N;NHUM;NOM;DEF;MASC;PL
رَمْزِيّ	رَمْزِيِّي	ADJ;GEN;MASC;PL;PSSD
زِيجَة	زِيجَتَيْ	N;NHUM;ACC;SPEC;FEM;DU
أَمَدّ	يُمَدَّ	V;IPFV;MASC;JUS;SG;3;PASS
مانِع	مانِعاتٍ	ADJ;GEN;INDF;FEM;PL
مُضْمَر	مُضْمَرَيْنِ	ADJ;ACC;INDF;MASC;DU
حَكَى	تَحْكِيانِ	V;IPFV;FEM;IND;DU;3;ACT
ضَراوَة	الضّارِي	N;NHUM;GEN;DEF;MASC;PL
عَشْوائِيّ	عَشْوائِيَّتَيْ	ADJ;GEN;FEM;DU;PSSD
مُحِقّ	المُحِقَّيْ	ADJ;GEN;DEF;MASC;DU;PSSD
واهِم	واهِمات	ADJ;INDF;FEM;PL
مُقْتَصِر	المُقْتَصِرَيْ	ADJ;GEN;DEF;MASC;DU;PSSD
رَئِيس	رَئِيسَتَيْنِ	N;HUM;ACC;INDF;FEM;DU
ٱِنْعِزال	اِنْعِزالاتُ	N;NHUM;NOM;MASC;PL;PSSD
لَيِّن	اللَّيِّنِ	ADJ;GEN;DEF;MASC;SG
زَمَنِيّ	الزَّمَنِيَّيْ	ADJ;ACC;DEF;MASC;DU;PSSD
شُجاع	الشُّجاعَيْ	ADJ;GEN;DEF;MASC;DU;PSSD
ٱِقْتِناع	اِقْتِناعِ	N;NHUM;GEN;MASC;SG;PSSD
مُتَوَسِّطِيّ	مُتَوَسِّطِيّاتِ	ADJ;GEN;SPEC;FEM;PL
مَصْلَحَة	مَصالِحُ	N;NHUM;NOM;INDF;FEM;PL
نَتِيجَة	نَتِيجَة	N;NHUM;SPEC;FEM;SG
كارِزْمِيّ	كارِزْمِيِّ	ADJ;GEN;SPEC;MASC;SG
مُتَواضِع	مُتَواضِعِينَ	ADJ;ACC;INDF;MASC;PL
ٱِئْتِلافِيّ	اِئْتِلافِيِّي	ADJ;GEN;SPEC;MASC;PL
مُخْتَصّ	المُخْتَصّات	ADJ;DEF;FEM;PL
تَأَجُّر	تَأَجُّرِ	N;NHUM;GEN;MASC;SG;PSSD
ٱِشْتَجَر	تَشْتَجِرُوا	V;IPFV;MASC;PL;2;ACT
عَرَّف	يُعَرِّفُونَ	V;IPFV;MASC;IND;PL;3;ACT
عاقِل	العاقِلات	ADJ;DEF;FEM;PL
تَشْرِيح	تَشْرِيحاتٍ	N;NHUM;GEN;INDF;MASC;PL
تَناقُض	التَّناقُضِ	N;NHUM;GEN;DEF;MASC;SG
مُسْتَمِرّ	مُسْتَمِرَّيْنِ	N;NHUM;ACC;INDF;MASC;DU
بَرِئ	تَبْرَأَ	V;IPFV;MASC;SBJV;SG;2;ACT
مُتَّصِل	مُتَّصِلاتِ	ADJ;ACC;SPEC;FEM;PL
مُبْتَذَل	مُبْتَذَلِينَ	N;NHUM;ACC;INDF;MASC;PL
مُجالَسَة	مُجالَساتِ	N;NHUM;ACC;FEM;PL;PSSD
دارَى	دارَيا	V;PFV;MASC;IND;DU;3;ACT
ٱِجْتِرار	اِجْتِرارٍ	N;NHUM;GEN;INDF;MASC;SG
نَشِط	نَشِطَتانِ	ADJ;NOM;SPEC;FEM;DU
خَراب	خَرابِ	N;NHUM;GEN;SPEC;MASC;SG
حارِق	حارِقَةَ	N;NHUM;ACC;FEM;SG;PSSD
جانِي	جانِيَتَيْنِ	N;HUM;GEN;INDF;FEM;DU
أَعْجَب	أُعْجَبَ	V;IPFV;SBJV;SG;1;PASS
حَبِيس	حَبِيساتِ	ADJ;ACC;FEM;PL;PSSD
مَكانِيّ	مَكانِيَّتا	ADJ;NOM;FEM;DU;PSSD
تَذَمَّر	تَذَمَّرْتَ	V;PFV;MASC;IND;SG;2;ACT
هِلالِيّ	الهِلالِيّانِ	ADJ;NOM;DEF;MASC;DU
أَبْرَأ	أَبْرَأْتُما	V;PFV;MASC;IND;DU;2;ACT
مُذْنِب	مُذْنِبَيْ	ADJ;GEN;SPEC;MASC;DU
مُحِقّ	مُحِقَّةَ	ADJ;ACC;FEM;SG;PSSD
عَرَبِيّ	العَرَبِيُّ	N;HUM;NOM;DEF;MASC;SG
قَنْبَلَة	القَنْبَلَة	N;NHUM;DEF;FEM;SG
فُطْر	فُطْرَةُ	N;NHUM;NOM;SPEC;FEM;SG
أَجَر	أَجَرْتُما	V;PFV;MASC;IND;DU;2;ACT
سِحْرِيّ	سِحْرِيَّتَيْ	ADJ;ACC;SPEC;FEM;DU
مُراقَبَة	المُراقَبَتانِ	N;NHUM;NOM;DEF;FEM;DU
ٱِسْتَطْرَد	اِسْتَطْرَدْتُم	V;PFV;MASC;IND;PL;2;ACT
مُمْتاز	مُمْتازَةُ	ADJ;NOM;FEM;SG;PSSD
هَدَى	أَهْدِي	V;IPFV;IND;SG;1;ACT
جاء	تَجِيءُ	V;IPFV;FEM;IND;SG;3;ACT
إِصْغار	إِصْغاراً	N;NHUM;ACC;INDF;MASC;SG
مَقْهُور	المَقْهُوراتِ	ADJ;GEN;DEF;FEM;PL;PSSD
مُتَعارَف	مُتَعارَفَةَ	ADJ;ACC;SPEC;FEM;SG
بَوّاب	بَوّابَتَيْ	N;HUM;ACC;SPEC;FEM;DU
أَسِير	الأَسِير	N;HUM;DEF;MASC;SG
أَفْصَح	تُفْصَحُوا	V;IPFV;MASC;PL;2;PASS
كُرْدِيّ	كُرْدِيَّيْ	N;HUM;GEN;MASC;DU;PSSD
ٱِسْتِماع	اِسْتِماعُ	N;NHUM;NOM;SPEC;MASC;SG
رَمْل	الرَّمْلُ	N;NHUM;NOM;DEF;MASC;SG
مُنْتَقِم	مُنْتَقِمِينَ	ADJ;GEN;INDF;MASC;PL
تَقَدُّمِيّ	تَقَدُّمِيَّة	ADJ;SPEC;FEM;SG
هَمَّش	هَمَّشْنا	V;PFV;IND;PL;1;ACT
صافِي	الصّافِيَتَيْنِ	ADJ;ACC;DEF;FEM;DU
دَقِيق	الدَّقِيقات	ADJ;DEF;FEM;PL
بَيْدَق	بَيْدَق	N;NHUM;INDF;MASC;SG
ماضِي	الماضِياتِ	ADJ;ACC;DEF;FEM;PL
مُحْتَجّ	مُحْتَجَّتَيْ	N;HUM;ACC;FEM;DU;PSSD
وُدِّيّ	الوُدِّيَّتَيْ	ADJ;ACC;DEF;FEM;DU;PSSD
قَدِير	قَدِيرَةٌ	ADJ;NOM;INDF;FEM;SG
مُوَشَّح	مُوَشَّحَةٍ	ADJ;GEN;INDF;FEM;SG
قائِم	قائِمَ	N;HUM;ACC;MASC;SG;PSSD
ساطِع	ساطِعَيْ	ADJ;ACC;MASC;DU;PSSD
عَطَل	عَطَلِ	N;NHUM;GEN;SPEC;MASC;SG
مُثَمِّن	مُثَمِّنُ	N;HUM;NOM;MASC;SG;PSSD
مُدِين	مُدِيناتِ	ADJ;GEN;FEM;PL;PSSD
تَطاوَل	يَتَطاوَلانِ	V;IPFV;MASC;IND;DU;3;ACT
مَنْطُوق	مَنْطُوقَيْنِ	N;NHUM;ACC;INDF;MASC;DU
إِباءَة	الإِباءَتَيْ	N;NHUM;ACC;DEF;FEM;DU
عاجِيّ	العاجِيَّ	ADJ;ACC;DEF;MASC;SG
دَفّاع	الدَّفّاعَةُ	ADJ;NOM;DEF;FEM;SG
مِسْكِين	مِسْكِيناً	N;HUM;ACC;INDF;MASC;SG
أَنْصَب	تُنْصَبِينَ	V;IPFV;FEM;IND;SG;2;PASS
مَعْزِل	مَعازِلُ	N;NHUM;NOM;INDF;MASC;PL
دالّ	دالُّ	ADJ;NOM;MASC;SG;PSSD
مُتَفَشِّي	مُتَفَشِّياتِ	ADJ;GEN;SPEC;FEM;PL
مُتَقاطِع	مُتَقاطِعَ	ADJ;ACC;SPEC;MASC;SG
باغِي	الباغِياتُ	ADJ;NOM;DEF;FEM;PL
صَلْصَة	صَلْصاتِ	N;NHUM;GEN;FEM;PL;PSSD
نَعِم	يَنْعَمَ	V;IPFV;MASC;SBJV;SG;3;ACT
أَعْوَل	أَعْوَلْتُ	V;PFV;IND;SG;1;ACT
مَدِين	المَدِيناتِ	ADJ;GEN;DEF;FEM;PL;PSSD
ظُفُر	ظُفُرا	N;NHUM;NOM;MASC;DU;PSSD
بَنْجلادِيشِيّ	البَنْجلادِيشِيّ	ADJ;DEF;MASC;SG
صَحْراوِيّ	الصَّحْرائِيُّونَ	ADJ;NOM;DEF;MASC;PL
صانِع	الصّانِعُونَ	ADJ;NOM;DEF;MASC;PL
تَجاذُب	التَّجاذُبا	N;NHUM;NOM;DEF;MASC;DU
جِهادِيّ	الجِهادِيُّ	ADJ;NOM;DEF;MASC;SG
مُناوَبَة	المُناوَبَتانِ	N;NHUM;NOM;DEF;FEM;DU
إِشْعاعِيّ	إِشْعاعِيُّونَ	ADJ;NOM;INDF;MASC;PL
مُنَظِّم	مُنَظِّمَتَيْنِ	ADJ;ACC;INDF;FEM;DU
ٱِسْتِعادَة	اِسْتِعادَتَيْ	N;NHUM;GEN;SPEC;FEM;DU
هَوِي	نَهْوَى	V;IPFV;IND;PL;1;ACT
بَحْثِيّ	بَحْثِيّات	ADJ;SPEC;FEM;PL
مُفارِق	مُفارِقَةَ	ADJ;ACC;SPEC;FEM;SG
تَباحُث	تَباحُثٌ	N;NHUM;NOM;INDF;MASC;SG
أَنانِيّ	أَنانِيّاتٍ	ADJ;GEN;INDF;FEM;PL
مُحاكاة	مُحاكاتا	N;NHUM;NOM;FEM;DU;PSSD
لاعِب	لاعِبِ	N;HUM;GEN;MASC;SG;PSSD
كاشِف	كاشِفَةَ	ADJ;ACC;FEM;SG;PSSD
خَبِيث	خَبِيثَتَيْ	ADJ;GEN;FEM;DU;PSSD
ٱِقْتِحام	اِقْتِحاماتٍ	N;NHUM;ACC;INDF;MASC;PL
سَمِع	تُسْمَعانِ	V;IPFV;MASC;IND;DU;2;PASS
شَكْلِيّ	الشَّكْلِيَّيْنِ	ADJ;GEN;DEF;MASC;DU
عِصابَة	عِصابَةَ	N;NHUM;ACC;SPEC;FEM;SG
صانِع	صانِعَةُ	ADJ;NOM;FEM;SG;PSSD
تَذَكُّر	تَذَكُّرا	N;NHUM;NOM;MASC;DU;PSSD
مَرْغُوب	مَرْغُوبَتانِ	ADJ;NOM;INDF;FEM;DU
رَمَضانِيّ	الرَّمَضانِيَّة	ADJ;DEF;FEM;SG;PSSD
أَشُورِيّ	آشُورِيّاتٌ	N;HUM;NOM;INDF;FEM;PL
جَبْرِيّ	الجَبْرِيِّي	ADJ;GEN;DEF;MASC;PL;PSSD
كِبْرِيت	الكِبْرِيتَتَيْ	N;NHUM;GEN;DEF;FEM;DU
عَنْدَلَة	عَنْدَلَةً	N;NHUM;ACC;INDF;FEM;SG
ٱِسْتِطْلاعِيّ	الاِسْتِطْلاعِيَّيْنِ	ADJ;ACC;DEF;MASC;DU
مُكْتَئِب	مُكْتَئِبَ	ADJ;ACC;SPEC;MASC;SG
مُرْسَل	المُرْسَلَةِ	ADJ;GEN;DEF;FEM;SG
جَراءَة	الجَراءَةَ	N;NHUM;ACC;DEF;FEM;SG
أَهْمَل	أُهْمِلَت	V;PFV;FEM;IND;SG;3;PASS
مُرَشَّح	مُرَشَّحِينَ	N;HUM;GEN;INDF;MASC;PL
ٱِسْتِشْفائِيّ	الاِسْتِشْفائِيّانِ	ADJ;NOM;DEF;MASC;DU
مُؤاتِي	مُؤاتِيَةٍ	ADJ;GEN;INDF;FEM;SG
قِرْد	قُرُودِ	N;NHUM;GEN;SPEC;MASC;PL
تَطْوِيل	التَّطْوِيلاتِ	N;NHUM;GEN;DEF;MASC;PL
مُوَقَّع	مُوَقَّعَيْ	ADJ;GEN;SPEC;MASC;DU
قَطّ	القَطَّةِ	N;NHUM;GEN;DEF;FEM;SG
أَيْدِيُولُوجِيا	إِدْيُولُوجِيّات	N;NHUM;SPEC;FEM;PL
تَسَرَّى	نَتَسَرَّى	V;IPFV;IND;PL;1;ACT
ضَيَّف	تُضَيِّفُوا	V;IPFV;MASC;PL;2;ACT
تَحْدِيد	تَحْدِيدا	N;NHUM;NOM;SPEC;MASC;DU
ذَوْق	ذَوْقِ	N;NHUM;GEN;SPEC;MASC;SG
أَرْسَل	أُرْسِلْتُم	V;PFV;MASC;IND;PL;2;PASS
ٱِسْتِقْدام	اِسْتِقْدامَيْ	N;NHUM;GEN;MASC;DU;PSSD
يَهُودِيّ	يَهُودِيّات	N;HUM;SPEC;FEM;PL
رَيّان	رَيّانِ	N;NHUM;GEN;MASC;SG;PSSD
تَسْهِيل	تَسْهِيلَ	N;NHUM;ACC;MASC;SG;PSSD
حاسِم	حاسِمِي	ADJ;ACC;MASC;PL;PSSD
غابَة	غابَتَيْ	N;NHUM;ACC;SPEC;FEM;DU
فاء	فاءاتِ	N;NHUM;GEN;SPEC;MASC;PL
صَرَخ	صَرَخْتُما	V;PFV;MASC;IND;DU;2;ACT
مَسْبُوق	مَسْبُوقَتا	ADJ;NOM;FEM;DU;PSSD
مُهاجِر	مُهاجِرَةُ	ADJ;NOM;SPEC;FEM;SG
رَشِيق	الرَّشِيقَةَ	ADJ;ACC;DEF;FEM;SG
نِيلِيّ	النِّيلِيّات	N;NHUM;DEF;FEM;PL
مُنْتَظَر	المُنْتَظَرَتَيْنِ	ADJ;GEN;DEF;FEM;DU
مُشِعّ	المُشِعَّ	ADJ;ACC;DEF;MASC;SG
إِنْكلِيزِيَّة	إِنْكلِيزِيّاتٍ	N;NHUM;ACC;INDF;FEM;PL
لَنْدَنِيّ	لَنْدَنِيِّينَ	ADJ;ACC;INDF;MASC;PL
غَضّ	غَضُّوا	V;PFV;MASC;IND;PL;3;ACT
مَثْوَى	المَثاوِي	N;NHUM;DEF;MASC;PL
مُهَلْوِس	مُهَلْوِساتِ	N;NHUM;ACC;SPEC;FEM;PL
حَلَبِيّ	حَلَبِيّاتُ	ADJ;NOM;FEM;PL;PSSD
جُرْح	جُرْحَيْ	N;NHUM;GEN;SPEC;MASC;DU
غَباوَة	غَباوَةً	N;NHUM;ACC;INDF;FEM;SG
جُزَيْء	جُزَيْءٍ	N;NHUM;GEN;INDF;MASC;SG
أُسْبُوع	أُسْبُوعُ	N;NHUM;NOM;SPEC;MASC;SG
كُنْفِدرالِيَّة	كُنْفِدِرالِيَّةَ	N;NHUM;ACC;SPEC;FEM;SG
تَغاضِي	تَغاضِياتِ	N;NHUM;ACC;SPEC;MASC;PL
قُلَّة	قُلَّة	N;NHUM;SPEC;FEM;SG
ٱِسْتَرْجَل	تَسْتَرْجِلا	V;IPFV;MASC;DU;2;ACT
غِنائِيّ	الغِنائِيَّ	ADJ;ACC;DEF;MASC;SG
تَدارُك	تَدارُكَةُ	N;NHUM;NOM;SPEC;FEM;SG
ٱِسْتَطْرَد	يَسْتَطْرِدُونَ	V;IPFV;MASC;IND;PL;3;ACT
ٱِعْتِدائِيّ	اِعْتِدائِيُّ	ADJ;NOM;SPEC;MASC;SG
أَدَرّ	أَدَرُّوا	V;PFV;MASC;IND;PL;3;ACT
ضام	ضِمْتُما	V;PFV;MASC;IND;DU;2;ACT
قِنْع	القِنْعِ	N;NHUM;GEN;DEF;MASC;SG
داخِل	الدّاخِلَةَ	ADJ;ACC;DEF;FEM;SG;PSSD
تَبَدَّل	تَبَدَّلَت	V;PFV;FEM;IND;SG;3;ACT
فاتِن	فاتِنَتَيْنِ	N;NHUM;GEN;INDF;FEM;DU
ٱِسْتَقام	يَسْتَقِيمَ	V;IPFV;MASC;SBJV;SG;3;ACT
ٱِسْتِقْصاء	اِسْتِقْصاءٌ	N;NHUM;NOM;INDF;MASC;SG
كَنَدِيّ	كَنَدِيَّتَيْ	N;HUM;GEN;SPEC;FEM;DU
مُهان	مُهانانِ	ADJ;NOM;INDF;MASC;DU
إِفْصاح	إِفْصاحٍ	N;NHUM;GEN;INDF;MASC;SG
حُكْم	الحُكْما	N;NHUM;NOM;DEF;MASC;DU
عامّ	عامّانِ	ADJ;NOM;INDF;MASC;DU
جِيفَة	جِيفَتَيْنِ	N;NHUM;ACC;INDF;FEM;DU
طارَد	يُطارِدُونَ	V;IPFV;MASC;IND;PL;3;ACT
صَعِيد	صَعِيدانِ	N;NHUM;NOM;INDF;MASC;DU
خَيالِيّ	الخَيالِيّاتِ	ADJ;GEN;DEF;FEM;PL;PSSD
ٱِرْتَضَى	نُرْتَضَى	V;IPFV;SBJV;PL;1;PASS
رَأْسِيّ	الرَّأْسِيَّةُ	ADJ;NOM;DEF;FEM;SG
كَنْعانِيّ	كَنْعانِيّات	ADJ;INDF;FEM;PL
مَلَكِيّ	المَلَكِيُّو	ADJ;NOM;DEF;MASC;PL;PSSD
تَعْيِين	تَعْيِيناً	N;NHUM;ACC;INDF;MASC;SG
سِيكارَة	السَّكائِر	N;NHUM;DEF;FEM;PL
مَرْء	مَرْءِ	N;HUM;GEN;SPEC;MASC;SG
غَرِق	أَغْرَقَ	V;IPFV;SBJV;SG;1;ACT
تَفَهَّم	تَفَهَّمْتُنَّ	V;PFV;FEM;IND;PL;2;ACT
ٱِعْتاش	اِعْتَشْتَ	V;PFV;MASC;IND;SG;2;ACT
مُتَعَلِّق	المُتَعَلِّقَتَيْنِ	ADJ;ACC;DEF;FEM;DU
غَرِيم	غَرِيمَيْ	N;NHUM;GEN;MASC;DU;PSSD
ٱِئْتِلافِيّ	اِئْتِلافِيّاتُ	ADJ;NOM;FEM;PL;PSSD
شَجَب	شَجَبْتُما	V;PFV;MASC;IND;DU;2;ACT
ضِمْن	ضِمْنِ	N;NHUM;GEN;SPEC;MASC;SG
مُسَطَّح	المُسَطَّحاتِ	ADJ;ACC;DEF;FEM;PL
راسِي	راسِيانِ	ADJ;NOM;INDF;MASC;DU
نَصُوح	النَّصُوحَةِ	ADJ;GEN;DEF;FEM;SG
شاذّ	الشّاذّ	ADJ;DEF;MASC;SG;PSSD
هامِشِيّ	الهامِشِيِّ	ADJ;GEN;DEF;MASC;SG
جَلِيس	جَلِيساتِ	N;HUM;GEN;FEM;PL;PSSD
صِناعَة	صِناعَة	N;NHUM;FEM;SG;PSSD
فَرَك	يَفْرُكا	V;IPFV;MASC;DU;3;ACT
مُتَطاير	المُتَطايرِ	ADJ;GEN;DEF;MASC;SG
مُتَضامِن	المُتَضامِنُو	ADJ;NOM;DEF;MASC;PL;PSSD
مَدّ	تَمُدُّ	V;IPFV;FEM;IND;SG;3;ACT
ٱِخْتِصاصِيّ	اِخْتِصاصِيَّةً	ADJ;ACC;INDF;FEM;SG
مُجْتَمِع	مُجْتَمِعَيْنِ	N;NHUM;ACC;INDF;MASC;DU
تَكْيِيف	تَكْيِيفاً	N;NHUM;ACC;INDF;MASC;SG
مُحْتاج	مُحْتاجُونَ	N;HUM;NOM;INDF;MASC;PL
مُتَوَجِّب	مُتَوَجِّبَةِ	ADJ;GEN;FEM;SG;PSSD
سانِح	سانِحاتُ	ADJ;NOM;FEM;PL;PSSD
مُهاجَمَة	مُهاجَمات	N;NHUM;FEM;PL;PSSD
إِلْزامِيّ	الإِلْزامِيَّتَيْ	ADJ;GEN;DEF;FEM;DU;PSSD
عَمِل	نَعْمَلْ	V;IPFV;JUS;PL;1;ACT
ٱِتِّجار	الاِتِّجارا	N;NHUM;NOM;DEF;MASC;DU
غُلُوّ	غُلُوُّ	N;NHUM;NOM;MASC;SG;PSSD
أَغْرَق	تُغْرِقِي	V;IPFV;FEM;SG;2;ACT
مَحا	مَحَوْنا	V;PFV;IND;PL;1;ACT
هَدَّم	تُهَدِّمِي	V;IPFV;FEM;SG;2;ACT
ٱِفْتِئات	اِفْتِئاتاتٍ	N;NHUM;ACC;INDF;MASC;PL
تَحتْمائِيّ	تَحتْمائِيَّةَ	ADJ;ACC;SPEC;FEM;SG
زاهِر	زاهِرا	ADJ;NOM;SPEC;MASC;DU
فَقْر	فَقْر	N;NHUM;INDF;MASC;SG
مَسْبُوق	المَسْبُوقِ	ADJ;GEN;DEF;MASC;SG
إِدْرار	إِدْرارانِ	N;NHUM;NOM;INDF;MASC;DU
عَبايَة	عَباءَتَيْنِ	N;NHUM;ACC;INDF;FEM;DU
أَزْرَق	الزُّرُقِ	N;NHUM;GEN;DEF;FEM;PL
تَعالَى	تَعالَيْتُنَّ	V;PFV;FEM;IND;PL;2;ACT
طُغْيان	طُغْيانَ	N;NHUM;ACC;MASC;SG;PSSD
مِهْبَل	مِهْبَلِ	N;NHUM;GEN;MASC;SG;PSSD
جَنُوب	الجَنُوبَ	N;NHUM;ACC;DEF;MASC;SG
كَبَّل	تُكَبِّلُونَ	V;IPFV;MASC;IND;PL;2;ACT
حَشَرِيّ	الحَشَرِيّات	ADJ;DEF;FEM;PL;PSSD
أَخَذ	نُؤْخَذَ	V;IPFV;SBJV;PL;1;PASS
طارَد	طارَدَتا	V;PFV;FEM;IND;DU;3;ACT
طَلِيق	طَلِيقَةِ	ADJ;GEN;FEM;SG;PSSD
أَسْفَل	أَسْفَلِ	ADJ;GEN;CMPR;FEM;SG;PSSD
ٱِسْتِثْنائِيّ	اِسْتِثْنائِيّا	ADJ;NOM;SPEC;MASC;DU
وَحِيد	الوَحِيدِ	ADJ;GEN;DEF;MASC;SG;PSSD
أَظْلَم	أَظْلَمُ	ADJ;NOM;CMPR;MASC;SG;PSSD
أُورُو	أُورُوِ	N;NHUM;GEN;MASC;SG;PSSD
طَرِيق	طَرِيقُ	N;NHUM;NOM;FEM;SG;PSSD
لِنِينِيّ	لِنِينِيّاً	ADJ;ACC;INDF;MASC;SG
مُتَجانِس	المُتَجانِسَيْ	N;NHUM;GEN;DEF;MASC;DU
وَرْد	الوَرْدات	N;NHUM;DEF;FEM;PL
مَنْبُوذ	المَنْبُوذِينَ	ADJ;GEN;DEF;MASC;PL
سائِح	السّائِحاتِ	ADJ;GEN;DEF;FEM;PL
مِجْهَرِيّ	مِجْهَرِيِّي	ADJ;ACC;SPEC;MASC;PL
تَمايَل	تَمايَلْتِ	V;PFV;FEM;IND;SG;2;ACT
أَيْرلَنْدِيّ	الإِرْلَنْدِيَّةَ	ADJ;ACC;DEF;FEM;SG;PSSD
أَساسِيّ	أَساسِيُّو	ADJ;NOM;SPEC;MASC;PL
مَنامَة	مَنامَتانِ	N;NHUM;NOM;SPEC;FEM;DU
لَخَّص	لَخَّصْنَ	V;PFV;FEM;IND;PL;3;ACT
عامِّيَّة	عامِّيّاتٍ	N;NHUM;ACC;INDF;FEM;PL
تَقْوِيم	تَقاوِيمَ	N;NHUM;ACC;MASC;SG;PSSD
مُسْتَهْدَف	مُسْتَهْدَفَتَيْنِ	ADJ;GEN;INDF;FEM;DU
قِتالِيّ	قِتالِيَّتَيْ	ADJ;GEN;FEM;DU;PSSD
جَمْهَر	تُجَمْهِرُ	V;IPFV;MASC;IND;SG;2;ACT
حِسابِيّ	حِسابِيّا	ADJ;NOM;MASC;DU;PSSD
تَعْرِيفِيّ	التَّعْرِيفِيَّ	ADJ;ACC;DEF;MASC;SG
ٱِزْداد	يَزْدَدْنَ	V;IPFV;FEM;PL;3;ACT
حُكْم	أَحْكامٌ	N;NHUM;NOM;INDF;MASC;PL
مَشْلُول	المَشْلُولات	ADJ;DEF;FEM;PL;PSSD
طَرِيق	طَرِيقَيْنِ	N;NHUM;GEN;INDF;MASC;DU
شَذِيّ	شَذِيَّيْنِ	ADJ;ACC;INDF;MASC;DU
تَجْزِئَة	تَجْزِئاتِ	N;NHUM;GEN;FEM;PL;PSSD
بارَز	تُبارِزُ	V;IPFV;FEM;IND;SG;3;ACT
مُتَداعِي	مُتَداعِيات	N;NHUM;SPEC;FEM;PL
رَدْعِيّ	الرَّدْعِيَّ	N;NHUM;ACC;DEF;MASC;SG
قَوْم	أَقْوامٌ	N;NHUM;NOM;INDF;MASC;PL
طَوِيل	طَوِيلانِ	ADJ;NOM;INDF;MASC;DU
مُجَدَّد	المُجَدَّد	ADJ;DEF;MASC;SG;PSSD
ساكِت	السّاكِتا	ADJ;NOM;DEF;MASC;DU;PSSD
مَنِيع	المَنِيعِ	ADJ;GEN;DEF;MASC;SG
خِطابَة	خِطابَةُ	N;NHUM;NOM;SPEC;FEM;SG
سارْتِرِيّ	السّارْتِرِيَّة	ADJ;DEF;FEM;SG
إِنارَة	إِنارَةَ	N;NHUM;ACC;FEM;SG;PSSD
نَصُوح	النَّصُوحَيْ	ADJ;ACC;DEF;MASC;DU;PSSD
نِيابِيّ	نِيابِيُّو	ADJ;NOM;SPEC;MASC;PL
ماضِي	ماضِيات	ADJ;INDF;FEM;PL
بَرْقِيّ	البَرْقِيَّةَ	ADJ;ACC;DEF;FEM;SG;PSSD
قُطْنِيّ	القُطْنِيُّ	ADJ;NOM;DEF;MASC;SG;PSSD
تَبَخَّر	تَبَخَّرْتَ	V;PFV;MASC;IND;SG;2;ACT
ٱِدِّخارِيّ	اِدِّخارِيَّةَ	ADJ;ACC;SPEC;FEM;SG
سِتّ	السِّتَّ	N;HUM;ACC;DEF;MASC;SG
دَيِّن	دَيِّنَيْ	ADJ;ACC;SPEC;MASC;DU
تَوَقُّف	تَوَقُّفاتُ	N;NHUM;NOM;SPEC;MASC;PL
آر	آرِ	N;NHUM;GEN;MASC;SG;PSSD
زَكَّى	تُزَكَّيا	V;IPFV;FEM;DU;3;PASS
داجِن	الدَّواجِن	N;NHUM;DEF;MASC;PL
فِدائِيّ	فِدائِيَّتَيْ	ADJ;ACC;SPEC;FEM;DU
تَجاوُز	تَجاوُزات	N;NHUM;INDF;MASC;PL
نَبِيّ	نَبِيّاتٍ	N;HUM;GEN;INDF;FEM;PL
مَرْئِيّ	المَرْئِيّاتِ	ADJ;GEN;DEF;FEM;PL;PSSD
مُعْتَصِم	مُعْتَصِمُ	N;HUM;NOM;SPEC;MASC;SG
مُواطِن	المُواطِناتِ	ADJ;ACC;DEF;FEM;PL;PSSD
مِثْلِيّ	مِثْلِيّات	ADJ;SPEC;FEM;PL
كاثُولِيكِيّ	كاثُولِيكِيّات	ADJ;FEM;PL;PSSD
أَنْصَب	يُنْصَبُونَ	V;IPFV;MASC;IND;PL;3;PASS
أَبار	يُبارانِ	V;IPFV;MASC;IND;DU;3;PASS
قَصَد	تُقْصَدانِ	V;IPFV;FEM;IND;DU;3;PASS
عاقَب	تُعاقَبا	V;IPFV;FEM;DU;3;PASS
عَمِيل	العَمِيلَتَيْنِ	ADJ;ACC;DEF;FEM;DU
أَشْكِينازِيّ	أَشْكِنازٍ	ADJ;GEN;INDF;MASC;PL
إِسْتراتِيجِيّ	الإِسْتراتِيجِيّاتُ	ADJ;NOM;DEF;FEM;PL
وَسَطِيّ	الوَسَطِيَّ	ADJ;ACC;DEF;MASC;SG;PSSD
هُدْب	الهُدُبَيْ	N;NHUM;ACC;DEF;MASC;DU
وَرْطَة	وَرَطات	N;NHUM;SPEC;FEM;PL
ٱِسْتَطاع	تَسْتَطاعا	V;IPFV;FEM;DU;3;ACT
وَشَّى	وَشَّيْتُنَّ	V;PFV;FEM;IND;PL;2;ACT
أَجاز	تُجِزْ	V;IPFV;MASC;JUS;SG;2;ACT
مَفْقُود	مَفْقُودات	ADJ;INDF;FEM;PL
كِراء	الأَكْرِيَةَ	N;NHUM;ACC;DEF;MASC;PL
إِجْرائِيّ	إِجْرائِيَّيْنِ	ADJ;GEN;INDF;MASC;DU
مُكَيَّف	مُكَيَّفا	N;NHUM;NOM;SPEC;MASC;DU
ٱِسْتِفْهام	اِسْتِفْهاماتُ	N;NHUM;NOM;MASC;PL;PSSD
عُلْجُوم	عُلْجُوما	N;NHUM;NOM;MASC;DU;PSSD
تالِي	التّالِياتُ	ADJ;NOM;DEF;FEM;PL;PSSD
عِرْض	العِرْضُ	N;NHUM;NOM;DEF;MASC;SG
بَسْمَة	بَسْمَة	N;NHUM;FEM;SG;PSSD
قَفْر	القَفْر	N;NHUM;DEF;MASC;SG
تَصاعُد	تَصاعُداتِ	N;NHUM;GEN;SPEC;MASC;PL
تَراكُمِيّ	تَراكُمِيِّ	ADJ;GEN;MASC;SG;PSSD
أَفْرُوأَسْيَوِيّ	أَفْرُوأَسْيَوِيّانِ	ADJ;NOM;INDF;MASC;DU
قُنْصُلِيّ	القُنْصُلِيَّةَ	ADJ;ACC;DEF;FEM;SG;PSSD
مُتَنافَس	المُتَنافَسَيْنِ	ADJ;ACC;DEF;MASC;DU
عَقَّد	عَقَّدْنا	V;PFV;IND;PL;1;ACT
لَدْن	لَدْنَتَيْ	ADJ;GEN;SPEC;FEM;DU
فَذّ	الفُذُوذ	N;HUM;DEF;MASC;PL
مُعَكِّر	مُعَكِّرِينَ	N;HUM;ACC;INDF;MASC;PL
مُعْجَب	المُعْجَب	ADJ;DEF;MASC;SG
وَقَّع	تُوَقِّعِينَ	V;IPFV;FEM;IND;SG;2;ACT
مُنَسِّق	مُنَسِّقَتَيْنِ	ADJ;GEN;INDF;FEM;DU
دَرْب	الدَّرْبِ	N;NHUM;GEN;DEF;MASC;SG
مُضْحِك	المُضْحِكُ	ADJ;NOM;DEF;MASC;SG;PSSD
تالِي	تالِيَةِ	ADJ;GEN;SPEC;FEM;SG
مَوْلِد	مَوْلِدَ	N;NHUM;ACC;SPEC;MASC;SG
جَرِب	تَجْرَبُونَ	V;IPFV;MASC;IND;PL;2;ACT
مَحْسُوب	المَحْسُوبَة	ADJ;DEF;FEM;SG;PSSD
مُصاب	مُصابُ	ADJ;NOM;SPEC;MASC;SG
تَفاعَل	تَتَفاعَلْنَ	V;IPFV;FEM;PL;2;ACT
تَطاوَل	تَطاوَلْتُ	V;PFV;IND;SG;1;ACT
مُقابِل	مُقابِلَ	ADJ;ACC;SPEC;MASC;SG
جَمْر	الجَمَراتِ	N;NHUM;GEN;DEF;FEM;PL
صَدِيق	صَدِيقَيْنِ	N;HUM;GEN;INDF;MASC;DU
كُوكايِين	كُوكائِين	N;NHUM;INDF;MASC;SG
مَمْجُوج	مَمْجُوجاتٍ	ADJ;GEN;INDF;FEM;PL
مُرَدِّد	المُرَدِّداتِ	ADJ;ACC;DEF;FEM;PL
مُخَلِّص	مُخَلِّصَتَيْ	N;HUM;GEN;SPEC;FEM;DU
أَحْدَب	أَحْدَبا	N;HUM;NOM;MASC;DU;PSSD
خَلَقَة	خَلَقَةٌ	N;NHUM;NOM;INDF;FEM;SG
ترِيلِيُون	ترِيلِيُونِ	ADJ;GEN;SPEC;MASC;SG
لَوَّح	أُلَوِّحْ	V;IPFV;JUS;SG;1;ACT
خَطِّيّ	الخَطِّيّات	ADJ;DEF;FEM;PL;PSSD
وَضَع	تَضَعْ	V;IPFV;MASC;JUS;SG;2;ACT
جانِب	الجانِب	N;NHUM;DEF;MASC;SG
ٱِخْتَزَن	تَخْتَزِنِي	V;IPFV;FEM;SG;2;ACT
برُوتِين	برُوتِيناتِ	N;NHUM;GEN;SPEC;MASC;PL
سُورِيّ	سُورِيٌّ	N;HUM;NOM;INDF;MASC;SG
مُتَّهِم	المُتَّهِمَتَيْ	N;HUM;GEN;DEF;FEM;DU
تَعَدَّى	أَتَعَدَّى	V;IPFV;SBJV;SG;1;ACT
ٱِسْتِنْباط	اِسْتِنْباطُ	N;NHUM;NOM;SPEC;MASC;SG
تَرْفِيع	تَرْفِيعَ	N;NHUM;ACC;SPEC;MASC;SG
مُهاجَرَة	المُهاجَرَةَ	N;NHUM;ACC;DEF;FEM;SG
حائِر	حائِراتٍ	ADJ;GEN;INDF;FEM;PL
شَلَبِيّ	الشَّلَبِيَّة	ADJ;DEF;FEM;SG
حَذا	حَذَوْتُما	V;PFV;MASC;IND;DU;2;ACT
أَفْرَغ	الأَفْرَغُ	ADJ;NOM;CMPR;DEF;MASC;SG
ٱِسْتِعْدادِيّ	اِسْتِعْدادِيّاتٌ	ADJ;NOM;INDF;FEM;PL
مُكَرِّر	مُكَرِّرِينَ	ADJ;GEN;INDF;MASC;PL
كَنَدِيّ	كَنَدِيَّتَيْ	ADJ;ACC;FEM;DU;PSSD
تَفْوِيض	التَّفْوِيضاتُ	N;NHUM;NOM;DEF;MASC;PL
صِدْقِيَّة	الصِّدْقِيَّةِ	N;NHUM;GEN;DEF;FEM;SG
حَرِج	حَرِجِ	ADJ;GEN;SPEC;MASC;SG
مَنْكِب	مَناكِبُ	N;NHUM;NOM;SPEC;MASC;PL
شَكْوَة	شَكْوَتَيْ	N;NHUM;ACC;FEM;DU;PSSD
جاثِم	الجاثِما	ADJ;NOM;DEF;MASC;DU;PSSD
مُحْرَق	مُحْرَقاتِ	N;NHUM;GEN;SPEC;FEM;PL
ٱِسْتَهْجَن	يَسْتَهْجِنَ	V;IPFV;MASC;SBJV;SG;3;ACT
غَنِيّ	غَنِيَّةَ	ADJ;ACC;SPEC;FEM;SG
ٱِسْتِعْدادِيّ	اِسْتِعْدادِيُّو	ADJ;NOM;MASC;PL;PSSD
أُورُو	الأُورُوُ	N;NHUM;NOM;DEF;MASC;SG
مُبَيِّت	المُبَيِّتاتُ	N;HUM;NOM;DEF;FEM;PL
مُرَفَّه	مُرَفَّهاتِ	ADJ;GEN;FEM;PL;PSSD
ثُلاثِيّ	ثُلاثِيّا	N;NHUM;NOM;MASC;DU;PSSD
تَهْوِيد	تَهْوِيداتٍ	N;NHUM;GEN;INDF;MASC;PL
مُعْتَصِم	مُعْتَصِمَةٌ	N;HUM;NOM;INDF;FEM;SG
ٱِخْتِمار	الاِخْتِمارَ	N;NHUM;ACC;DEF;MASC;SG
إِجابَة	إِجاباتِ	N;NHUM;GEN;SPEC;FEM;PL
قَهَر	يَقْهَرُونَ	V;IPFV;MASC;IND;PL;3;ACT
مُحَدَّد	مُحَدَّدِينَ	ADJ;ACC;INDF;MASC;PL
مُراجِع	مُراجِعَيْنِ	N;HUM;ACC;INDF;MASC;DU
تَخَبَّط	تَتَخَبَّطَ	V;IPFV;FEM;SBJV;SG;3;ACT
مُغَبَّر	مُغَبَّرَيْ	ADJ;GEN;SPEC;MASC;DU
شَرَع	تَشْرَعَ	V;IPFV;FEM;SBJV;SG;3;ACT
مُبْهَم	مُبْهَمَتَيْ	N;NHUM;ACC;SPEC;FEM;DU
جُرْعَة	جُرْعَةً	N;NHUM;ACC;INDF;FEM;SG
مُسَطَّح	المُسَطَّحَتَيْ	ADJ;GEN;DEF;FEM;DU;PSSD
باطِل	باطِلِينَ	N;NHUM;ACC;INDF;MASC;PL
ٱِحْتِجاز	اِحْتِجاز	N;NHUM;INDF;MASC;SG
رُوزْنامَة	رُوزْناماتُ	N;NHUM;NOM;SPEC;FEM;PL
عِزْبَة	عِزْبَة	N;NHUM;SPEC;FEM;SG
داوَر	تُداوِرا	V;IPFV;FEM;DU;3;ACT
عَدّاد	عَدّادِ	N;NHUM;GEN;MASC;SG;PSSD
مَسْمُوم	مَسْمُومُ	ADJ;NOM;SPEC;MASC;SG
فِدائِيّ	الفِدائِيِّي	ADJ;GEN;DEF;MASC;PL;PSSD
عَبْقَرِيّ	العَبْقَرِيَّتَيْ	ADJ;GEN;DEF;FEM;DU;PSSD
ثائِر	ثائِرُ	ADJ;NOM;MASC;SG;PSSD
وِجْهَة	وُجْهَةَ	N;NHUM;ACC;FEM;SG;PSSD
جاهِل	جاهِلاتٌ	ADJ;NOM;INDF;FEM;PL
أَرْمَنِيّ	أَرْمَنِيَّتَيْ	ADJ;ACC;SPEC;FEM;DU
سامِي	سام	ADJ;INDF;MASC;SG
خَطْف	خَطْفاً	N;NHUM;ACC;INDF;MASC;SG
لَبِق	لَبِقا	ADJ;NOM;SPEC;MASC;DU
رَوِيّ	رَوِيَّيْ	ADJ;GEN;SPEC;MASC;DU
نَبَذ	نَبَذْتِ	V;PFV;FEM;IND;SG;2;ACT
مَغَبَّة	المَغَبَّةُ	N;NHUM;NOM;DEF;FEM;SG
نَقِيب	النَّقِيبُ	N;HUM;NOM;DEF;MASC;SG
مَلّاح	المَلّاحاتِ	N;HUM;ACC;DEF;FEM;PL
مَرّاكِشِيّ	مَرّاكِشِيِّينَ	ADJ;ACC;INDF;MASC;PL
كَثَّف	نُكَثِّفَ	V;IPFV;SBJV;PL;1;ACT
حَشِيش	حَشِيشُ	N;NHUM;NOM;MASC;SG;PSSD
جَرِيء	الجَرِيئَتَيْ	ADJ;GEN;DEF;FEM;DU;PSSD
لِيبِرالِيّ	اللِّيبِرالِيَّيْنِ	ADJ;GEN;DEF;MASC;DU
مُنْعِش	مُنْعِشَةَ	ADJ;ACC;FEM;SG;PSSD
جَدِيد	الجَدِيدَتانِ	ADJ;NOM;DEF;FEM;DU
ٱِنْتَقَل	تَنْتَقِلَ	V;IPFV;MASC;SBJV;SG;2;ACT
بُوظَة	بُوظَةً	N;NHUM;ACC;INDF;FEM;SG
تَوْضِيحِيّ	تَوْضِيحِيّاتِ	ADJ;GEN;FEM;PL;PSSD
أَرْضِيّ	أَرْضِيِّ	ADJ;GEN;MASC;SG;PSSD
تَرَأَّس	أَتَرَأَّسْ	V;IPFV;JUS;SG;1;ACT
إِفادَة	إِفادَةٌ	N;NHUM;NOM;INDF;FEM;SG
تَكْرِيمِيّ	التَّكْرِيمِيَّةَ	ADJ;ACC;DEF;FEM;SG
مِرَشَّة	مِرَشَّتَيْنِ	N;NHUM;ACC;INDF;FEM;DU
رَهِين	رَهِينات	N;NHUM;FEM;PL;PSSD
تَطَرُّق	التَّطَرُّقاتُ	N;NHUM;NOM;DEF;MASC;PL
جَنُوبِيّ	جَنُوبِيَّةَ	ADJ;ACC;FEM;SG;PSSD
خادِع	الخادِعَيْنِ	ADJ;ACC;DEF;MASC;DU
صالَح	تُصالِحْ	V;IPFV;FEM;JUS;SG;3;ACT
واهِي	واهِيَتا	ADJ;NOM;FEM;DU;PSSD
مِعْمارِيّ	مِعْمارِيِّينَ	ADJ;ACC;INDF;MASC;PL
مُبْتَدِئ	مُبْتَدِئُونَ	N;HUM;NOM;INDF;MASC;PL
شابّ	شابَّيْنِ	N;HUM;GEN;INDF;MASC;DU
تَساوِي	تَساوِيَ	N;NHUM;ACC;MASC;SG;PSSD
صِرْبِيّ	صِرْبِيّاتٍ	ADJ;ACC;INDF;FEM;PL
مُتَعامِل	مُتَعامِلاتُ	N;HUM;NOM;FEM;PL;PSSD
مَكْتُوف	مَكْتُوفَتَيْنِ	ADJ;ACC;INDF;FEM;DU
واقِي	الواقِيَيْنِ	ADJ;ACC;DEF;MASC;DU
مُتَسائِل	المُتَسائِلَتانِ	ADJ;NOM;DEF;FEM;DU
عَزَف	أَعْزِفُ	V;IPFV;IND;SG;1;ACT
مَغْرُور	مَغْرُورَةَ	ADJ;ACC;SPEC;FEM;SG
أَطْفَأ	أَطْفَأْتُما	V;PFV;MASC;IND;DU;2;ACT
أُورُوغُوايانِيّ	أُورُوغُويانِيَّةِ	ADJ;GEN;SPEC;FEM;SG
تَشْرِيد	تَشْرِيدَيْ	N;NHUM;ACC;MASC;DU;PSSD
ٱِتِّقاء	اِتِّقاءٍ	N;NHUM;GEN;INDF;MASC;SG
قاطِن	قاطِنَةَ	ADJ;ACC;FEM;SG;PSSD
مُخْتَبِئ	مُخْتَبِئَة	N;NHUM;FEM;SG;PSSD
سَماوِيّ	سَمائِيّاتِ	ADJ;GEN;SPEC;FEM;PL
حائِر	الحائِرِي	ADJ;GEN;DEF;MASC;PL;PSSD
مُكَثِّف	المُكَثِّفُ	ADJ;NOM;DEF;MASC;SG
ذاكِر	الذّاكِرِي	ADJ;ACC;DEF;MASC;PL;PSSD
أَهْلَك	أَهْلَكا	V;PFV;MASC;IND;DU;3;ACT
أَحَسّ	يُحِسّانِ	V;IPFV;MASC;IND;DU;3;ACT
قَوْمِيّ	قَوْمِيَّتَيْنِ	ADJ;GEN;INDF;FEM;DU
مُتَحَكِّم	مُتَحَكِّمات	ADJ;SPEC;FEM;PL
جَيِّد	جَيِّدات	ADJ;FEM;PL;PSSD
مُتَعَثِّر	المُتَعَثِّرَة	N;NHUM;DEF;FEM;SG
مُجْتَمَع	مُجْتَمَعانِ	N;NHUM;NOM;INDF;MASC;DU
إِعْداد	إِعْدادا	N;NHUM;NOM;MASC;DU;PSSD
حِجاب	حُجُبِ	N;NHUM;GEN;MASC;PL;PSSD
مُطَّرِد	المُطَّرِدَة	ADJ;DEF;FEM;SG;PSSD
ذاب	تَذُوبُونَ	V;IPFV;MASC;IND;PL;2;ACT
مَصْرَع	المَصْرَعُ	N;NHUM;NOM;DEF;MASC;SG
آمِل	آمِلَتَيْ	N;HUM;ACC;FEM;DU;PSSD
فَقُّوس	فَقُّوسَتَيْ	N;NHUM;GEN;FEM;DU;PSSD
مَشْرَب	مَشارِبِ	N;NHUM;GEN;MASC;PL;PSSD
زانِي	زانِياتُ	N;HUM;NOM;SPEC;FEM;PL
سامِي	سامِيَ	ADJ;ACC;MASC;SG;PSSD
تَلْمِيح	تَلْمِيح	N;NHUM;INDF;MASC;SG
ناشِط	ناشِطَةَ	N;HUM;ACC;FEM;SG;PSSD
مُبْتَسِم	مُبْتَسِمَيْنِ	ADJ;ACC;INDF;MASC;DU
جَرِيح	جَرِيحَة	ADJ;SPEC;FEM;SG
مُكْتَمَل	مُكْتَمَلَة	ADJ;FEM;SG;PSSD
مُوَقَّت	المُوَقَّتاتِ	ADJ;ACC;DEF;FEM;PL
أَخَصّ	أَخَصّ	ADJ;CMPR;INDF;MASC;PL
مَسْكُونِيّ	مَسْكُونِيّا	ADJ;NOM;MASC;DU;PSSD
حَدا	يُحْدَيْنَ	V;IPFV;FEM;PL;3;PASS
مُوَسَّع	المُوَسَّعُ	ADJ;NOM;DEF;MASC;SG
ٱِعْتِدائِيّ	اِعْتِدائِيُّونَ	ADJ;NOM;INDF;MASC;PL
سَلِيف	سَلِيفِ	N;HUM;GEN;SPEC;MASC;SG
مُنْبَعِث	المُنْبَعِثَةُ	N;NHUM;NOM;DEF;FEM;SG
إِجْرام	الإِجْرامات	N;NHUM;DEF;MASC;PL
نَجِز	تَنْجَزُ	V;IPFV;MASC;IND;SG;2;ACT
مَهِين	المَهِينَ	ADJ;ACC;DEF;MASC;SG;PSSD
مُتَحَرِّر	المُتَحَرِّرُونَ	ADJ;NOM;DEF;MASC;PL
تَمَنِّي	التَّمَنِّيا	N;NHUM;NOM;DEF;MASC;DU
شَقِيق	شَقِيقٍ	N;HUM;GEN;INDF;MASC;SG
رَكِب	تَرْكَبُونَ	V;IPFV;MASC;IND;PL;2;ACT
مُحْتَرِف	مُحْتَرِفَيْ	ADJ;GEN;SPEC;MASC;DU
ٱِنْتَشَل	اِنْتَشَلْتُ	V;PFV;IND;SG;1;ACT
نَبَت	تَنْبُتُ	V;IPFV;FEM;IND;SG;3;ACT
جَدِيد	جَدِيدَةِ	ADJ;GEN;SPEC;FEM;SG
سَوِيّ	سَوِيّاتِ	ADJ;ACC;FEM;PL;PSSD
طَرَد	تُطْرَدْنَ	V;IPFV;FEM;PL;2;PASS
مُحَرَّف	مُحَرَّفا	ADJ;NOM;MASC;DU;PSSD
صام	نَصُومُ	V;IPFV;IND;PL;1;ACT
تَبادُل	تَبادُلات	N;NHUM;INDF;MASC;PL
صَرّاخ	صَرّاخَ	N;HUM;ACC;SPEC;MASC;SG
بِرْقِش	بِرْقِشٍ	N;NHUM;GEN;INDF;MASC;SG
صَنَّف	تُصَنِّفْ	V;IPFV;MASC;JUS;SG;2;ACT
مُرْهَف	مُرْهَفَيْ	ADJ;GEN;MASC;DU;PSSD
شَرَع	يَشْرَعانِ	V;IPFV;MASC;IND;DU;3;ACT
مُتَضَرِّر	مُتَضَرِّرَ	N;NHUM;ACC;MASC;SG;PSSD
مُنْغَلِق	المُنْغَلِقاتِ	ADJ;ACC;DEF;FEM;PL;PSSD
مُشَغَّل	مُشَغَّلَيْ	N;HUM;GEN;MASC;DU;PSSD
وَلِيّ	أَوْلِياءَ	N;HUM;ACC;SPEC;MASC;PL
ٱِجْتِماعِيّ	اِجْتِماعِيِّينَ	ADJ;ACC;INDF;MASC;PL
كَسِل	كَسِلٌ	N;NHUM;NOM;INDF;MASC;SG
إِفْلات	إِفْلات	N;NHUM;INDF;MASC;SG
إِجْمالِيّ	إِجْمالِيَّيْنِ	N;NHUM;GEN;INDF;MASC;DU
أُوبِرالِيّ	أُوبِرالِيَّتَيْ	ADJ;GEN;SPEC;FEM;DU
تَرْقِيد	التَّرْقِيدُ	N;NHUM;NOM;DEF;MASC;SG
رابِع	الرّابِعَة	ADJ;DEF;FEM;SG
واضِح	الواضِحَةِ	ADJ;GEN;DEF;FEM;SG
مُرابِط	المُرابِطَة	ADJ;DEF;FEM;SG
مُتَوَقِّع	مُتَوَقِّعِي	ADJ;GEN;SPEC;MASC;PL
ثَبَّط	يُثَبِّطُوا	V;IPFV;MASC;PL;3;ACT
ساقِطَة	السّاقِطاتِ	N;HUM;GEN;DEF;FEM;PL
لادِيمُوقراطِيّ	لادِيمُوقراطِيُّو	ADJ;NOM;SPEC;MASC;PL
مُجْرِم	مُجْرِمِينَ	N;HUM;GEN;INDF;MASC;PL
مُساعِد	مُساعِدَة	N;HUM;INDF;FEM;SG
إِتْنِيَّة	الإِتْنِيَّةِ	N;NHUM;GEN;DEF;FEM;SG
زاهِر	الزّاهِر	ADJ;DEF;MASC;SG;PSSD
ٱِعْتِزاز	اِعْتِزازاتِ	N;NHUM;GEN;MASC;PL;PSSD
عُضْو	أَعْضاءُ	ADJ;NOM;SPEC;MASC;PL
تَرَفُّع	تَرَفُّعِ	N;NHUM;GEN;MASC;SG;PSSD
مُحِقّ	المُحِقَّةُ	ADJ;NOM;DEF;FEM;SG
مُعْلَن	مُعْلَن	ADJ;INDF;MASC;SG
جِسْم	الجِسْمَ	N;NHUM;ACC;DEF;MASC;SG
مُسْتَثْمِر	مُسْتَثْمِراتٍ	N;HUM;ACC;INDF;FEM;PL
حائِز	حائِزَةِ	ADJ;GEN;SPEC;FEM;SG
نَرُوجِيّ	نَرُوجِيِّينَ	ADJ;GEN;INDF;MASC;PL
ٱِنْفَعَل	اِنْفَعَلْتَ	V;PFV;MASC;IND;SG;2;ACT
إِعارَة	إِعارَتَيْنِ	N;NHUM;ACC;INDF;FEM;DU
ٱِسْتَبْقَى	اِسْتَبْقَتا	V;PFV;FEM;IND;DU;3;ACT
صِينِيّ	صِينِيٍّ	ADJ;GEN;INDF;MASC;SG
ٱِتِّجار	اِتِّجارَيْ	N;NHUM;ACC;SPEC;MASC;DU
تَعَمَّم	تَتَعَمَّما	V;IPFV;FEM;DU;3;ACT
عَجِين	عَجِينِ	N;NHUM;GEN;SPEC;MASC;SG
إِدْخال	إِدْخالَيْنِ	N;NHUM;GEN;INDF;MASC;DU
أَخِير	أَخِيرانِ	N;NHUM;NOM;INDF;MASC;DU
عَمَّم	أُعَمِّمُ	V;IPFV;IND;SG;1;ACT
داوَر	تُداوِرُونَ	V;IPFV;MASC;IND;PL;2;ACT
عاطِفَة	عاطِفَة	N;NHUM;INDF;FEM;SG
ساقَى	يُساقِيْنَ	V;IPFV;FEM;PL;3;ACT
مُصاب	المُصاباتُ	N;HUM;NOM;DEF;FEM;PL
مُشاجَرَة	المُشاجَرَتانِ	N;NHUM;NOM;DEF;FEM;DU
مُصَنَّع	المُصَنَّعا	ADJ;NOM;DEF;MASC;DU;PSSD
مُمْسِك	مُمْسِكِ	N;NHUM;GEN;SPEC;MASC;SG
مُسْبَق	مُسْبَقِ	ADJ;GEN;MASC;SG;PSSD
مُسْتَعار	مُسْتَعارَةِ	ADJ;GEN;FEM;SG;PSSD
ثَمْر	ثَمْرَةُ	N;NHUM;NOM;FEM;SG;PSSD
مُنْغَلِق	مُنْغَلِقا	ADJ;NOM;MASC;DU;PSSD
جَسِيم	جَسِيمَةِ	ADJ;GEN;FEM;SG;PSSD
نَبَّه	نَبَّهْتُ	V;PFV;IND;SG;1;ACT
تَكْذِيب	تَكْذِيباتٌ	N;NHUM;NOM;INDF;MASC;PL
مَلْأَك	مَلاكَيْنِ	N;NHUM;ACC;INDF;MASC;DU
آل	آلٍ	N;NHUM;GEN;INDF;MASC;SG
أَزْرَق	أَزْرَقَيْ	N;NHUM;ACC;SPEC;MASC;DU
مُقاتَلَة	مُقاتَلَتَيْ	N;NHUM;ACC;FEM;DU;PSSD
أَرْجَع	تُرْجِعا	V;IPFV;FEM;DU;3;ACT
جامِع	الجامِعَتَيْ	ADJ;GEN;DEF;FEM;DU;PSSD
حَقَّر	تُحَقِّرُ	V;IPFV;MASC;IND;SG;2;ACT
فَقْرَة	فَقَراتُ	N;NHUM;NOM;FEM;PL;PSSD
ٱِسْتِخْبارِيّ	اِسْتِخْبارِيّات	ADJ;SPEC;FEM;PL
مُصاب	مُصاباتِ	N;HUM;ACC;FEM;PL;PSSD
باكِستانِيّ	باكِستانِيِّي	ADJ;ACC;SPEC;MASC;PL
مُناسَبَة	مُناسَباتٌ	N;NHUM;NOM;INDF;FEM;PL
غَرْس	الغَرْس	N;NHUM;DEF;MASC;SG
مائِع	المائِعانِ	ADJ;NOM;DEF;MASC;DU
كَلَّف	تُكَلِّفا	V;IPFV;FEM;DU;3;ACT
مُدَوَّر	المُدَوَّرَتانِ	ADJ;NOM;DEF;FEM;DU
مَثِيل	مَثِيلات	N;NHUM;INDF;FEM;PL
أَكادِيمِيّ	أَكادِيمِيِّي	ADJ;ACC;MASC;PL;PSSD
فِيدِرالِيّ	الفِدِرالِيَّةِ	N;NHUM;GEN;DEF;FEM;SG
مِيكْرُوب	المِكْرُوبِ	N;NHUM;GEN;DEF;MASC;SG
قَيِّم	القَيِّمَ	ADJ;ACC;DEF;MASC;SG
تَأَبَّط	تَأَبَّطَت	V;PFV;FEM;IND;SG;3;ACT
زَغْرَدَة	زَغْرَدَةِ	N;NHUM;GEN;FEM;SG;PSSD
طَحَن	طَحَنْتُم	V;PFV;MASC;IND;PL;2;ACT
سَذاجَة	السَّذاجَةَ	N;NHUM;ACC;DEF;FEM;SG
ٱِشْتِراط	الاِشْتِراطِ	N;NHUM;GEN;DEF;MASC;SG
مُحَرِّض	المُحَرِّضَةُ	ADJ;NOM;DEF;FEM;SG
تَمْهِيدِيّ	تَمْهِيدِيَّ	ADJ;ACC;SPEC;MASC;SG
ٱِلْتَأَم	أَلْتَئِمْ	V;IPFV;JUS;SG;1;ACT
مُخالِف	مُخالِفاتٌ	N;NHUM;NOM;INDF;FEM;PL
دَوَى	دَوَتا	V;PFV;FEM;IND;DU;3;ACT
شَتات	الشَّتِيتاتُ	ADJ;NOM;DEF;FEM;PL;PSSD
مُتَعالِي	المُتَعالِياتِ	ADJ;ACC;DEF;FEM;PL
زاد	أُزَدْ	V;IPFV;JUS;SG;1;PASS
مُسْهِب	مُسْهِبانِ	ADJ;NOM;INDF;MASC;DU
جَمايْكِيّ	جامايْكِيَّيْ	N;HUM;ACC;MASC;DU;PSSD
مُضارِب	مُضارِباتِ	N;HUM;GEN;FEM;PL;PSSD
مَدْعُوم	مَدْعُومِينَ	ADJ;GEN;INDF;MASC;PL
مَعْذِرَة	مَعْذِرَةٍ	N;NHUM;GEN;INDF;FEM;SG
مُسْتَوْرِد	مُسْتَوْرِدٍ	N;HUM;GEN;INDF;MASC;SG
أَرْبَك	تُرْبَكُونَ	V;IPFV;MASC;IND;PL;2;PASS
مُرَوِّج	المُرَوِّجِينَ	ADJ;GEN;DEF;MASC;PL
تَضَخَّم	يَتَضَخَّمانِ	V;IPFV;MASC;IND;DU;3;ACT
مِئْذَنَة	مَأْذَنَتَيْنِ	N;NHUM;GEN;INDF;FEM;DU
نَشَأ	نَشَأَ	V;PFV;MASC;IND;SG;3;ACT
أَجْدَى	يُجْدَيا	V;IPFV;MASC;DU;3;PASS
شَبِع	تَشْبَعا	V;IPFV;FEM;DU;3;ACT
تَفْسِير	التَّفْسِيرا	N;NHUM;NOM;DEF;MASC;DU
مَضْجَع	مَضْجَعِ	N;NHUM;GEN;SPEC;MASC;SG
مَشْرِق	مَشْرِقِ	N;NHUM;GEN;SPEC;MASC;SG
مُحْتَلّ	مُحْتَلّاً	ADJ;ACC;INDF;MASC;SG
مُنَظِّم	مُنَظِّمَتانِ	ADJ;NOM;INDF;FEM;DU
صارِم	الصّارِمانِ	ADJ;NOM;DEF;MASC;DU
شاحِب	شاحِباتُ	ADJ;NOM;FEM;PL;PSSD
شَغّال	شَغّالُو	N;HUM;NOM;MASC;PL;PSSD
سَعِد	يَسْعَدُونَ	V;IPFV;MASC;IND;PL;3;ACT
مِعْمارِيّ	المِعْمارِيِّي	ADJ;ACC;DEF;MASC;PL;PSSD
وَقّاع	وَقّاعَتَيْ	N;HUM;GEN;FEM;DU;PSSD
جَرّافَة	جَرّافَتَيْنِ	N;NHUM;GEN;INDF;FEM;DU
ٱِلْتِباس	اِلْتِباساتِ	N;NHUM;GEN;MASC;PL;PSSD
ٱِسْمِيّ	اِسْمِيَّتَيْنِ	ADJ;ACC;INDF;FEM;DU
بَرْقِيّ	بَرْقِيُّ	ADJ;NOM;MASC;SG;PSSD
قِرْد	قِرْدَة	N;NHUM;SPEC;FEM;SG
مَضْبُوط	مَضْبُوطَيْ	ADJ;ACC;SPEC;MASC;DU
أَشْعَر	أُشْعِرْ	V;IPFV;JUS;SG;1;ACT
لَمّ	لَمّ	N;NHUM;INDF;MASC;SG
لِيرَة	اللِّيرات	N;NHUM;DEF;FEM;PL
سُومِرِيّ	السُّومِرِيَّتَيْنِ	ADJ;GEN;DEF;FEM;DU
فَنَّد	تُفَنِّدْ	V;IPFV;FEM;JUS;SG;3;ACT
وِلايَة	الوِلايات	N;NHUM;DEF;FEM;PL
أَصْغَر	أَصْغَرَ	ADJ;ACC;CMPR;MASC;SG;PSSD
فَلَك	الفَلَكِ	N;NHUM;GEN;DEF;MASC;SG
عاتِب	العاتِبِي	N;NHUM;GEN;DEF;MASC;PL
مُتَحَدِّث	مُتَحَدِّثَ	N;HUM;ACC;MASC;SG;PSSD
أَتْبَع	يُتْبَعُوا	V;IPFV;MASC;PL;3;PASS
دِين	الأَدْيان	N;NHUM;DEF;MASC;PL
حاكِم	حاكِما	ADJ;NOM;MASC;DU;PSSD
مِيلادِيّ	المِيلادِيَّةِ	ADJ;GEN;DEF;FEM;SG
نِيُويُورْكِيّ	نِيُويُورْكِيَّتَيْنِ	ADJ;GEN;INDF;FEM;DU
مُتَشَدِّد	مُتَشَدِّدَتانِ	N;HUM;NOM;SPEC;FEM;DU
تَخَشَّى	يَتَخَشَّيْنَ	V;IPFV;FEM;PL;3;ACT
أَسَف	أَسَف	N;NHUM;INDF;MASC;SG
تَصَدُّر	التَّصَدُّرِ	N;NHUM;GEN;DEF;MASC;SG
قَوْلَة	قَوْلَةُ	N;NHUM;NOM;SPEC;FEM;SG
عَرِيض	عَرِيضَتَيْ	ADJ;GEN;SPEC;FEM;DU
بِقاعِيّ	بِقاعِيَّة	ADJ;SPEC;FEM;SG
تَخَصُّصِيّ	تَخَصُّصِيَّتا	ADJ;NOM;FEM;DU;PSSD
ٱِسْتِقامَة	اِسْتِقامَة	N;NHUM;FEM;SG;PSSD
ٱِسْتَنّ	يَسْتَنُّونَ	V;IPFV;MASC;IND;PL;3;ACT
زَوْج	الأَزْواجَ	N;NHUM;ACC;DEF;MASC;PL
رَنا	يَرْنُوَ	V;IPFV;MASC;SBJV;SG;3;ACT
مُتَسَلِّط	مُتَسَلِّطَة	ADJ;FEM;SG;PSSD
راقِي	راقِيَتَيْ	ADJ;ACC;FEM;DU;PSSD
تَمْوِيلِيّ	تَمْوِيلِيِّ	ADJ;GEN;SPEC;MASC;SG
تَجَوُّل	تَجَوُّلَ	N;NHUM;ACC;MASC;SG;PSSD
مُؤَسَّساتِيّ	مُؤَسَّساتِيّات	ADJ;INDF;FEM;PL
بِطالَة	بَطالَةٌ	N;NHUM;NOM;INDF;FEM;SG
سَجِين	سَجِينٌ	N;HUM;NOM;INDF;MASC;SG
أَساسِيّ	أَساسِيَّة	ADJ;SPEC;FEM;SG
مُنْجَذَب	مُنْجَذَبِ	ADJ;GEN;SPEC;MASC;SG
بُوم	بُومَةِ	N;NHUM;GEN;FEM;SG;PSSD
مَسِير	مَسِيرٍ	N;NHUM;GEN;INDF;MASC;SG
راقَب	راقَبْتُ	V;PFV;IND;SG;1;ACT
بالِغ	البالِغاتِ	N;HUM;ACC;DEF;FEM;PL
لِنِينِيّ	لِنِينِيّ	ADJ;INDF;MASC;SG
مُوحِي	مُوحٍ	ADJ;NOM;INDF;MASC;SG
عاوَد	تُعاوِدُ	V;IPFV;MASC;IND;SG;2;ACT
مُماطَلَة	مُماطَلَتا	N;NHUM;NOM;FEM;DU;PSSD
وافِد	الوافِدَةُ	ADJ;NOM;DEF;FEM;SG;PSSD
أَبْقَى	الأَبْقَيا	ADJ;NOM;CMPR;DEF;MASC;DU
أَمْرِيكِيّ	أَمِيرْكِيّا	ADJ;NOM;MASC;DU;PSSD
قالِب	قالَبَيْ	N;NHUM;ACC;MASC;DU;PSSD
رَنّان	رَنّانَتانِ	ADJ;NOM;INDF;FEM;DU
ناطِق	النّاطِقَةِ	N;HUM;GEN;DEF;FEM;SG
تَبْلِيغ	التَّبْلِيغا	N;NHUM;NOM;DEF;MASC;DU
تَفاهَم	يَتَفاهَمُونَ	V;IPFV;MASC;IND;PL;3;ACT
مُسْلِم	المُسْلِمَتَيْنِ	ADJ;ACC;DEF;FEM;DU
أَفْغانِيّ	أَفْغانِيَّتا	N;HUM;NOM;FEM;DU;PSSD
إِنْباء	إِنْباءاتُ	N;NHUM;NOM;SPEC;MASC;PL
مُعادِي	مُعادِيَ	ADJ;ACC;MASC;SG;PSSD
ثَوْب	الثَّوْبَيْ	N;NHUM;ACC;DEF;MASC;DU
عَقَب	أَعْقُبُ	V;IPFV;IND;SG;1;ACT
مُحْتَجَز	مُحْتَجَزاتِ	ADJ;GEN;FEM;PL;PSSD
لاإِنْسانِيّ	لاإِنْسانِيَّيْنِ	ADJ;GEN;INDF;MASC;DU
سِيرالِيُونِيّ	السِّيرالِيُونِيِّ	ADJ;GEN;DEF;MASC;SG;PSSD
مُسَبِّب	مُسَبِّبِي	ADJ;ACC;SPEC;MASC;PL
شِرائِيّ	شِرائِيَّةٌ	ADJ;NOM;INDF;FEM;SG
ٱِنْفَصَل	تَنْفَصِلِي	V;IPFV;FEM;SG;2;ACT
عَلِم	عَلِمْنَ	V;PFV;FEM;IND;PL;3;ACT
زُجاجَة	زُجاجَةَ	N;NHUM;ACC;SPEC;FEM;SG
مَفْسَدَة	مَفْسَدَةً	N;NHUM;ACC;INDF;FEM;SG
سَرار	سَرارِ	N;NHUM;GEN;MASC;SG;PSSD
مُخَنَّث	مُخَنَّثَةَ	ADJ;ACC;SPEC;FEM;SG
مُلْتَهِب	مُلْتَهِبِينَ	ADJ;GEN;INDF;MASC;PL
كُلْوَة	كُلْوَةً	N;NHUM;ACC;INDF;FEM;SG
تَعْطِير	تَعْطِيراتٍ	N;NHUM;GEN;INDF;MASC;PL
مُضْطَرّ	مُضْطَرَّة	ADJ;FEM;SG;PSSD
تَسابَق	يَتَسابَقانِ	V;IPFV;MASC;IND;DU;3;ACT
تَكْسِير	تَكْسِيرَ	N;NHUM;ACC;MASC;SG;PSSD
تَقَشُّفِيّ	تَقَشُّفِيّاتٍ	ADJ;ACC;INDF;FEM;PL
أَبْرَم	أُبْرِمْتَ	V;PFV;MASC;IND;SG;2;PASS
مَرَّر	أُمَرِّرْ	V;IPFV;JUS;SG;1;ACT
ضَوْء	أَضْواءَ	N;NHUM;ACC;SPEC;MASC;PL
فارِع	فارِعَة	ADJ;SPEC;FEM;SG
نَطَق	يُنْطَقْ	V;IPFV;MASC;JUS;SG;3;PASS
قَلْفَة	قَلْفَةً	N;NHUM;ACC;INDF;FEM;SG
إِرْشادِيّ	إِرْشادِيّ	ADJ;INDF;MASC;SG
مُضارَبَة	مُضارَبَةُ	N;NHUM;NOM;FEM;SG;PSSD
أَرْجَنْتِينِيّ	أَرْجَنْتِينِيٌّ	N;HUM;NOM;INDF;MASC;SG
مُنْتَصِر	مُنْتَصِرَةً	ADJ;ACC;INDF;FEM;SG
تَوَقَّف	تَتَوَقَّفْنَ	V;IPFV;FEM;PL;2;ACT
تَغْطِيَة	تَغْطِيَة	N;NHUM;INDF;FEM;SG
مُؤَمَّن	مُؤَمَّنِ	ADJ;GEN;MASC;SG;PSSD
صاغِي	الصّاغِيَتا	ADJ;NOM;DEF;FEM;DU;PSSD
مَسْؤُول	المَسْؤُولاتِ	N;HUM;ACC;DEF;FEM;PL
أَضْرَب	تُضْرِبانِ	V;IPFV;MASC;IND;DU;2;ACT
أَتْحَف	تُتْحِفُ	V;IPFV;MASC;IND;SG;2;ACT
مُتَعاقِد	مُتَعاقِدِينَ	N;HUM;GEN;INDF;MASC;PL
مَنْخَر	مَنْخَرَ	N;NHUM;ACC;MASC;SG;PSSD
غامِض	الغَوامِضُ	ADJ;NOM;DEF;MASC;PL
بَحْرِيّ	بَحْرِيّاتٍ	ADJ;ACC;INDF;FEM;PL
تَثْقِيفِيّ	التَّثْقِيفِيُّونَ	ADJ;NOM;DEF;MASC;PL
بَرّانِيّ	البَرّانِيَّة	ADJ;DEF;FEM;SG
مُناهِض	المُناهِضُو	N;HUM;NOM;DEF;MASC;PL
مَحْمِيّ	مَحْمِيَّ	ADJ;ACC;SPEC;MASC;SG
نَدا	تَنْدُوَ	V;IPFV;FEM;SBJV;SG;3;ACT
أَثِير	أَثِيرَيْ	N;NHUM;ACC;MASC;DU;PSSD
مُتَدَيِّن	مُتَدَيِّنَة	ADJ;FEM;SG;PSSD
حَبِيس	الحُبَساء	ADJ;DEF;MASC;PL
مَأْوَى	مَآوٍ	N;NHUM;GEN;INDF;MASC;PL
مُورِيتانِيّ	المُورِيتانِيَّةِ	ADJ;GEN;DEF;FEM;SG
لُبْنانِيّ	لُبْنانِيّات	ADJ;INDF;FEM;PL
رِسالَة	رَسائِلَ	N;NHUM;GEN;INDF;FEM;PL
مُسَجِّل	المُسَجِّل	N;NHUM;DEF;MASC;SG
مُمْكِن	مُمْكِنَيْ	ADJ;ACC;MASC;DU;PSSD
تَوَسَّع	تَتَوَسَّعُوا	V;IPFV;MASC;PL;2;ACT
رِجْل	رِجْلا	N;NHUM;NOM;MASC;DU;PSSD
صَبِيب	صَبِيبِ	N;NHUM;GEN;SPEC;MASC;SG
مُلْحَقات	المَلاحِقَ	N;NHUM;ACC;DEF;MASC;PL
صالَة	الصّالَتَيْ	N;NHUM;GEN;DEF;FEM;DU
ٱِسْتِثْنائِيّ	اِسْتِثْنائِيَّة	ADJ;FEM;SG;PSSD
جَرّاح	جَرّاحُو	N;HUM;NOM;MASC;PL;PSSD
رادِع	الرّادِعَيْ	N;NHUM;GEN;DEF;MASC;DU
رَجْعِيّ	الرَّجْعِيّاتُ	ADJ;NOM;DEF;FEM;PL;PSSD
إِسْتُودِيُو	إِسْتُودِيُوٍ	N;NHUM;GEN;INDF;MASC;SG
واضِع	واضِعَةُ	N;HUM;NOM;SPEC;FEM;SG
مُشْرِف	مُشْرِفَةُ	N;HUM;NOM;SPEC;FEM;SG
تَوافُق	تَوافُقَ	N;NHUM;ACC;SPEC;MASC;SG
أَفْرَغ	نُفْرِغَ	V;IPFV;SBJV;PL;1;ACT
عَطَل	عَطَلٌ	N;NHUM;NOM;INDF;MASC;SG
مَعْنِيّ	مَعْنِيَّيْ	N;NHUM;GEN;MASC;DU;PSSD
لَيْسَ	لَسْتَ	V;PFV;MASC;IND;SG;2;ACT
ساتِر	سَواتِرُ	N;NHUM;NOM;INDF;MASC;PL
شَيْخ	شَيْخُ	ADJ;NOM;SPEC;MASC;SG
ٱِضْطَرَب	تَضْطَرِبْ	V;IPFV;MASC;JUS;SG;2;ACT
شَخَّص	تُشَخِّصانِ	V;IPFV;FEM;IND;DU;3;ACT
عِلْم	عُلُومَ	N;NHUM;ACC;MASC;PL;PSSD
تَعافَى	تَتَعافَيانِ	V;IPFV;MASC;IND;DU;2;ACT
ٱِنْتِقال	اِنْتِقالُ	N;NHUM;NOM;MASC;SG;PSSD
تَعاوَن	تَتَعاوَنَ	V;IPFV;MASC;SBJV;SG;2;ACT
عَزّ	تَعِزَّ	V;IPFV;MASC;SBJV;SG;2;ACT
مَثّال	مَثّالُو	N;NHUM;NOM;SPEC;MASC;PL
أَمْثَل	أَمْثَلانِ	N;NHUM;NOM;INDF;MASC;DU
طاقِم	طاقِمُ	N;NHUM;NOM;SPEC;MASC;SG
مُرافِق	مُرافِقاتٌ	N;HUM;NOM;INDF;FEM;PL
مَطْعُون	المَطْعُونَيْ	ADJ;ACC;DEF;MASC;DU;PSSD
مُنْحاز	المُنْحازَةُ	ADJ;NOM;DEF;FEM;SG;PSSD
جَحْفَل	جَحْفَلِ	N;NHUM;GEN;MASC;SG;PSSD
كِبْرِياء	كِبْرِياءُ	N;NHUM;NOM;INDF;MASC;SG
ٱِسْتِيطانِيّ	الاِسْتِيطانِيَّة	ADJ;DEF;FEM;SG
إِكْرام	إِكْرامَ	N;NHUM;ACC;MASC;SG;PSSD
قَمْح	قَمْحَة	N;NHUM;SPEC;FEM;SG
حَرامِيّ	الحَرامِيّا	N;HUM;NOM;DEF;MASC;DU
أَضاف	أَضَفْتُم	V;PFV;MASC;IND;PL;2;ACT
بَرَّر	بَرَّرْتُم	V;PFV;MASC;IND;PL;2;ACT
وَظَّف	تُوَظَّفُونَ	V;IPFV;MASC;IND;PL;2;PASS
فاحِص	فُحّاص	N;HUM;INDF;MASC;PL
قَوْمَة	القَوْمَةَ	N;NHUM;ACC;DEF;FEM;SG
ٱِسْتِقْرار	اِسْتِقْرارَيْنِ	N;NHUM;ACC;INDF;MASC;DU
حُمُولَة	الحُمُولَةِ	N;NHUM;GEN;DEF;FEM;SG
أَحْكَم	أُحْكِمْ	V;IPFV;JUS;SG;1;ACT
تشِيلِيانِيّ	تشِيلِيانِيّاتُ	N;HUM;NOM;FEM;PL;PSSD
حاكِم	الحاكِمُو	ADJ;NOM;DEF;MASC;PL;PSSD
لازِم	اللّازِمَيْنِ	ADJ;ACC;DEF;MASC;DU
أَحْيائِيّ	الأَحْيائِيَّ	ADJ;ACC;DEF;MASC;SG;PSSD
مُدَرِّس	مُدَرِّسا	N;HUM;NOM;MASC;DU;PSSD
شَكْلِيّ	الشَّكْلِيّات	ADJ;DEF;FEM;PL;PSSD
بِنائِيّ	بِنائِيِّ	ADJ;GEN;MASC;SG;PSSD
أَلْقَى	تُلْقِ	V;IPFV;MASC;JUS;SG;2;ACT
ضَيْعَة	الضِّياع	N;NHUM;DEF;FEM;PL
ٱِنْقَشَع	تَنْقَشِعانِ	V;IPFV;FEM;IND;DU;3;ACT
تَخَلُّص	تَخَلُّصاتِ	N;NHUM;ACC;MASC;PL;PSSD
تَناهَى	تَتَناهَ	V;IPFV;MASC;JUS;SG;2;ACT
لُبْنانِيّ	لُبْنانِيّاتِ	N;HUM;GEN;SPEC;FEM;PL
سَبْتِيّ	سَبْتِيّاتٌ	ADJ;NOM;INDF;FEM;PL
مُزْدَهِر	المُزْدَهِراتِ	ADJ;GEN;DEF;FEM;PL
حَفْرِيّ	الحَفْرِيَّتا	ADJ;NOM;DEF;FEM;DU;PSSD
مُحْسِن	المُحْسِنُو	ADJ;NOM;DEF;MASC;PL;PSSD
رَكِيزَة	رَكِيزَتَيْ	N;NHUM;ACC;SPEC;FEM;DU
مُتَقاطِع	المُتَقاطِعَيْنِ	ADJ;ACC;DEF;MASC;DU
تَوْضِيح	تَوْضِيحات	N;NHUM;INDF;MASC;PL
مُحَصِّل	مُحَصِّلاتُ	N;HUM;NOM;SPEC;FEM;PL
تَوْقِيت	تَوْقِيتاتٌ	N;NHUM;NOM;INDF;MASC;PL
ٱِسْتِسْلام	اِسْتِسْلامَيْ	N;NHUM;ACC;SPEC;MASC;DU
شِيشانِيّ	شِيشانِيَّيْنِ	ADJ;ACC;INDF;MASC;DU
مُتَعَهِّد	مُتَعَهِّدَتَيْ	N;HUM;ACC;FEM;DU;PSSD
باسكِيّ	الباسكِيَّتَيْنِ	ADJ;GEN;DEF;FEM;DU
مُعارِض	المُعارِضَتَيْ	ADJ;GEN;DEF;FEM;DU;PSSD
جُرْثُومِيّ	جُرْثُومِيّا	ADJ;NOM;SPEC;MASC;DU
هَزِيمَة	الهَزائِمَ	N;NHUM;ACC;DEF;FEM;PL
قاتِل	قاتِلَتَيْ	ADJ;ACC;FEM;DU;PSSD
مَنْقُول	مَنْقُولات	N;NHUM;MASC;PL;PSSD
فِكْرِيّ	فِكْرِيّانِ	ADJ;NOM;INDF;MASC;DU
ٱِكْتَسَب	اِكْتَسَبْتِ	V;PFV;FEM;IND;SG;2;ACT
رَفِيع	رَفِيعاتِ	ADJ;GEN;SPEC;FEM;PL
تَقاتُل	تَقاتُلاتٍ	N;NHUM;ACC;INDF;MASC;PL
أَحْدَث	تُحْدَثا	V;IPFV;MASC;DU;2;PASS
مَأْتَمِيّ	المَأْتَمِيِّ	ADJ;GEN;DEF;MASC;SG;PSSD
نَعَى	تَنْعَ	V;IPFV;FEM;JUS;SG;3;ACT
مُصَدِّر	المُصَدِّرَ	ADJ;ACC;DEF;MASC;SG
مُتَشَدِّد	مُتَشَدِّدَتَيْ	ADJ;ACC;FEM;DU;PSSD
أَنَّس	تُؤَنِّسْ	V;IPFV;FEM;JUS;SG;3;ACT
مُوحِي	مُوحِيَةَ	ADJ;ACC;SPEC;FEM;SG
ثُلاثِيّ	ثُلاثِيّاتٍ	ADJ;ACC;INDF;FEM;PL
مُراسَلَة	مُراسَلات	N;NHUM;SPEC;FEM;PL
واعِظ	واعِظاً	N;HUM;ACC;INDF;MASC;SG
فرانْكُوفُونِيّ	فرانْكُفُونِيّ	ADJ;INDF;MASC;SG
إِسْلامِيّ	إِسْلامِيَّتَيْ	ADJ;ACC;FEM;DU;PSSD
أَرْسَى	يُرْسِيانِ	V;IPFV;MASC;IND;DU;3;ACT
زال	تَزالَ	V;IPFV;MASC;SBJV;SG;2;ACT
برِيطانِيّ	برِيطانِيّاتُ	ADJ;NOM;FEM;PL;PSSD
أَصْدَق	أَصْدَقَ	ADJ;ACC;CMPR;SPEC;MASC;PL
مُساوِي	المُساوِيَةُ	ADJ;NOM;DEF;FEM;SG
مُنَسِّق	مُنَسِّقَتَيْ	ADJ;GEN;SPEC;FEM;DU
أَبْجَدِيّ	الأَبْجَدِيَّيْ	ADJ;GEN;DEF;MASC;DU;PSSD
باكِر	باكِرَتا	ADJ;NOM;FEM;DU;PSSD
مُتَأَجِّج	مُتَأَجِّجُو	N;NHUM;NOM;MASC;PL;PSSD
ٱِسْتِشارِيّ	اِسْتِشارِيَّة	N;HUM;FEM;SG;PSSD
جِيم	الجِيمَيْ	N;NHUM;GEN;DEF;MASC;DU
مُضَمَّخ	مُضَمَّخِ	ADJ;GEN;MASC;SG;PSSD
حاضَر	حاضَرْتَ	V;PFV;MASC;IND;SG;2;ACT
مُعْوِز	المُعْوِزَةُ	ADJ;NOM;DEF;FEM;SG;PSSD
مُحَقَّق	المُحَقَّقَتَيْ	ADJ;ACC;DEF;FEM;DU;PSSD
مُحاوِر	المُحاوِرَتَيْنِ	ADJ;GEN;DEF;FEM;DU
نَحَت	أَنْحُتَ	V;IPFV;SBJV;SG;1;ACT
ٱِلْتَزَم	تَلْتَزِمْ	V;IPFV;MASC;JUS;SG;2;ACT
عَظْم	عَظْم	N;NHUM;INDF;MASC;SG
سَرَح	يَسْرَحا	V;IPFV;MASC;DU;3;ACT
سادِس	سادِسَةٍ	ADJ;GEN;INDF;FEM;SG
ٱِنْكَشَف	تَنْكَشِفْ	V;IPFV;FEM;JUS;SG;3;ACT
مُرْتَزِق	مُرْتَزِقاتِ	N;HUM;ACC;FEM;PL;PSSD
جَزائِرِيّ	جَزائِرِيّاتِ	ADJ;ACC;FEM;PL;PSSD
تَأْسِيسِيّ	التَّأْسِيسِيَّتا	ADJ;NOM;DEF;FEM;DU;PSSD
راكِد	راكِدانِ	ADJ;NOM;INDF;MASC;DU
قائِل	القائِلَةَ	ADJ;ACC;DEF;FEM;SG;PSSD
أَفْرَج	أُفْرِجْتَ	V;PFV;MASC;IND;SG;2;PASS
كَفِيل	كَفِيلَيْ	ADJ;GEN;MASC;DU;PSSD
مُحْتاج	المُحْتاجَيْ	N;HUM;GEN;DEF;MASC;DU
مادَّة	مَوادُّ	N;NHUM;NOM;FEM;PL;PSSD
شُجاع	شَجَعَةٍ	ADJ;GEN;INDF;MASC;PL
جاهِز	الجاهِزَتَيْ	ADJ;GEN;DEF;FEM;DU;PSSD
أَدْمَج	يُدْمَجُونَ	V;IPFV;MASC;IND;PL;3;PASS
أَغْرَم	أُغْرِمَت	V;PFV;FEM;IND;SG;3;PASS
تَوَسُّعِيّ	التَّوَسُّعِيَّتَيْنِ	ADJ;GEN;DEF;FEM;DU
تَوْقِيع	تَوْقِيعانِ	N;NHUM;NOM;INDF;MASC;DU
ساحِق	ساحِقَةَ	ADJ;ACC;SPEC;FEM;SG
خَرِب	الخَرِباتِ	N;NHUM;GEN;DEF;FEM;PL
مُخالِف	المُخالِف	ADJ;DEF;MASC;SG;PSSD
أَدْكَن	أَدْكَنَيْ	ADJ;ACC;SPEC;MASC;DU
مُخَلِّص	مُخَلِّصَتَيْنِ	N;HUM;ACC;INDF;FEM;DU
مُضْمَر	المُضْمَرَة	ADJ;DEF;FEM;SG
دَفْع	الدَّفْعُ	N;NHUM;NOM;DEF;MASC;SG
ٱِخْتَلَى	تُخْتَلَى	V;IPFV;FEM;IND;SG;3;PASS
مَقْرُون	المَقْرُونُ	ADJ;NOM;DEF;MASC;SG;PSSD
أَرْضَى	تُرْضَيانِ	V;IPFV;FEM;IND;DU;3;PASS
مُتَغَيِّب	المُتَغَيِّبِ	N;HUM;GEN;DEF;MASC;SG
ٱِسْتَفاق	اِسْتَفَقْتَ	V;PFV;MASC;IND;SG;2;ACT
عامِر	عامِرَيْ	ADJ;GEN;MASC;DU;PSSD
إِراحَة	الإِراحَةَ	N;NHUM;ACC;DEF;FEM;SG
مَقْذُوف	مَقْذُوفِ	N;NHUM;GEN;MASC;SG;PSSD
تَحَرُّر	تَحَرُّراتُ	N;NHUM;NOM;MASC;PL;PSSD
صَلاة	صَلَوات	N;NHUM;SPEC;FEM;PL
ثَدْيِيّ	الثَّدْيِيّاتِ	N;NHUM;ACC;DEF;MASC;PL
مُسْتَشْهِد	مُسْتَشْهِدَةَ	ADJ;ACC;FEM;SG;PSSD
يَتِيم	يَتِيمَةُ	N;HUM;NOM;SPEC;FEM;SG
مَذْعُور	المَذْعُورَيْ	ADJ;GEN;DEF;MASC;DU;PSSD
مُتَخَلِّف	المُتَخَلِّفَتا	ADJ;NOM;DEF;FEM;DU;PSSD
أَمات	أَماتَتا	V;PFV;FEM;IND;DU;3;ACT
ٱِكْتِتاب	اِكْتِتاباتٍ	N;NHUM;GEN;INDF;MASC;PL
أَقْصَى	تُقْصِ	V;IPFV;MASC;JUS;SG;2;ACT
شِراعِيّ	شِراعِيَّتانِ	ADJ;NOM;INDF;FEM;DU
نَحْس	نُحُوسُ	N;NHUM;NOM;SPEC;MASC;PL
ٱِرْتِعاش	اِرْتِعاشات	N;NHUM;SPEC;MASC;PL
إِنْشاء	إِنْشاءاتُ	N;NHUM;NOM;SPEC;MASC;PL
ضَخّ	تَضُخُّونَ	V;IPFV;MASC;IND;PL;2;ACT
عَدَدِيّ	العَدَدِيَّة	ADJ;DEF;FEM;SG;PSSD
يَخْت	اليَخْتِ	N;NHUM;GEN;DEF;MASC;SG
حَبِيب	أَحْبابُ	ADJ;NOM;MASC;PL;PSSD
رِسالَة	الرَّسائِل	N;NHUM;DEF;FEM;PL
جَمّ	الجَمَّةُ	N;NHUM;NOM;DEF;FEM;SG
شَكاة	الشَّكاةِ	N;NHUM;GEN;DEF;FEM;SG
مُسْتَنْسَخ	مُسْتَنْسَخِينَ	ADJ;ACC;INDF;MASC;PL
بَطّانِيَّة	بَطّانِيَّة	N;NHUM;INDF;FEM;SG
غائِص	الغائِصَة	ADJ;DEF;FEM;SG;PSSD
أَزْرَق	أَزْرَقا	N;NHUM;NOM;SPEC;MASC;DU
ٱِسْتَخْدَم	يَسْتَخْدِمْنَ	V;IPFV;FEM;PL;3;ACT
تَمْيِيزِيّ	تَمْيِيزِيُّونَ	ADJ;NOM;INDF;MASC;PL
دُفْعَة	الدُّفْعَةَ	N;NHUM;ACC;DEF;FEM;SG
حَصْرِيّ	حَصْرِيِّ	N;NHUM;GEN;MASC;SG;PSSD
خُصُوصِيّ	خُصُوصِيَّ	ADJ;ACC;MASC;SG;PSSD
يَشْم	يَشْمُ	N;NHUM;NOM;SPEC;MASC;SG
خَطّاب	خَطّابَيْ	N;HUM;ACC;SPEC;MASC;DU
أُكال	الأُكالِ	N;NHUM;GEN;DEF;MASC;SG
مُوجَز	مُوجَزَة	ADJ;SPEC;FEM;SG
شِرائِيّ	شِرائِيَّ	ADJ;ACC;SPEC;MASC;SG
قُرَشِيّ	القُرَشِيِّ	ADJ;GEN;DEF;MASC;SG
تامّ	التّامَّتَيْنِ	ADJ;GEN;DEF;FEM;DU
مُغَلَّف	المُغَلَّف	ADJ;DEF;MASC;SG;PSSD
لاحِق	لاحِق	ADJ;INDF;MASC;SG
راضِي	راضِيَةِ	ADJ;GEN;FEM;SG;PSSD
مَكْتُوم	مَكْتُومَةَ	ADJ;ACC;SPEC;FEM;SG
نَظَم	تَنْظِمْ	V;IPFV;MASC;JUS;SG;2;ACT
ٱِشْمِئْزاز	اِشْمِئْزازاتٍ	N;NHUM;ACC;INDF;MASC;PL
إِجْهاد	إِجْهادَيْ	N;NHUM;GEN;SPEC;MASC;DU
كِساء	أَكْسِيَةَ	N;NHUM;ACC;MASC;PL;PSSD
أَنْكَر	يُنْكَرَ	V;IPFV;MASC;SBJV;SG;3;PASS
قِسْم	أَقْساماً	N;NHUM;ACC;INDF;MASC;PL
جَمايْكِيّ	الجامايْكِيِّ	N;HUM;GEN;DEF;MASC;SG
مِلْعَقَة	مِلْعَقَةُ	N;NHUM;NOM;FEM;SG;PSSD
دَرّاس	الدَّرّاساتِ	ADJ;GEN;DEF;FEM;PL;PSSD
ساقَى	تُساقُونَ	V;IPFV;MASC;IND;PL;2;ACT
ٱِشْتَمّ	اِشْتَمَّ	V;PFV;MASC;IND;SG;3;ACT
مُعْتَمَد	مُعْتَمَدَةٍ	ADJ;GEN;INDF;FEM;SG
أَرْسَل	أُرْسَلَ	V;IPFV;SBJV;SG;1;PASS
بالُون	بالُوناتٍ	N;NHUM;GEN;INDF;MASC;PL
مَشُوب	مَشُوبَتانِ	ADJ;NOM;SPEC;FEM;DU
صَحِيح	الصَّحِيحَة	ADJ;DEF;FEM;SG;PSSD
مُنَظِّم	مُنَظِّماتِ	ADJ;GEN;FEM;PL;PSSD
جاوَز	تُجاوِزْ	V;IPFV;FEM;JUS;SG;3;ACT
رَوْضَة	الرَّوْضَتانِ	N;NHUM;NOM;DEF;FEM;DU
مُحْتَسِب	مُحْتَسِباتٍ	N;HUM;ACC;INDF;FEM;PL
مَحْرُوم	مَحْرُومَتَيْ	ADJ;GEN;FEM;DU;PSSD
مُبَشِّر	مُبَشِّرَيْ	N;HUM;GEN;MASC;DU;PSSD
مَأْثَرَة	المَأْثَرَةِ	N;NHUM;GEN;DEF;FEM;SG
عُثْنُون	العُثْنُونا	N;NHUM;NOM;DEF;MASC;DU
ضامِن	الضُّمَناء	ADJ;DEF;MASC;PL
ظَهْر	ظَهْرُ	N;NHUM;NOM;MASC;SG;PSSD
كُحُولِيّ	كُحُولِيَّيْنِ	ADJ;GEN;INDF;MASC;DU
دَمْعَة	دَمْعَةٍ	N;NHUM;GEN;INDF;FEM;SG
شَمالِيّ	الشَّمالِيَّ	ADJ;ACC;DEF;MASC;SG
لَوَّث	لَوَّثَت	V;PFV;FEM;IND;SG;3;ACT
نَقْدِيّ	النَّقْدِيّانِ	ADJ;NOM;DEF;MASC;DU
مُتَحَدِّث	مُتَحَدِّثاتِ	N;HUM;ACC;SPEC;FEM;PL
هَرْوَل	هَرْوَلْتُما	V;PFV;MASC;IND;DU;2;ACT
قُدْسِيّ	قُدْسِيَّةً	ADJ;ACC;INDF;FEM;SG
حَوَّل	يُحَوِّلَ	V;IPFV;MASC;SBJV;SG;3;ACT
بَطْن	بَطْنَ	N;NHUM;ACC;MASC;SG;PSSD
كِبْرِياء	كِبْرِياء	N;NHUM;INDF;MASC;SG
شِيشانِيّ	شِيشانِ	N;HUM;GEN;SPEC;MASC;PL
ضِعْف	ضِعْفِ	N;GEN;FEM;PL;PSSD
مَقْسُوم	المَقْسُومانِ	ADJ;NOM;DEF;MASC;DU
ٱِرْتَمَى	تَرْتَمَى	V;IPFV;FEM;IND;SG;3;ACT
مِتْراس	مَتارِيسَ	N;NHUM;ACC;MASC;PL;PSSD
قِتال	قِتالَ	N;NHUM;ACC;SPEC;MASC;SG
كَرا	كَرَوْتُم	V;PFV;MASC;IND;PL;2;ACT
وَجِيه	الوَجِيهاتِ	ADJ;ACC;DEF;FEM;PL
مُكَلَّف	مُكَلَّفاتُ	ADJ;NOM;FEM;PL;PSSD
إِقْدام	إِقْدامٍ	N;NHUM;GEN;INDF;MASC;SG
ثانَوِيّ	ثانَوِيَّة	ADJ;SPEC;FEM;SG
تَدَرَّج	تَتَدَرَّجا	V;IPFV;FEM;DU;3;ACT
أَكْبَر	أَكْبَر	ADJ;CMPR;INDF;MASC;SG
وَجَد	تُوجَدِينَ	V;IPFV;FEM;IND;SG;2;PASS
راكِب	راكِبَتَيْ	ADJ;GEN;FEM;DU;PSSD
مُنْصَرِم	مُنْصَرِمَتانِ	ADJ;NOM;INDF;FEM;DU
جَرِيح	جَرِيحَةِ	N;NHUM;GEN;FEM;SG;PSSD
قَعَّد	تُقَعِّدِي	V;IPFV;FEM;SG;2;ACT
إِعْجاب	إِعْجابُ	N;NHUM;NOM;SPEC;MASC;SG
خِلْقَة	خِلْقَة	N;NHUM;INDF;FEM;SG
هُولانْدِيّ	هُولانْدِيَّيْنِ	ADJ;GEN;INDF;MASC;DU
مُسْتاء	المُسْتاءاتِ	ADJ;GEN;DEF;FEM;PL
حَتَّم	تُحَتِّمانِ	V;IPFV;FEM;IND;DU;3;ACT
عَنان	العَنانُ	N;NHUM;NOM;DEF;MASC;SG
نَزْع	نَزْعٍ	N;NHUM;GEN;INDF;MASC;SG
جُنُونِيّ	جُنُونِيَّتَيْ	ADJ;ACC;SPEC;FEM;DU
تَزْوِيد	تَزْوِيدُ	N;NHUM;NOM;MASC;SG;PSSD
مَوْعُود	المَوْعُود	N;NHUM;DEF;MASC;SG
مَلاك	مَلاكاتِ	N;NHUM;GEN;SPEC;MASC;PL
تَلازُم	تَلازُماتُ	N;NHUM;NOM;SPEC;MASC;PL
أَخْرَق	أَخْرَقَ	ADJ;ACC;SPEC;MASC;SG
أَرْبَعُمِائَة	أَرْبَعَمِئَةُ	ADJ;NOM;SPEC;FEM;SG
جُزْء	الجُزْءِ	N;NHUM;GEN;DEF;MASC;SG
أَرْفَق	تُرْفِقْ	V;IPFV;MASC;JUS;SG;2;ACT
كِبْرِيتِيّ	كِبْرِيتِيِّ	ADJ;GEN;SPEC;MASC;SG
مُتَّبَع	المُتَّبَعَةَ	ADJ;ACC;DEF;FEM;SG
مُتَحَكِّم	المُتَحَكِّمَتَيْنِ	ADJ;GEN;DEF;FEM;DU
مُراهِق	مُراهِقَةُ	N;HUM;NOM;FEM;SG;PSSD
مالِح	مالِحَتانِ	ADJ;NOM;SPEC;FEM;DU
تَكَلَّم	تَتَكَلَّمِينَ	V;IPFV;FEM;IND;SG;2;ACT
تَلْفَن	تُتَلْفِنا	V;IPFV;MASC;DU;2;ACT
جَمَع	تَجْمَعُ	V;IPFV;MASC;IND;SG;2;ACT
ٱِبْتِهال	اِبْتِهالِ	N;NHUM;GEN;SPEC;MASC;SG
بَيْنِيّ	البَيْنِيِّ	ADJ;GEN;DEF;MASC;SG;PSSD
زاهِد	زاهِدُ	N;NHUM;NOM;SPEC;MASC;SG
مُظاهَرَة	المُظاهَرَتانِ	N;NHUM;NOM;DEF;FEM;DU
قادِم	قادِمَتانِ	ADJ;NOM;SPEC;FEM;DU
عالِي	العالِيَةَ	ADJ;ACC;DEF;FEM;SG;PSSD
سائِل	سائِلَةٌ	ADJ;NOM;INDF;FEM;SG
دَرَس	تَدْرُسانِ	V;IPFV;MASC;IND;DU;2;ACT
غَزّالَة	الغَزّالَة	N;NHUM;DEF;FEM;SG
تَحْمِيل	تَحْمِيلاتُ	N;NHUM;NOM;SPEC;MASC;PL
خَزِينَة	خَزِينَةُ	N;NHUM;NOM;FEM;SG;PSSD
تَأْسِيس	التَّأْسِيسَيْ	N;NHUM;ACC;DEF;MASC;DU
ٱِعْتِياد	اِعْتِياداً	N;NHUM;ACC;INDF;MASC;SG
مُقاوِم	المُقاوِمانِ	ADJ;NOM;DEF;MASC;DU
واجَه	وُوجِهْتُ	V;PFV;IND;SG;1;PASS
جِرْم	جِرْمَيْنِ	N;NHUM;ACC;INDF;MASC;DU
فَلْتان	فَلْتاناتٍ	ADJ;ACC;INDF;FEM;PL
عَقَدِيّ	العَقَدِيَّيْنِ	ADJ;GEN;DEF;MASC;DU
بِيُوغرافِيّ	بِيُوغرافِيَّةَ	ADJ;ACC;FEM;SG;PSSD
تُرَبِيّ	التُّرَبِيِّي	N;HUM;ACC;DEF;MASC;PL
نَوَوِيّ	النَّوَوِيَّ	ADJ;ACC;DEF;MASC;SG
تارِك	التّارِكَيْنِ	ADJ;ACC;DEF;MASC;DU
رِوائِيّ	رِوائِيَّةً	N;HUM;ACC;INDF;FEM;SG
مُداخَلَة	مُداخَلاتٍ	N;NHUM;ACC;INDF;FEM;PL
مِقْوَد	مَقاوِدُ	N;NHUM;NOM;SPEC;MASC;PL
جَوّال	جَوّالَيْ	ADJ;GEN;MASC;DU;PSSD
صَباحِيّ	صَباحِيَّتَيْ	ADJ;GEN;SPEC;FEM;DU
خارِجِيّ	الخارِجِيَّتانِ	ADJ;NOM;DEF;FEM;DU
وُقِّع	تُوَقَّعِينَ	V;IPFV;FEM;IND;SG;2;PASS
إِصابَة	الإِصاباتِ	N;NHUM;GEN;DEF;FEM;PL
نَكَح	أَنْكَحُ	V;IPFV;IND;SG;1;ACT
تَبَلَّل	تَتَبَلَّلْ	V;IPFV;FEM;JUS;SG;3;ACT
حُلَّة	حُلَّةَ	N;NHUM;ACC;SPEC;FEM;SG
قَدَّم	يُقَدَّمُونَ	V;IPFV;MASC;IND;PL;3;PASS
مُتَنَكِّر	مُتَنَكِّرَةٍ	N;NHUM;GEN;INDF;FEM;SG
أَدان	نُدَنْ	V;IPFV;JUS;PL;1;PASS
دَبّابَة	دَبّاباتٍ	N;NHUM;ACC;INDF;FEM;PL
كاحِل	كَواحِلُ	N;NHUM;NOM;MASC;PL;PSSD
قَيَّد	أُقَيِّدْ	V;IPFV;JUS;SG;1;ACT
تَثْقِيف	تَثْقِيفُ	N;NHUM;NOM;MASC;SG;PSSD
مُسْتَنِد	مُسْتَنِدَتَيْنِ	ADJ;ACC;INDF;FEM;DU
حُجْرَة	حُجْرَةُ	N;NHUM;NOM;FEM;SG;PSSD
تَلَمُّس	تَلَمُّساتُ	N;NHUM;NOM;SPEC;MASC;PL
ٱِسْتَقال	تَسْتَقِيلا	V;IPFV;FEM;DU;3;ACT
قُبَّة	قُبَّتَيْ	N;NHUM;ACC;SPEC;FEM;DU
عَسْكَرِيّ	عَسْكَرِيَّيْ	N;HUM;GEN;MASC;DU;PSSD
غَرّ	غَرَرْنا	V;PFV;IND;PL;1;ACT
أَنْبَأ	أَنْبَأْتِ	V;PFV;FEM;IND;SG;2;ACT
خارِق	خارِقِينَ	ADJ;GEN;INDF;MASC;PL
إِطْلالَة	إِطْلالَةٍ	N;NHUM;GEN;INDF;FEM;SG
شَغَر	تَشْغُرَ	V;IPFV;FEM;SBJV;SG;3;ACT
وَكِيل	وَكِيلَتَيْ	N;HUM;ACC;FEM;DU;PSSD
قَلَب	تَقْلِبِي	V;IPFV;FEM;SG;2;ACT
ٱِنْزَرَع	نَنْزَرِعَ	V;IPFV;SBJV;PL;1;ACT
مُشاوَر	المُشاوَراتِ	N;NHUM;GEN;DEF;FEM;PL
تَخْرِيبِيّ	التَّخْرِيبِيَّةَ	ADJ;ACC;DEF;FEM;SG
تَقاتُل	التَّقاتُلاتِ	N;NHUM;ACC;DEF;MASC;PL
مَنْسِيّ	المَنْسِيَّةَ	ADJ;ACC;DEF;FEM;SG
إِلٰه	إِلاهات	N;HUM;SPEC;FEM;PL
ٱِبْتِهال	اِبْتِهالات	N;NHUM;MASC;PL;PSSD
مَوْهُوب	مَوْهُوبِ	N;NHUM;GEN;SPEC;MASC;SG
تَكْرِير	تَكْرِيرٍ	N;NHUM;GEN;INDF;MASC;SG
مَفْقُود	المَفْقُودَةَ	ADJ;ACC;DEF;FEM;SG;PSSD
مُغْرِض	مُغْرِضاتٍ	ADJ;ACC;INDF;FEM;PL
لِحْيَة	اللُّحَى	N;NHUM;DEF;FEM;PL
فَرِيسِيّ	فَرِيسِيَّةُ	N;HUM;NOM;SPEC;FEM;SG
رَشِيد	الرَّشِيدَيْنِ	ADJ;ACC;DEF;MASC;DU
بُورْنُوغرافِيّ	بُورْنُوغرافِيَّتَيْ	ADJ;GEN;SPEC;FEM;DU
ساحِر	ساحِرَةِ	ADJ;GEN;FEM;SG;PSSD
حَسّاس	حَسّاسُ	ADJ;NOM;SPEC;MASC;SG
مُطالَبَة	مُطالَباتِ	N;NHUM;ACC;FEM;PL;PSSD
تَناوَل	نَتَناوَلْ	V;IPFV;JUS;PL;1;ACT
ٱِتِّجار	الاِتِّجارِ	N;NHUM;GEN;DEF;MASC;SG
ٱِحْتِجاجِيّ	اِحْتِجاجِيَّةٍ	ADJ;GEN;INDF;FEM;SG
تَواجَه	نَتَواجَهَ	V;IPFV;SBJV;PL;1;ACT
سُؤال	السُّؤالا	N;NHUM;NOM;DEF;MASC;DU
إِقْدام	إِقْدامات	N;NHUM;INDF;MASC;PL
ساعِد	سَواعِدِ	N;NHUM;GEN;SPEC;MASC;PL
عَجِيبَة	العَجِيبَتَيْ	N;NHUM;GEN;DEF;FEM;DU
تَطَوُّعِيّ	التَّطَوُّعِيِّينَ	ADJ;ACC;DEF;MASC;PL
قَوْلَة	القَوْلَةِ	N;NHUM;GEN;DEF;FEM;SG
واعِي	واعِيَةٌ	ADJ;NOM;INDF;FEM;SG
ٱِسْتِيقاظ	اِسْتِيقاظَيْنِ	N;NHUM;ACC;INDF;MASC;DU
ناوَى	نُناوَى	V;IPFV;SBJV;PL;1;PASS
إِرْهابِيّ	الإِرْهابِيَّيْنِ	ADJ;GEN;DEF;MASC;DU
مُتَصَدِّر	المُتَصَدِّرات	ADJ;DEF;FEM;PL;PSSD
مُؤَهَّل	مُؤَهَّلا	ADJ;NOM;MASC;DU;PSSD
ٱِسْتَتاب	اِسْتَتابَتا	V;PFV;FEM;IND;DU;3;ACT
مُضْرِب	المُضْرِبِي	N;HUM;ACC;DEF;MASC;PL
ٱِسْتِخْبارِيّ	اِسْتِخْبارِيَّةٍ	ADJ;GEN;INDF;FEM;SG
تَنافُسِيّ	التَّنافُسِيَّتانِ	ADJ;NOM;DEF;FEM;DU
أَطاق	أُطِقْ	V;IPFV;JUS;SG;1;ACT
مُبْتَكَر	مُبْتَكَرَتانِ	ADJ;NOM;INDF;FEM;DU
ٱِسْتَغَلّ	اِسْتَغْلَلْتِ	V;PFV;FEM;IND;SG;2;ACT
مُنْقِذ	مُنْقِذَيْ	N;HUM;GEN;MASC;DU;PSSD
باحِث	باحِثَةِ	N;HUM;GEN;SPEC;FEM;SG
نَباتِيّ	نَباتِيَّ	ADJ;ACC;SPEC;MASC;SG
مُحَصِّل	مُحَصِّلانِ	N;HUM;NOM;INDF;MASC;DU
غِذائِيّ	الغِذائِيَّ	ADJ;ACC;DEF;MASC;SG
مُتَأَلِّق	مُتَأَلِّقَتَيْ	N;HUM;ACC;FEM;DU;PSSD
مُتَواجِد	مُتَواجِدَ	N;HUM;ACC;MASC;SG;PSSD
ٱِحْتَذَى	أَحْتَذِي	V;IPFV;IND;SG;1;ACT
أَغْلَق	أُغْلِقَ	V;IPFV;SBJV;SG;1;ACT
مُتَفاهِم	مُتَفاهِمَة	ADJ;SPEC;FEM;SG
مُتَصادِم	مُتَصادِما	ADJ;NOM;MASC;DU;PSSD
وَفْدِيّ	وَفْدِيَّتا	ADJ;NOM;FEM;DU;PSSD
نَيِّر	نَيِّرَ	ADJ;ACC;SPEC;MASC;SG
رَدِيف	رَدِيفَ	N;NHUM;ACC;MASC;SG;PSSD
رَسّام	رَسّامَةَ	N;HUM;ACC;SPEC;FEM;SG
مَوْلُود	المَوْلُودَة	N;HUM;DEF;FEM;SG
أَثْنَى	يُثْنَيْنَ	V;IPFV;FEM;PL;3;PASS
نَزْفِيّ	النَّزْفِيَّيْ	ADJ;ACC;DEF;MASC;DU;PSSD
رائِد	رائِدَ	ADJ;ACC;SPEC;MASC;SG
تَكْتِيكِيّ	تَكْتِيكِيَّةُ	ADJ;NOM;FEM;SG;PSSD
طارِئَة	طارِئَتانِ	N;NHUM;NOM;INDF;FEM;DU
مَرْجُوّ	المَرْجُوِّ	ADJ;GEN;DEF;MASC;SG
تَفَضَّل	يَتَفَضَّلَ	V;IPFV;MASC;SBJV;SG;3;ACT
قاعِد	قاعِداتِ	N;NHUM;GEN;FEM;PL;PSSD
مُرَكَّز	مُرَكَّزَةٌ	ADJ;NOM;INDF;FEM;SG
جَحْفَل	جَحافِلَ	N;NHUM;ACC;INDF;MASC;PL
أَعْدَى	تُعْدَيا	V;IPFV;FEM;DU;3;PASS
ٱِنْتِكاس	اِنْتِكاسُ	N;NHUM;NOM;MASC;SG;PSSD
مَرْكَزِيّ	المَرْكَزِيّا	ADJ;NOM;DEF;MASC;DU;PSSD
تَآلَف	يَتَآلَفانِ	V;IPFV;MASC;IND;DU;3;ACT
مُصافَحَة	مُصافَحَةَ	N;NHUM;ACC;FEM;SG;PSSD
مَصْحُوب	مَصْحُوباً	ADJ;ACC;INDF;MASC;SG
قاطَع	قاطَعا	V;PFV;MASC;IND;DU;3;ACT
فاضِح	الفاضِحاتِ	ADJ;GEN;DEF;FEM;PL
سائِل	السّائِلاتُ	ADJ;NOM;DEF;FEM;PL
إِطْفائِيّ	الإِطْفائِيّاتِ	ADJ;ACC;DEF;FEM;PL
ساء	سُؤْتُم	V;PFV;MASC;IND;PL;2;ACT
باحِث	باحِثَيْ	N;HUM;ACC;SPEC;MASC;DU
أَذْكَى	أَذْكا	N;NHUM;INDF;MASC;SG
أُسْبُوعِيّ	أُسْبُوعِيٌّ	ADJ;NOM;INDF;MASC;SG
ٱِنْكَشَف	يَنْكَشِفُوا	V;IPFV;MASC;PL;3;ACT
ٱِنْغِماس	اِنْغِماساتٍ	N;NHUM;GEN;INDF;MASC;PL
تَلاشَى	تَتَلاشَوْنَ	V;IPFV;MASC;IND;PL;2;ACT
نَوَّه	نَوَّهْتُ	V;PFV;IND;SG;1;ACT
مَشْهُود	المَشْهُودَتَيْنِ	ADJ;GEN;DEF;FEM;DU
بَئِيس	البَئِيسِي	N;NHUM;ACC;DEF;MASC;PL
بَغِيض	بَغِيضاتٍ	ADJ;GEN;INDF;FEM;PL
مُشَدِّد	المُشَدِّدَتانِ	ADJ;NOM;DEF;FEM;DU
دائِب	الدّائِبِي	ADJ;ACC;DEF;MASC;PL;PSSD
عَشِق	عَشِقْتُ	V;PFV;IND;SG;1;ACT
ٱِسْتِيعابِيّ	اِسْتِيعابِيَّيْ	ADJ;GEN;MASC;DU;PSSD
مُتَوَقِّع	مُتَوَقِّعِينَ	ADJ;ACC;INDF;MASC;PL
مَوْكِب	المَوْكِبَيْ	N;NHUM;ACC;DEF;MASC;DU
ٱِكْتَنَف	تَكْتَنِفانِ	V;IPFV;FEM;IND;DU;3;ACT
مُسَيَّس	مُسَيَّساتٍ	ADJ;GEN;INDF;FEM;PL
مُعادِل	المُعادِلَيْ	ADJ;ACC;DEF;MASC;DU;PSSD
تَمْهِيد	تَمْهِيداتٍ	N;NHUM;ACC;INDF;MASC;PL
تَسَرُّب	تَسَرُّباتٍ	N;NHUM;GEN;INDF;MASC;PL
صَحْوَة	صَحْوَةِ	N;NHUM;GEN;SPEC;FEM;SG
كُولُونِيل	كُولُونِيلا	N;HUM;NOM;SPEC;MASC;DU
دائِمِيّ	دائِمِيّاتٌ	ADJ;NOM;INDF;FEM;PL
تَأْمِينِيّ	تَأْمِينِيَّةُ	ADJ;NOM;FEM;SG;PSSD
مُنْهَمِك	المُنْهَمِكَيْ	ADJ;GEN;DEF;MASC;DU;PSSD
مُتَفاعِل	المُتَفاعِل	ADJ;DEF;MASC;SG
رِيف	الأَرْيافَ	N;NHUM;ACC;DEF;MASC;PL
كامِرا	كامِرات	N;NHUM;INDF;FEM;PL
مُفْسِد	مُفْسِدَةِ	N;NHUM;GEN;FEM;SG;PSSD
فَشَل	فَشَلُ	N;NHUM;NOM;MASC;SG;PSSD
مُتَساوِي	المُتَساوِيَيْ	ADJ;GEN;DEF;MASC;DU;PSSD
أَتَمّ	أَتْمَمْتُنَّ	V;PFV;FEM;IND;PL;2;ACT
مَتاع	أَمْتِعَةَ	N;NHUM;ACC;MASC;PL;PSSD
جَرِب	تَجْرَبَ	V;IPFV;FEM;SBJV;SG;3;ACT
مَزْهُوّ	المَزْهُوّ	ADJ;DEF;MASC;SG;PSSD
تَحَدَّى	تَتَحَدَّى	V;IPFV;MASC;SBJV;SG;2;ACT
ٱِرْتَكَب	تُرْتَكَبِي	V;IPFV;FEM;SG;2;PASS
أُرْثُودُكسِيّ	أُرْثُودُكسِيَّةِ	N;HUM;GEN;FEM;SG;PSSD
تَخَفِّي	تَخَفِّياتِ	N;NHUM;GEN;MASC;PL;PSSD
أَقْرَب	أَقْرَبِينَ	ADJ;GEN;INDF;MASC;PL
ٱِصْطَفّ	اِصْطَفُّوا	V;PFV;MASC;IND;PL;3;ACT
حَكَى	نَحْكِ	V;IPFV;JUS;PL;1;ACT
خَيّاط	خَيّاطٍ	N;HUM;GEN;INDF;MASC;SG
مُسْتَعْمَل	مُسْتَعْمَلٍ	ADJ;GEN;INDF;MASC;SG
تَثْقِيفِيّ	تَثْقِيفِيِّينَ	ADJ;ACC;INDF;MASC;PL
إِطالَة	إِطالَةَ	N;NHUM;ACC;SPEC;FEM;SG
مُشَغَّل	مُشَغَّلانِ	ADJ;NOM;INDF;MASC;DU
مُحْتَفِل	مُحْتَفِلاتُ	N;HUM;NOM;SPEC;FEM;PL
مُمَثَّل	المُمَثَّلَتا	ADJ;NOM;DEF;FEM;DU;PSSD
فِدائِيّ	الفِدائِيَّتَيْ	ADJ;GEN;DEF;FEM;DU;PSSD
صَمَم	صَمَمٍ	N;NHUM;GEN;INDF;MASC;SG
فَجَع	فَجَعُوا	V;PFV;MASC;IND;PL;3;ACT
باتّ	باتّا	ADJ;NOM;SPEC;MASC;DU
وَسْوَس	يُوَسْوِسُوا	V;IPFV;MASC;PL;3;ACT
عَجَّل	تُعَجِّلْنَ	V;IPFV;FEM;PL;2;ACT
هَدَم	هَدَمْتَ	V;PFV;MASC;IND;SG;2;ACT
تَمَلَّى	يَتَمَلَّى	V;IPFV;MASC;IND;SG;3;ACT
مَلِيح	المَلِيحَتا	ADJ;NOM;DEF;FEM;DU;PSSD
مُوافِق	مُوافِقَتَيْنِ	ADJ;GEN;INDF;FEM;DU
أَنْبَت	نُنْبَتُ	V;IPFV;IND;PL;1;PASS
ٱِسْتِظْهار	اِسْتِظْهاراً	N;NHUM;ACC;INDF;MASC;SG
أُورُوِيّ	الأُورُوِيُّ	ADJ;NOM;DEF;MASC;SG
ٱِخْتَمَر	اِخْتَمَرُوا	V;PFV;MASC;IND;PL;3;ACT
تَنْشِيء	تَنْشِيئات	N;NHUM;SPEC;MASC;PL
صَدَّع	تُصَدِّعُ	V;IPFV;MASC;IND;SG;2;ACT
مُعْتَدِل	مُعْتَدِلاتِ	ADJ;GEN;FEM;PL;PSSD
نَقْض	نَقْضَ	N;NHUM;ACC;MASC;SG;PSSD
مُقْتَضَى	المُقْتَضَيا	N;NHUM;NOM;DEF;MASC;DU
ثَمَّن	تُثَمِّنِينَ	V;IPFV;FEM;IND;SG;2;ACT
حَماسِيّ	حَماسِيّاً	ADJ;ACC;INDF;MASC;SG
كَوْمَة	كُومَةُ	N;NHUM;NOM;SPEC;FEM;SG
وَفَّق	يُوَفِّقُ	V;IPFV;MASC;IND;SG;3;ACT
وَصِيفَة	وَصِيفَةُ	N;HUM;NOM;SPEC;FEM;SG
إِسْتراتِيجِيّ	إِسْتراتِيجِيِّي	N;NHUM;GEN;MASC;PL;PSSD
تَحَرُّرِيّ	تَحَرُّرِيَّتَيْ	ADJ;ACC;FEM;DU;PSSD
فَهِم	يُفْهَمانِ	V;IPFV;MASC;IND;DU;3;PASS
مُغْرِي	المُغْرِيَيْ	ADJ;ACC;DEF;MASC;DU;PSSD
إِشْكال	إِشْكالاتِ	N;NHUM;GEN;SPEC;MASC;PL
قَرِيَّة	القَرِيَّة	N;NHUM;DEF;FEM;SG
زِنْزانَة	زِنْزانات	N;NHUM;SPEC;FEM;PL
دَأَب	أَدْأَبْ	V;IPFV;JUS;SG;1;ACT
تَصْوِير	تَصْوِيرات	N;NHUM;SPEC;MASC;PL
زَيَّد	نُزَيِّدَ	V;IPFV;SBJV;PL;1;ACT
ٱِسْتَنْزَف	تَسْتَنْزِفانِ	V;IPFV;FEM;IND;DU;3;ACT
ٱِنْسَجَم	تَنْسَجِمَ	V;IPFV;FEM;SBJV;SG;3;ACT
مُتَرَبِّع	المُتَرَبِّعاتِ	ADJ;ACC;DEF;FEM;PL
مِيزان	مَوازِينِ	N;NHUM;GEN;SPEC;MASC;PL
كافِي	كافِيَة	ADJ;SPEC;FEM;SG
غاز	غازَيْ	N;NHUM;GEN;SPEC;MASC;DU
ٱِخْتِمار	الاِخْتِمارِ	N;NHUM;GEN;DEF;MASC;SG
