مُجَمَّع	مُجَمَّعَة	ADJ;INDF;FEM;SG
مُتَّكِل	المُتَّكِلاتُ	ADJ;NOM;DEF;FEM;PL
مَنْشُور	مَنْشُورَ	N;NHUM;ACC;MASC;SG;PSSD
مُسْتَعْمَل	مُسْتَعْمَل	ADJ;INDF;MASC;SG
مُؤَرَّخ	مُؤَرَّخَتَيْنِ	ADJ;ACC;INDF;FEM;DU
مُتَطَلِّب	المُتَطَلِّبَتَيْ	N;NHUM;GEN;DEF;FEM;DU
بِيزَنْطِيّ	بِيزَنْطِيَّتَيْ	ADJ;GEN;SPEC;FEM;DU
بَرازِيلِيّ	البَرازِيلِيُّ	ADJ;NOM;DEF;MASC;SG
ٱِشْتَرَى	اِشْتَرَيْنَ	V;PFV;FEM;IND;PL;3;ACT
أَفْدَح	أَفْدَح	ADJ;CMPR;INDF;FEM;PL
تَلاحَق	تَتَلاحَقْ	V;IPFV;MASC;JUS;SG;2;ACT
مُعاكِس	المُعاكِس	ADJ;DEF;MASC;SG;PSSD
مَعْزُوفَة	مَعْزُوفَتَيْ	N;NHUM;GEN;SPEC;FEM;DU
مُدافِع	المُدافِعَتَيْنِ	ADJ;ACC;DEF;FEM;DU
أَمَل	آمالٌ	N;NHUM;NOM;INDF;MASC;PL
مُحاوِر	المُحاوِرَةَ	ADJ;ACC;DEF;FEM;SG;PSSD
دِينامِيكِيّ	دِينامِيكِيَّةَ	ADJ;ACC;SPEC;FEM;SG
سَطْحِيّ	السَّطْحِيَّتَيْ	ADJ;ACC;DEF;FEM;DU;PSSD
مُدَرِّس	مُدَرِّسَيْ	N;HUM;ACC;MASC;DU;PSSD
ٱِنْحَرَف	يَنْحَرِفُ	V;IPFV;MASC;IND;SG;3;ACT
بَيَّت	يُبَيِّتَ	V;IPFV;MASC;SBJV;SG;3;ACT
مَنْحُوتَة	مَنْحُوتَةَ	N;NHUM;ACC;SPEC;FEM;SG
خَرَق	يَخْرُقَ	V;IPFV;MASC;SBJV;SG;3;ACT
مَعِيشِيّ	مَعِيشِيَّيْ	ADJ;GEN;SPEC;MASC;DU
ناضِج	النّاضِج	ADJ;DEF;MASC;SG
سَيّاح	سَيّاحِينَ	N;HUM;GEN;INDF;MASC;PL
خَطِر	الخَطِرا	ADJ;NOM;DEF;MASC;DU;PSSD
إِباحِيّ	إِباحِيّانِ	ADJ;NOM;INDF;MASC;DU
لُوجِسْتِيّ	اللُّوجِسْتِيُّو	ADJ;NOM;DEF;MASC;PL;PSSD
أَلْمَح	أَلْمَحا	V;PFV;MASC;IND;DU;3;ACT
مَخْزُون	مَخْزُونُ	N;NHUM;NOM;SPEC;MASC;SG
سَرَق	يَسْرِقا	V;IPFV;MASC;DU;3;ACT
مُشْتَقّ	مُشْتَقّات	ADJ;SPEC;FEM;PL
وَرِيد	أَوْرِدَة	N;NHUM;SPEC;FEM;PL
مُثَلَّج	مُثَلَّجَيْ	N;NHUM;GEN;MASC;DU;PSSD
خَدّام	خَدّامَةً	N;HUM;ACC;INDF;FEM;SG
مُنَوِّه	مُنَوِّهَ	ADJ;ACC;SPEC;MASC;SG
صَيْحَة	صَيْحَتانِ	N;NHUM;NOM;INDF;FEM;DU
أُورُومُتَوَسِّطِيّ	أُورُومُتَوَسِّطِيِّينَ	ADJ;GEN;INDF;MASC;PL
لَيْل	لَيْلاً	N;NHUM;ACC;INDF;MASC;SG
مُعامَلَة	مُعامَلَتَيْ	N;NHUM;GEN;FEM;DU;PSSD
ٱِنْهال	تَنْهالا	V;IPFV;FEM;DU;3;ACT
شَبَه	الشَّبَهَ	N;NHUM;ACC;DEF;MASC;SG
أَشْرَك	أَشْرَكُوا	V;PFV;MASC;IND;PL;3;ACT
أَحْوَج	يُحْوَجُوا	V;IPFV;MASC;PL;3;PASS
وَسَط	وَسَطِ	ADJ;GEN;SPEC;MASC;SG
تَزْكِيَة	تَزْكِيَةَ	N;NHUM;ACC;FEM;SG;PSSD
ساخِر	السّاخِرَتانِ	ADJ;NOM;DEF;FEM;DU
عادِيّ	العادِيّ	ADJ;DEF;MASC;SG
سَرِير	سَرِيرَيْ	N;NHUM;ACC;MASC;DU;PSSD
مُعْلِن	المُعْلِنِي	N;HUM;GEN;DEF;MASC;PL
تَبَدَّى	تَتَبَدَّى	V;IPFV;MASC;IND;SG;2;ACT
عَلامَة	العَلاماتِ	N;NHUM;GEN;DEF;FEM;PL
زائِد	زائِدَةً	N;NHUM;ACC;INDF;FEM;SG
لِيرَة	اللِّيرَةُ	N;NHUM;NOM;DEF;FEM;SG
مُمارِس	مُمارِسٍ	N;HUM;GEN;INDF;MASC;SG
ناعُورَة	ناعُورَة	N;NHUM;INDF;FEM;SG
جَمِيع	جَمِيعُ	N;NOM;SPEC;MASC;SG
مَثّال	مَثّالَةً	N;NHUM;ACC;INDF;FEM;SG
مُنْزَلِق	مُنْزَلِقَتَيْ	ADJ;GEN;SPEC;FEM;DU
أَمْضَى	تُمْضَى	V;IPFV;FEM;SBJV;SG;3;PASS
أَضْمَر	نُضْمَرُ	V;IPFV;IND;PL;1;PASS
أَثاب	أَثَبْنَ	V;PFV;FEM;IND;PL;3;ACT
قَيْصَر	القَيْصَرِ	N;HUM;GEN;DEF;MASC;SG
مُسَيْطِر	المُسَيْطِرُ	ADJ;NOM;DEF;MASC;SG
مُساكِن	مُساكِنات	N;HUM;FEM;PL;PSSD
حَشَد	أَحْشُدَ	V;IPFV;SBJV;SG;1;ACT
ٱِسْتِعْراضِيّ	اِسْتِعْراضِيّاتِ	ADJ;ACC;SPEC;FEM;PL
مُمَيَّز	المُمَيَّزَةَ	ADJ;ACC;DEF;FEM;SG
أَحْرَج	تُحْرَجْ	V;IPFV;MASC;JUS;SG;2;PASS
ٱِلْتِقاط	اِلْتِقاطاتُ	N;NHUM;NOM;SPEC;MASC;PL
سادِس	سادِسَةُ	ADJ;NOM;SPEC;FEM;SG
خاطِئ	خُطاةِ	ADJ;GEN;MASC;PL;PSSD
مُطْرانِيَّة	مُطْرانِيّاتٌ	N;NHUM;NOM;INDF;FEM;PL
حَوَّل	حَوَّلْنَ	V;PFV;FEM;IND;PL;3;ACT
ٱِنْشَغَل	نَنْشَغِلَ	V;IPFV;SBJV;PL;1;ACT
تَوَسَّل	تَوَسَّلْتِ	V;PFV;FEM;IND;SG;2;ACT
نَزْلَة	نَزَلاتِ	N;NHUM;ACC;FEM;PL;PSSD
وَسْطِيَّة	وَسْطِيّاتٍ	N;NHUM;GEN;INDF;FEM;PL
رَشّاشَة	رَشّاشَةٍ	ADJ;GEN;INDF;FEM;SG
مُحَرِّض	مُحَرِّضِي	ADJ;ACC;MASC;PL;PSSD
صَيْفِيّ	الصَّيْفِيَّتانِ	ADJ;NOM;DEF;FEM;DU
مُحَدَّد	مُحَدَّدات	ADJ;FEM;PL;PSSD
بِلْيُون	البَلايِينَ	N;NHUM;ACC;DEF;MASC;PL
أَلِفْباء	أَلِفْباءُ	N;NHUM;NOM;MASC;SG;PSSD
تَوْصِيف	تَوْصِيفات	N;NHUM;INDF;MASC;PL
مُضْطَهَد	المُضْطَهَدِينَ	ADJ;GEN;DEF;MASC;PL
وَتِين	وُتُنُ	N;NHUM;NOM;SPEC;MASC;PL
جائِزَة	الجائِزَتَيْ	N;NHUM;ACC;DEF;FEM;DU
أَقَلِّيَّة	أَقَلِّيَّتَيْ	N;NHUM;ACC;SPEC;FEM;DU
أَفْشَل	أَفْشَلُوا	V;PFV;MASC;IND;PL;3;ACT
رادِيكالِيّ	رادِكالِيّانِ	N;HUM;NOM;INDF;MASC;DU
مُسْتَبِدّ	مُسْتَبِدّاتٌ	ADJ;NOM;INDF;FEM;PL
صَلِيبِيّ	صَلِيبِيَّتا	ADJ;NOM;FEM;DU;PSSD
أُسْقُفِيّ	الأُسْقُفِيَّ	ADJ;ACC;DEF;MASC;SG
قَطَرِيّ	قَطَرِيَّتَيْ	N;HUM;GEN;SPEC;FEM;DU
ضَباب	ضَبابُ	N;NHUM;NOM;SPEC;MASC;SG
تَحَرُّرِيّ	تَحَرُّرِيّاتٍ	ADJ;GEN;INDF;FEM;PL
مَسْكَن	مَسْكَنانِ	N;NHUM;NOM;INDF;MASC;DU
إِدارَة	إِدارات	N;NHUM;INDF;FEM;PL
حَمِيد	حَمِيدَيْ	ADJ;GEN;SPEC;MASC;DU
مَغْسَل	مَغْسَل	N;NHUM;INDF;MASC;SG
جَسَّد	جَسَّدا	V;PFV;MASC;IND;DU;3;ACT
مُلَبِّي	مُلَبِّياتٍ	N;NHUM;ACC;INDF;FEM;PL
دَنْدَن	دَنْدَنّا	V;PFV;IND;PL;1;ACT
شارَف	شارَفْتُما	V;PFV;MASC;IND;DU;2;ACT
أَصَرّ	يُصَرُّ	V;IPFV;MASC;IND;SG;3;PASS
لِيبِيّ	لِيبِيَّتَيْنِ	N;HUM;ACC;INDF;FEM;DU
كُوسْتارِيكِيّ	الكُوسْتارِيكِيَّةَ	ADJ;ACC;DEF;FEM;SG;PSSD
وَكَّل	تُوَكِّلُ	V;IPFV;FEM;IND;SG;3;ACT
مُرْتَهِن	مُرْتَهِنا	N;HUM;NOM;SPEC;MASC;DU
راحِل	راحِلَة	N;NHUM;FEM;SG;PSSD
مَرام	مَراما	N;NHUM;NOM;SPEC;MASC;DU
مُراسَلَة	مُراسَلَتَيْنِ	N;NHUM;GEN;INDF;FEM;DU
نَبَوِيّ	النَّبَوِيَّةَ	ADJ;ACC;DEF;FEM;SG;PSSD
ٱِشْتِراكِيّ	اِشْتِراكِيّات	ADJ;SPEC;FEM;PL
مَرْمِيّ	المَرْمِيّات	ADJ;DEF;FEM;PL;PSSD
شاع	أَشِيعُ	V;IPFV;IND;SG;1;ACT
أَذْكَر	أُذْكِرُ	V;IPFV;IND;SG;1;ACT
مُعَوِّق	مُعَوِّقاتٌ	N;NHUM;NOM;INDF;MASC;PL
سَمّ	سَمُّوا	V;PFV;MASC;IND;PL;3;ACT
لامُبالِيّ	لامُبالِيّاتٍ	ADJ;ACC;INDF;FEM;PL
مُوغِل	مُوغِلُ	ADJ;NOM;MASC;SG;PSSD
مُجاوِر	المُجاوِرَيْنِ	ADJ;ACC;DEF;MASC;DU
فارِسِيّ	فارِسِيَّتَيْنِ	N;HUM;GEN;INDF;FEM;DU
سَنّ	السَّنِّ	N;NHUM;GEN;DEF;MASC;SG
مُجْمَل	المُجْمَلِ	ADJ;GEN;DEF;MASC;SG
كَئِيب	الكَئِيب	ADJ;DEF;MASC;SG;PSSD
مُكَثَّف	مُكَثَّفَتَيْ	ADJ;ACC;SPEC;FEM;DU
عاد	تَعُودُ	V;IPFV;FEM;IND;SG;3;ACT
تشِيكِيّ	تشِيكِيَّتا	N;HUM;NOM;FEM;DU;PSSD
ٱِنْتِخابِيّ	اِنْتِخابِيِّ	ADJ;GEN;MASC;SG;PSSD
بالِسْتِيّ	البالِسْتِيَّتانِ	ADJ;NOM;DEF;FEM;DU
كِفاء	كِفاءً	N;NHUM;ACC;INDF;MASC;SG
أَمِير	أُمَراءُ	N;HUM;NOM;SPEC;MASC;PL
بَيْرُوتِيّ	بَيْرُوتِيّانِ	ADJ;NOM;INDF;MASC;DU
باكِستانِيّ	الباكِستانِيّا	ADJ;NOM;DEF;MASC;DU;PSSD
مُهاجِر	مُهاجِراتِ	ADJ;ACC;FEM;PL;PSSD
رَفِيع	الرَّفِيعَ	ADJ;ACC;DEF;MASC;SG
ضاغِط	ضاغِطَ	ADJ;ACC;SPEC;MASC;SG
قانِئ	قانِئَةِ	ADJ;GEN;FEM;SG;PSSD
مَحْرُوق	مَحْرُوقُو	ADJ;NOM;SPEC;MASC;PL
مَنْظُور	مَنْظُورَيْنِ	N;NHUM;ACC;INDF;MASC;DU
أَنَّة	أَنّاتٌ	N;NHUM;NOM;INDF;FEM;PL
قَدَّر	تُقَدِّرْنَ	V;IPFV;FEM;PL;2;ACT
سَمْح	السَّمْحَةَ	ADJ;ACC;DEF;FEM;SG
طَعْن	طَعْن	N;NHUM;INDF;MASC;SG
هِسْتِيرِيّ	هِسْتِيرِيِّي	ADJ;GEN;MASC;PL;PSSD
ٱِنْتِقائِيّ	الاِنْتِقائِيَّتا	ADJ;NOM;DEF;FEM;DU;PSSD
مُعْتَدِل	المُعْتَدِلِ	ADJ;GEN;DEF;MASC;SG;PSSD
مُزْمِن	المُزْمِناتُ	ADJ;NOM;DEF;FEM;PL;PSSD
طابِق	طابِقا	N;NHUM;NOM;MASC;DU;PSSD
مُلْحَق	مُلْحَقا	ADJ;NOM;SPEC;MASC;DU
تَجْرِيبِيّ	تَجْرِيبِيّاتِ	ADJ;ACC;FEM;PL;PSSD
خَفِيض	خَفِيضَتَيْ	N;NHUM;GEN;SPEC;FEM;DU
مُقَدَّس	مُقَدَّس	ADJ;INDF;MASC;SG
تَجَلَّى	تَجَلَّيْتَ	V;PFV;MASC;IND;SG;2;ACT
سُورِيّ	السُّورِيّات	ADJ;DEF;FEM;PL;PSSD
تَحْطِيم	تَحْطِيمات	N;NHUM;INDF;MASC;PL
مُشَيِّن	مُشَيِّنِ	ADJ;GEN;MASC;SG;PSSD
نِطاق	نِطاقٍ	N;NHUM;GEN;INDF;MASC;SG
مُخْتَبِئ	مُخْتَبِئَةَ	N;NHUM;ACC;FEM;SG;PSSD
مُخالِف	المُخالِفَةَ	ADJ;ACC;DEF;FEM;SG;PSSD
تَوْصِيَة	تَوْصِيَتَيْنِ	N;NHUM;GEN;INDF;FEM;DU
حِمائِيّ	الحِمائِيِّ	ADJ;GEN;DEF;MASC;SG
مُحاضِر	مُحاضِراتِ	N;HUM;GEN;FEM;PL;PSSD
عَبْوَة	عَبَواتٍ	N;NHUM;ACC;INDF;FEM;PL
طَرِيق	الطَّرِيقَيْ	N;NHUM;ACC;DEF;FEM;DU
ناجِم	النّاجِمَة	ADJ;DEF;FEM;SG;PSSD
قِرْش	قُرُوشَ	N;NHUM;ACC;SPEC;MASC;PL
لَوْح	لَوْحَيْ	N;NHUM;GEN;MASC;DU;PSSD
مَصْرَفِيّ	مَصْرَفِيّاتٌ	N;HUM;NOM;INDF;FEM;PL
مُوجَز	المُوجَزَتانِ	ADJ;NOM;DEF;FEM;DU
مَجْمَع	المَجْمَعَيْ	N;NHUM;GEN;DEF;MASC;DU
كائِن	كائِناتٍ	N;NHUM;GEN;INDF;MASC;PL
لانِهائِيّ	لانِهائِيّاتِ	ADJ;GEN;FEM;PL;PSSD
إِجْمالِيّ	إِجْمالِيٍّ	N;NHUM;GEN;INDF;MASC;SG
تَفَرَّغ	تَفَرَّغْنَ	V;PFV;FEM;IND;PL;3;ACT
قاطِع	قاطِعَةِ	ADJ;GEN;SPEC;FEM;SG
مُتَضَرِّر	مُتَضَرِّرَةِ	ADJ;GEN;FEM;SG;PSSD
فَتِي	يَفْتَ	V;IPFV;MASC;JUS;SG;3;ACT
مُزْمَع	مُزْمَعا	ADJ;NOM;MASC;DU;PSSD
مُتَغَيِّب	مُتَغَيِّباتِ	N;HUM;ACC;SPEC;FEM;PL
مَطْرُوح	المَطْرُوحُو	N;NHUM;NOM;DEF;MASC;PL
جُرْثُوم	جُرْثُومَتَيْ	N;NHUM;ACC;FEM;DU;PSSD
هَدَأ	تَهْدَأُوا	V;IPFV;MASC;PL;2;ACT
وُدِّيّ	الوُدِّيّات	ADJ;DEF;FEM;PL;PSSD
ٱِغْتِناء	الاِغْتِناءَيْ	N;NHUM;ACC;DEF;MASC;DU
مُوالِي	مُوالِيَةُ	ADJ;NOM;SPEC;FEM;SG
تَهَجُّم	تَهَجُّمَيْ	N;NHUM;GEN;SPEC;MASC;DU
جَمَّع	جُمِّعْتِ	V;PFV;FEM;IND;SG;2;PASS
قَيْظ	قَيْظاً	N;NHUM;ACC;INDF;MASC;SG
فَحَص	فَحَصْنا	V;PFV;IND;PL;1;ACT
أَخِصّائِيّ	الأَخِصّائِيُّ	ADJ;NOM;DEF;MASC;SG
شَكا	تَشْكِينَ	V;IPFV;FEM;IND;SG;2;ACT
مُقَيَّد	المُقَيَّداتِ	ADJ;GEN;DEF;FEM;PL;PSSD
مُؤَسِّس	مُؤَسِّسَيْ	ADJ;ACC;SPEC;MASC;DU
عازِف	عازِفَ	N;HUM;ACC;SPEC;MASC;SG
فاتِح	فاتِحِ	N;NHUM;GEN;MASC;SG;PSSD
كامِرا	كامِرَتا	N;NHUM;NOM;FEM;DU;PSSD
مَرْتَع	مَرْتَعا	N;NHUM;NOM;SPEC;MASC;DU
حَضّ	تَحُضّا	V;IPFV;MASC;DU;2;ACT
لَوْلَبِيّ	لَوْلَبِيَّتَيْ	ADJ;GEN;FEM;DU;PSSD
تَسَلُّل	تَسَلُّلٌ	N;NHUM;NOM;INDF;MASC;SG
مُخْتَلِف	مُخْتَلِفَةُ	ADJ;NOM;SPEC;FEM;SG
أَجْرَى	تُجْرَ	V;IPFV;MASC;JUS;SG;2;PASS
مُثِير	مُثِيرُونَ	ADJ;NOM;INDF;MASC;PL
حُقْنَة	حُقْنَةَ	N;NHUM;ACC;FEM;SG;PSSD
أَزال	نُزِيلَ	V;IPFV;SBJV;PL;1;ACT
هَيْمَن	هَيْمَنَتا	V;PFV;FEM;IND;DU;3;ACT
فَضِيحَة	الفَضِيحَةُ	N;NHUM;NOM;DEF;FEM;SG
تَنافُسِيّ	تَنافُسِيِّي	ADJ;GEN;MASC;PL;PSSD
ٱِسْتَقْبَل	تَسْتَقْبِلا	V;IPFV;FEM;DU;3;ACT
مُرّ	مُرَّيْ	ADJ;ACC;SPEC;MASC;DU
ٱِخْتِبار	اِخْتِباراتٍ	N;NHUM;ACC;INDF;MASC;PL
عِراقِيّ	عِراقِيِّي	N;HUM;GEN;SPEC;MASC;PL
ٱِحْتَكَر	اِحْتَكَرْنَ	V;PFV;FEM;IND;PL;3;ACT
تَفادِي	تَفادِيات	N;NHUM;SPEC;MASC;PL
أَشَر	تَأْشُرا	V;IPFV;FEM;DU;3;ACT
مَحَطَّة	المَحَطّات	N;NHUM;DEF;FEM;PL
مارُونِيّ	مارُونِيَّتَيْ	ADJ;ACC;SPEC;FEM;DU
حَصانَة	حَصانَةٍ	N;NHUM;GEN;INDF;FEM;SG
مُقَلِّد	المُقَلِّدَيْ	N;HUM;GEN;DEF;MASC;DU
رُؤْيَة	رُؤْيَتَيْ	N;NHUM;GEN;FEM;DU;PSSD
مُونْدِيالِيّ	مُونْدِيالِيّات	ADJ;SPEC;FEM;PL
مُتَفاقِم	مُتَفاقِمَتَيْ	ADJ;ACC;FEM;DU;PSSD
أَصَرّ	تُصِرّا	V;IPFV;MASC;DU;2;ACT
مُتَطَوِّع	المُتَطَوِّعَةِ	N;HUM;GEN;DEF;FEM;SG
يائِس	اليائِساتِ	ADJ;GEN;DEF;FEM;PL;PSSD
غَيَّب	تُغَيِّبْ	V;IPFV;FEM;JUS;SG;3;ACT
تَوافُقِيّ	تَوافُقِيّاتُ	ADJ;NOM;SPEC;FEM;PL
فِيلِيبِّينِيّ	فِلِبِّينِيَّتَيْ	ADJ;GEN;SPEC;FEM;DU
مَجّانِيّ	مَجّانِيَّتَيْ	ADJ;GEN;SPEC;FEM;DU
طامِح	طامِحٍ	ADJ;GEN;INDF;MASC;SG
عَثْرَة	عَثْرَةٍ	N;NHUM;GEN;INDF;FEM;SG
مُنْسَجِم	مُنْسَجِمَيْنِ	ADJ;GEN;INDF;MASC;DU
مُفْجِع	مُفْجِعَيْ	ADJ;GEN;SPEC;MASC;DU
ٱِرْتَدَى	يَرْتَدِي	V;IPFV;MASC;IND;SG;3;ACT
ٱِنْضَوَى	يَنْضَوِيا	V;IPFV;MASC;DU;3;ACT
حائِز	حائِزَةَ	ADJ;ACC;SPEC;FEM;SG
مُتَعالِي	مُتَعالِيَةُ	ADJ;NOM;FEM;SG;PSSD
كِفاحِيّ	الكِفاحِيّ	ADJ;DEF;MASC;SG;PSSD
وَطْء	وَطْءَ	N;NHUM;ACC;SPEC;MASC;SG
أَصِيل	أَصِيلَيْ	ADJ;ACC;SPEC;MASC;DU
سَحَق	أَسْحَقْ	V;IPFV;JUS;SG;1;ACT
دُسْتُور	دُسْتُورانِ	N;NHUM;NOM;INDF;MASC;DU
نُكْتَة	نُكْتَتَيْنِ	N;NHUM;GEN;INDF;FEM;DU
مُخَنَّث	مُخَنَّثَةَ	ADJ;ACC;SPEC;FEM;SG
واحَة	واحَتَيْ	N;NHUM;ACC;SPEC;FEM;DU
دِينامِيكِيّ	الدِّينامِيكِيَّ	ADJ;ACC;DEF;MASC;SG
مَلِيح	مَلِيحانِ	ADJ;NOM;INDF;MASC;DU
ٱِنْزِعاج	اِنْزِعاجٌ	N;NHUM;NOM;INDF;MASC;SG
مُتَجَرِّد	مُتَجَرِّدَيْنِ	N;NHUM;GEN;INDF;MASC;DU
ٱِنْضِمام	اِنْضِماماتِ	N;NHUM;ACC;MASC;PL;PSSD
قَصِير	القِصارُ	ADJ;NOM;DEF;MASC;PL;PSSD
بَرِّيّ	البَرِّيَّة	ADJ;DEF;FEM;SG;PSSD
أَدَّى	تُؤَدَّيْ	V;IPFV;FEM;SG;2;PASS
ٱِلْتَزَم	اِلْتَزَمْتُما	V;PFV;MASC;IND;DU;2;ACT
مُمَلَّح	المُمَلَّحَتَيْ	ADJ;ACC;DEF;FEM;DU;PSSD
تَفْسِير	تَفْسِيرُ	N;NHUM;NOM;MASC;SG;PSSD
تَعْبِيرِيّ	التَّعْبِيرِيَّةِ	ADJ;GEN;DEF;FEM;SG
تَأَجُّج	تَأَجُّجات	N;NHUM;INDF;MASC;PL
ٱِنْكَفّ	اِنْكَفَفْتُ	V;PFV;IND;SG;1;ACT
خاطِف	الخاطِفات	ADJ;DEF;FEM;PL;PSSD
لُبْنانِيّ	لُبْنانِيُّ	N;HUM;NOM;SPEC;MASC;SG
شِيعَة	شِيعَةِ	ADJ;GEN;FEM;SG;PSSD
مُنْخَفِض	مُنْخَفِضاتِ	ADJ;ACC;FEM;PL;PSSD
أُصْبُوع	أَصابِيعَ	N;NHUM;ACC;SPEC;MASC;PL
تَقَهْقُر	تَقَهْقُرُ	N;NHUM;NOM;MASC;SG;PSSD
مَدِيح	المَدِيح	N;NHUM;DEF;MASC;SG
كُرَوِيّ	الكُرَوِيَّتَيْ	ADJ;GEN;DEF;FEM;DU;PSSD
إِقْطاع	إِقْطاعٌ	N;NHUM;NOM;INDF;MASC;SG
ساعِد	السّاعِدِينَ	ADJ;ACC;DEF;MASC;PL
طَبَقِيّ	طَبَقِيَّتانِ	ADJ;NOM;INDF;FEM;DU
مُنافَسَة	المُنافَسَةِ	N;NHUM;GEN;DEF;FEM;SG
سَلِم	تَسْلَمُوا	V;IPFV;MASC;PL;2;ACT
نَقَّب	تُنَقِّبا	V;IPFV;FEM;DU;3;ACT
كَفِيّ	كَفِيَّةً	ADJ;ACC;INDF;FEM;SG
ٱِنْدَمَل	تَنْدَمِلْنَ	V;IPFV;FEM;PL;2;ACT
سَبَّح	سَبَّحَ	V;PFV;MASC;IND;SG;3;ACT
أَوَّى	تُؤَوَّيا	V;IPFV;FEM;DU;3;PASS
طائِع	الطّائِعِ	ADJ;GEN;DEF;MASC;SG;PSSD
باطِنِيّ	باطِنِيَّتَيْنِ	ADJ;GEN;INDF;FEM;DU
تَلَمَّس	يَتَلَمَّسُ	V;IPFV;MASC;IND;SG;3;ACT
مُتَعالِي	مُتَعالِي	ADJ;GEN;SPEC;MASC;PL
أُورُوغُوايانِيّ	الأُورُوغُويانِيَّتَيْ	N;HUM;ACC;DEF;FEM;DU
مُخَوَّل	المُخَوَّلَةُ	ADJ;NOM;DEF;FEM;SG
دُكْتُور	الدُّكْتُوراتُ	N;HUM;NOM;DEF;FEM;PL
مارِق	المارِقَتَيْ	ADJ;GEN;DEF;FEM;DU;PSSD
ثَقِيل	ثَقِيل	ADJ;INDF;MASC;SG
سَلِيب	سَلِيبَتَيْ	ADJ;GEN;FEM;DU;PSSD
قَرَأ	يُقْرَأُونَ	V;IPFV;MASC;IND;PL;3;PASS
تَبْشِيرِيّ	التَّبْشِيرِيِّينَ	ADJ;ACC;DEF;MASC;PL
أَبِيّ	أَبِيَّ	ADJ;ACC;SPEC;MASC;SG
قاد	قُدْتِ	V;PFV;FEM;IND;SG;2;ACT
تَعَسُّفِيّ	تَعَسُّفِيّاتِ	ADJ;ACC;SPEC;FEM;PL
تَبْشِيرِيّ	التَّبْشِيرِيَّتانِ	ADJ;NOM;DEF;FEM;DU
مَدْخَنَة	المَدْخَنَة	N;NHUM;DEF;FEM;SG
ناشِئ	النّاشِئَةُ	N;NHUM;NOM;DEF;FEM;SG
طِيلَة	الطِّيلَةُ	N;NHUM;NOM;DEF;FEM;SG
شَقِيقَة	الشَّقِيقَةُ	N;HUM;NOM;DEF;FEM;SG
مُبَلَّل	مُبَلَّلِي	N;NHUM;ACC;SPEC;MASC;PL
سَدُود	سَدُودَتَيْ	N;NHUM;ACC;FEM;DU;PSSD
جَزائِرِيّ	الجَزائِرِيّاتُ	ADJ;NOM;DEF;FEM;PL;PSSD
بَحْرَيْنِيّ	البَحْرَيْنِيّانِ	ADJ;NOM;DEF;MASC;DU
أَيْضِيّ	أَيْضِيَّةٍ	ADJ;GEN;INDF;FEM;SG
ناضَل	تُناضِلِينَ	V;IPFV;FEM;IND;SG;2;ACT
شَرْشَف	الشَّراشِفِ	N;NHUM;GEN;DEF;MASC;PL
ٱِحْتَلّ	تَحْتَلُّ	V;IPFV;FEM;IND;SG;3;ACT
راحِل	راحِلاتٍ	ADJ;ACC;INDF;FEM;PL
جُمْلَة	جُمَلُ	N;NHUM;NOM;FEM;PL;PSSD
هُطُول	هُطُولاتٍ	N;NHUM;ACC;INDF;MASC;PL
عِيدِيَّة	عِيدِيَّتانِ	N;NHUM;NOM;SPEC;FEM;DU
عاب	عِبْتِ	V;PFV;FEM;IND;SG;2;ACT
ٱِصْطِناعِيّ	الاِصْطِناعِيُّ	ADJ;NOM;DEF;MASC;SG;PSSD
دَفِيء	دَفِيئا	ADJ;NOM;MASC;DU;PSSD
هَدَأ	يَهْدَأُ	V;IPFV;MASC;IND;SG;3;ACT
مُتَسَلِّح	مُتَسَلِّحَتَيْ	ADJ;ACC;FEM;DU;PSSD
مُدَرَّج	المُدَرَّجِ	N;NHUM;GEN;DEF;MASC;SG
تَجاهُل	تَجاهُلَيْ	N;NHUM;ACC;MASC;DU;PSSD
ٱِسْتِبْدال	اِسْتِبْدالاتِ	N;NHUM;GEN;SPEC;MASC;PL
كَشْفِيّ	كَشْفِيِّ	ADJ;GEN;SPEC;MASC;SG
فارِع	فارِعَتانِ	ADJ;NOM;SPEC;FEM;DU
مُقْتَبَس	مُقْتَبَسَتَيْنِ	ADJ;GEN;INDF;FEM;DU
تَواجُد	التَّواجُد	N;NHUM;DEF;MASC;SG
عازِل	عازِلَةً	ADJ;ACC;INDF;FEM;SG
ٱِقْتِصادِيّ	اِقْتِصادِيَّيْنِ	N;HUM;ACC;INDF;MASC;DU
مُتَجاوِز	مُتَجاوِزَةٌ	ADJ;NOM;INDF;FEM;SG
ٱِنْقَسَم	يَنْقَسِما	V;IPFV;MASC;DU;3;ACT
أَخْفَى	أَخْفَى	V;PFV;MASC;IND;SG;3;ACT
حَضارِيّ	الحَضارِيَّيْنِ	ADJ;GEN;DEF;MASC;DU
كِذْب	كِذْب	N;NHUM;INDF;MASC;SG
راكِد	راكِدَيْ	ADJ;ACC;SPEC;MASC;DU
آمِر	آمِراتِ	N;HUM;ACC;SPEC;FEM;PL
مُعَمَّر	المُعَمَّراتُ	ADJ;NOM;DEF;FEM;PL;PSSD
ٱِرْتَعَد	تَرْتَعِدا	V;IPFV;FEM;DU;3;ACT
مُلْحَق	مُلْحَقَ	ADJ;ACC;MASC;SG;PSSD
بَنْدَر	بَنادِرِ	N;NHUM;GEN;MASC;PL;PSSD
تَرْكِيع	تَرْكِيعانِ	N;NHUM;NOM;INDF;MASC;DU
شَنّ	تَشُنَّ	V;IPFV;FEM;JUS;SG;3;ACT
مُحَقِّق	مُحَقِّقَتَيْنِ	ADJ;ACC;INDF;FEM;DU
قِيادِيّ	قِيادِيُّ	N;HUM;NOM;SPEC;MASC;SG
خَيْر	خَيْرٌ	ADJ;NOM;CMPR;INDF;FEM;SG
وَهْمِيّ	وَهْمِيٌّ	ADJ;NOM;INDF;MASC;SG
يُونانِيّ	يُونانِيّ	N;HUM;INDF;MASC;SG
مُتَأَزِّم	المُتَأَزِّمَةِ	ADJ;GEN;DEF;FEM;SG
كاثُولِيكِيّ	الكاثُولِيكِيّات	ADJ;DEF;FEM;PL;PSSD
مَزْعُوم	مَزْعُوماتِ	ADJ;ACC;FEM;PL;PSSD
سُومِرِيّ	سُومِرِيَّةُ	ADJ;NOM;SPEC;FEM;SG
سَرّ	تُسَرَّ	V;IPFV;MASC;SBJV;SG;2;PASS
تشادِيّ	التّشادِيِّينَ	ADJ;GEN;DEF;MASC;PL
إِخْماد	إِخْمادَيْ	N;NHUM;GEN;SPEC;MASC;DU
ناجِم	النّاجِمَيْنِ	ADJ;GEN;DEF;MASC;DU
مَرْيَمِيّ	مَرْيَمِيَّتا	ADJ;NOM;FEM;DU;PSSD
ثابَر	ثابَرْنا	V;PFV;IND;PL;1;ACT
رائِد	الرّائِدات	ADJ;DEF;FEM;PL;PSSD
أَوْسَطِيّ	أَوْسَطِيَّةً	ADJ;ACC;INDF;FEM;SG
مُهْتَرِئ	المُهْتَرِئِ	ADJ;GEN;DEF;MASC;SG;PSSD
مُنْتَهِي	مُنْتَهِيَيْنِ	ADJ;ACC;INDF;MASC;DU
مُتَسارِع	المُتَسارِعِ	ADJ;GEN;DEF;MASC;SG;PSSD
نَصِير	نُصَراء	N;HUM;INDF;MASC;PL
تَأَصُّل	تَأَصُّلاتُ	N;NHUM;NOM;SPEC;MASC;PL
حَرَّر	يُحَرِّرْ	V;IPFV;MASC;JUS;SG;3;ACT
مُدَمَّر	مُدَمَّراتِ	ADJ;GEN;FEM;PL;PSSD
أَوْعَز	أَوْعَزَت	V;PFV;FEM;IND;SG;3;ACT
مُتَأَهِّب	مُتَأَهِّبا	N;NHUM;NOM;MASC;DU;PSSD
أُمَوِيّ	أُمَوِيَّة	ADJ;SPEC;FEM;SG
خاسِر	خاسِرَتانِ	ADJ;NOM;SPEC;FEM;DU
خالِق	الخالِقَ	N;HUM;ACC;DEF;MASC;SG
طارِئ	الطّارِئُونَ	ADJ;NOM;DEF;MASC;PL
نَبِيّ	نَبِيٌّ	N;HUM;NOM;INDF;MASC;SG
فَرْز	الفَرْزَ	N;NHUM;ACC;DEF;MASC;SG
باطِن	باطِنَتَيْ	N;NHUM;ACC;SPEC;FEM;DU
مُكْتَتِب	مُكْتَتِبا	N;HUM;NOM;SPEC;MASC;DU
رافِع	رافِعَتانِ	ADJ;NOM;SPEC;FEM;DU
هَيْكَل	الهَيْكَلَيْ	N;NHUM;GEN;DEF;MASC;DU
ٱِنْتَمَى	اِنْتَمَيْتُما	V;PFV;MASC;IND;DU;2;ACT
دِيماجُوجِيّ	دِيماجُوجِيِّ	ADJ;GEN;MASC;SG;PSSD
ٱِعْتَصَر	تَعْتَصِرُونَ	V;IPFV;MASC;IND;PL;2;ACT
مِحْوَرِيّ	المِحْوَرِيَّة	ADJ;DEF;FEM;SG;PSSD
رَدّ	يُرَدّْنَ	V;IPFV;FEM;PL;3;PASS
خُبْز	الخُبْزَةَ	N;NHUM;ACC;DEF;FEM;SG
إِباحِيّ	إِباحِيَّةُ	ADJ;NOM;SPEC;FEM;SG
مُطْران	مَطْرانا	N;HUM;NOM;SPEC;MASC;DU
فاشِل	فاشِلِ	ADJ;GEN;MASC;SG;PSSD
ٱِئْتِلاف	اِئْتِلافاتِ	N;NHUM;GEN;SPEC;MASC;PL
ضَعِيف	ضَعِيفات	N;NHUM;SPEC;FEM;PL
أَوْخَم	أَوْخَمَ	ADJ;ACC;CMPR;FEM;SG;PSSD
ٱِنْتِحارِيّ	اِنْتِحارِيُّ	ADJ;NOM;MASC;SG;PSSD
عَجِيب	عَجِيبَةُ	ADJ;NOM;SPEC;FEM;SG
جاذِب	جاذِبات	ADJ;FEM;PL;PSSD
قَدُّوس	قَدُّوسَ	N;NHUM;ACC;SPEC;MASC;SG
مات	تَمُوتَ	V;IPFV;MASC;SBJV;SG;2;ACT
كُوسا	كُوسايات	N;NHUM;SPEC;FEM;PL
سَعَى	سَعَيْتَ	V;PFV;MASC;IND;SG;2;ACT
إِفْتاء	إِفْتاءاتُ	N;NHUM;NOM;SPEC;MASC;PL
ٱِخْتار	يُخْتارانِ	V;IPFV;MASC;IND;DU;3;PASS
وازَى	وازَيْتِ	V;PFV;FEM;IND;SG;2;ACT
مُبْتَسِم	مُبْتَسِمَتَيْ	ADJ;GEN;FEM;DU;PSSD
ٱِسْتَفاق	يَسْتَفِيقَ	V;IPFV;MASC;SBJV;SG;3;ACT
مُعْجِزَة	المُعْجِزَةَ	N;NHUM;ACC;DEF;FEM;SG
أَتَمّ	أَتَمَّ	ADJ;ACC;CMPR;INDF;FEM;PL
عِظَة	عِظَةً	N;NHUM;ACC;INDF;FEM;SG
عَلِيل	العَلِيلُ	ADJ;NOM;DEF;MASC;SG
نَفْط	نَفْطٍ	N;NHUM;GEN;INDF;MASC;SG
تَزْوِير	تَزْوِيرَيْ	N;NHUM;GEN;SPEC;MASC;DU
مُحَيَّر	مُحَيَّرٍ	ADJ;GEN;INDF;MASC;SG
سَعِيد	سَعِيدَة	ADJ;SPEC;FEM;SG
مُتَّكِل	المُتَّكِلَيْنِ	ADJ;ACC;DEF;MASC;DU
ٱِتِّفاقِيَّة	اِتِّفاقِيّاتِ	N;NHUM;GEN;SPEC;FEM;PL
مُغْرِي	مُغْرِياتٍ	ADJ;ACC;INDF;FEM;PL
عالِي	العالِيَيْ	ADJ;ACC;DEF;MASC;DU;PSSD
مُكَرِّر	مُكَرِّرَتَيْ	ADJ;GEN;SPEC;FEM;DU
أَغْدَق	أَغْدَقْنَ	V;PFV;FEM;IND;PL;3;ACT
مِيلِيجرام	مِيلِيجرام	N;NHUM;INDF;MASC;SG
تَمْدِيد	تَمْدِيداتِ	N;NHUM;ACC;MASC;PL;PSSD
جَمالِيّ	جَمالِيّا	ADJ;NOM;SPEC;MASC;DU
حُرّ	حُرَّيْ	ADJ;ACC;SPEC;MASC;DU
كُزْبَرَة	الكُزْبَرَةَ	N;NHUM;ACC;DEF;FEM;SG
شَلَبِيّ	الشَّلَبِيَّ	ADJ;ACC;DEF;MASC;SG;PSSD
إِنْتاجِيّ	الإِنْتاجِيِّ	ADJ;GEN;DEF;MASC;SG;PSSD
رَثا	تَرْثُو	V;IPFV;FEM;IND;SG;3;ACT
مُمْسِك	المُمْسِكَتانِ	N;NHUM;NOM;DEF;FEM;DU
جَدْي	جَدْيَ	N;NHUM;ACC;MASC;SG;PSSD
ٱِسْتَضاء	نَسْتَضِئْ	V;IPFV;JUS;PL;1;ACT
مِلْحِيّ	المِلْحِيِّ	ADJ;GEN;DEF;MASC;SG
مُحَقَّق	مُحَقَّقاتُ	ADJ;NOM;FEM;PL;PSSD
تَأْكِيد	تَأْكِيداتِ	N;NHUM;ACC;MASC;PL;PSSD
مُسَطَّح	المُسَطَّحَةِ	ADJ;GEN;DEF;FEM;SG;PSSD
إِلٰه	إِلاهَيْ	N;HUM;ACC;SPEC;MASC;DU
إِنْجاب	إِنْجابات	N;NHUM;INDF;MASC;PL
راقَب	راقَبْتُنَّ	V;PFV;FEM;IND;PL;2;ACT
مُبَرَّز	مُبَرَّزَتَيْنِ	ADJ;ACC;INDF;FEM;DU
تَنَصُّل	تَنَصُّلا	N;NHUM;NOM;MASC;DU;PSSD
زِحام	زِحامِ	N;NHUM;GEN;SPEC;MASC;SG
تَبْشِيرِيّ	تَبْشِيرِيُّو	ADJ;NOM;SPEC;MASC;PL
مُدَقِّق	مُدَقِّقَتَيْ	N;HUM;ACC;SPEC;FEM;DU
كَسَر	تَكْسِرانِ	V;IPFV;FEM;IND;DU;3;ACT
نَقَّب	تُنَقِّبْ	V;IPFV;FEM;JUS;SG;3;ACT
كِبْرِياء	المُكابَرَةَ	N;NHUM;ACC;DEF;FEM;SG
بُرْكان	البُرْكانَ	N;NHUM;ACC;DEF;MASC;SG
تَحالَف	تَتَحالَفَ	V;IPFV;FEM;SBJV;SG;3;ACT
مُواطِن	مُواطِناتُ	N;HUM;NOM;SPEC;FEM;PL
داخِل	داخِلَتانِ	ADJ;NOM;SPEC;FEM;DU
مُتَّهَم	المُتَّهَماتُ	N;HUM;NOM;DEF;FEM;PL
مُزْهِر	مُزْهِراً	ADJ;ACC;INDF;MASC;SG
أَخْضَع	أَخْضَعُوا	V;PFV;MASC;IND;PL;3;ACT
مُساوَمَة	مُساوَمَةٍ	N;NHUM;GEN;INDF;FEM;SG
مُجِيد	المُجِيدات	ADJ;DEF;FEM;PL;PSSD
سَلِيم	السَّلِيمَة	ADJ;DEF;FEM;SG;PSSD
تَشَبُّث	تَشَبُّثاتُ	N;NHUM;NOM;SPEC;MASC;PL
دَعَم	يُدْعَما	V;IPFV;MASC;DU;3;PASS
بَحْبُوح	البَحْبُوحَتَيْ	N;NHUM;ACC;DEF;FEM;DU
شَمِيم	شَمِيمٌ	N;NHUM;NOM;INDF;MASC;SG
باحَث	تُباحِثْ	V;IPFV;MASC;JUS;SG;2;ACT
تَخَفِّي	تَخَفِّياتُ	N;NHUM;NOM;MASC;PL;PSSD
وَقُود	وَقُود	N;NHUM;INDF;MASC;SG
ٱِخْتَبَأ	اِخْتَبَأْتَ	V;PFV;MASC;IND;SG;2;ACT
مَحْكُوم	مَحْكُومَةِ	N;NHUM;GEN;SPEC;FEM;SG
قَطّاع	قَطّاعَتَيْ	ADJ;ACC;SPEC;FEM;DU
نُون	النُّوناتِ	N;NHUM;GEN;DEF;MASC;PL
لاذ	تَلُوذُونَ	V;IPFV;MASC;IND;PL;2;ACT
مُصَلِّي	مُصَلِّيَةُ	N;HUM;NOM;SPEC;FEM;SG
ٱِمْتِثال	اِمْتِثالُ	N;NHUM;NOM;MASC;SG;PSSD
مُتَفاوِض	مُتَفاوِضَيْ	N;HUM;GEN;SPEC;MASC;DU
نَشَر	تُنْشَرَ	V;IPFV;FEM;SBJV;SG;3;PASS
أَعْرَج	العَرْجاءُ	N;HUM;NOM;DEF;FEM;SG
دَيْر	أَدْيارُ	N;NHUM;NOM;MASC;PL;PSSD
بَطَل	بَطَلاتِ	N;HUM;ACC;SPEC;FEM;PL
إِزْعاج	إِزْعاجاتِ	N;NHUM;ACC;SPEC;MASC;PL
كُتَيِّب	كُتَيِّبٍ	N;NHUM;GEN;INDF;MASC;SG
أَنّ	تَئِنَّ	V;IPFV;FEM;SBJV;SG;3;ACT
عَلَف	العَلَف	N;NHUM;DEF;MASC;SG
أَخْمَص	أَخامِصِ	N;NHUM;GEN;SPEC;MASC;PL
زَجَلِيّ	الزَّجَلِيَّيْنِ	ADJ;ACC;DEF;MASC;DU
مانِع	المانِعَة	ADJ;DEF;FEM;SG
مُتَزامِن	مُتَزامِنِي	ADJ;ACC;SPEC;MASC;PL
خُرُور	الخُرُورَ	N;NHUM;ACC;DEF;MASC;SG
نَفَّذ	أُنَفَّذْ	V;IPFV;JUS;SG;1;PASS
تَحْتِيّ	التَّحْتِيّاتُ	ADJ;NOM;DEF;FEM;PL
سُرّ	سُرِّ	N;NHUM;GEN;MASC;SG;PSSD
مَصِيرِيّ	المَصِيرِيَّ	ADJ;ACC;DEF;MASC;SG
مُبَصِّر	مُبَصِّرِي	N;HUM;ACC;MASC;PL;PSSD
نَوْع	الأَنْواعَ	N;NHUM;ACC;DEF;MASC;PL
عِطْف	العِطْفَ	N;NHUM;ACC;DEF;MASC;SG
مَرّاكِشِيّ	المَرّاكِشِيَّتَيْ	ADJ;ACC;DEF;FEM;DU;PSSD
هاجَم	يُهاجَمُونَ	V;IPFV;MASC;IND;PL;3;PASS
بُرْتُقالِيّ	بُرْتُقالِيّا	ADJ;NOM;MASC;DU;PSSD
شارَك	شارَكْتَ	V;PFV;MASC;IND;SG;2;ACT
حال	حالَ	V;PFV;MASC;IND;SG;3;ACT
راكَم	راكَمَتا	V;PFV;FEM;IND;DU;3;ACT
نَشَر	تُنْشَرُوا	V;IPFV;MASC;PL;2;PASS
تَفاهَم	تَفاهَما	V;PFV;MASC;IND;DU;3;ACT
مُتَواضِع	المُتَواضِعات	ADJ;DEF;FEM;PL
مُفْجِع	المُفْجِعَةَ	ADJ;ACC;DEF;FEM;SG;PSSD
حَيَوِيّ	الحَيَوِيّاتِ	ADJ;ACC;DEF;FEM;PL
خَدَم	خَدَمْتُم	V;PFV;MASC;IND;PL;2;ACT
قاذِفَة	القاذِفاتِ	N;NHUM;ACC;DEF;FEM;PL
مَعْقُول	مَعْقُولِ	ADJ;GEN;MASC;SG;PSSD
مِصْعَد	مِصْعَداتُ	N;NHUM;NOM;SPEC;FEM;PL
فَلْسَفِيّ	فَلْسَفِيُّونَ	ADJ;NOM;INDF;MASC;PL
نَظِير	النَّظِيرَتا	ADJ;NOM;DEF;FEM;DU;PSSD
قَصَف	تُقْصَفُوا	V;IPFV;MASC;PL;2;PASS
بالِي	بالِياً	N;NHUM;ACC;INDF;MASC;SG
مُتَشابِه	مُتَشابِهُ	ADJ;NOM;MASC;SG;PSSD
مَرْصَد	مَرْصَدِ	N;NHUM;GEN;SPEC;MASC;SG
عاوَن	عاوَنَتا	V;PFV;FEM;IND;DU;3;ACT
ٱِسْتَحْوَذ	تَسْتَحْوِذُ	V;IPFV;MASC;IND;SG;2;ACT
عُضْو	عُضْوَةُ	ADJ;NOM;FEM;SG;PSSD
مُرْتَقَب	المُرْتَقَبَ	ADJ;ACC;DEF;MASC;SG;PSSD
مُجِيب	المُجِيباتُ	N;NHUM;NOM;DEF;FEM;PL
كَعْبَة	كَعْبَتَيْ	N;NHUM;GEN;SPEC;FEM;DU
جَفْن	جَفْنا	N;NHUM;NOM;SPEC;MASC;DU
طَرَأ	طَرَأُوا	V;PFV;MASC;IND;PL;3;ACT
ٱِنْتَعَش	تَنْتَعِشُوا	V;IPFV;MASC;PL;2;ACT
غُرْفَة	غُرَفَ	N;NHUM;ACC;FEM;PL;PSSD
تَرْكِيب	تَرْكِيبا	N;NHUM;NOM;SPEC;MASC;DU
مُتَساوِي	المُتَساوِيات	ADJ;DEF;FEM;PL;PSSD
مُنْبَثِق	مُنْبَثِقَيْ	ADJ;GEN;MASC;DU;PSSD
عَتَب	تَعْتُبُ	V;IPFV;MASC;IND;SG;2;ACT
تَبِيع	تَبِيعَة	N;NHUM;INDF;FEM;SG
غُصْن	الغُصْنُ	N;NHUM;NOM;DEF;MASC;SG
صِرْف	الصِّرْف	ADJ;DEF;MASC;SG;PSSD
مائِيّ	مائِيَّتَيْ	ADJ;ACC;SPEC;FEM;DU
ٱِسْتِماتَة	اِسْتِماتَةِ	N;NHUM;GEN;FEM;SG;PSSD
مُسَلَّم	مُسَلَّماتِ	N;NHUM;ACC;MASC;PL;PSSD
مَجْرُوح	مَجْرُوحَيْنِ	ADJ;ACC;INDF;MASC;DU
بَوّاب	بَوّاباتُ	N;HUM;NOM;SPEC;FEM;PL
مُلَبِّي	مُلَبِّينَ	N;NHUM;GEN;INDF;MASC;PL
ٱِسْتَحَقّ	نُسْتَحَقّْ	V;IPFV;JUS;PL;1;PASS
أَجاد	أَجادَت	V;PFV;FEM;IND;SG;3;ACT
ضَحِي	تَضْحَيانِ	V;IPFV;FEM;IND;DU;3;ACT
قَيَّل	نُقَيِّلْ	V;IPFV;JUS;PL;1;ACT
عِبْرِيّ	عِبْرِيُّو	ADJ;NOM;SPEC;MASC;PL
قَضِم	تَقْضَما	V;IPFV;MASC;DU;2;ACT
سَمانَة	سَمانَةٌ	N;NHUM;NOM;INDF;FEM;SG
صَعَق	تَصْعَقَ	V;IPFV;FEM;SBJV;SG;3;ACT
يَسِير	يَسِيرَةُ	ADJ;NOM;SPEC;FEM;SG
جَبَل	جَبَلَيْ	N;NHUM;ACC;SPEC;MASC;DU
مُتْرَع	مُتْرَعَيْ	N;NHUM;GEN;SPEC;MASC;DU
ٱِنْقَسَم	تَنْقَسِمُ	V;IPFV;FEM;IND;SG;3;ACT
إِتْمام	إِتْمامات	N;NHUM;SPEC;MASC;PL
فَتَح	فُتِحْتَ	V;PFV;MASC;IND;SG;2;PASS
بَدِيل	بَدِيلَيْ	N;NHUM;GEN;MASC;DU;PSSD
شِيك	شِكّاتِ	N;NHUM;ACC;MASC;PL;PSSD
تارِك	تارِكاتِ	ADJ;ACC;FEM;PL;PSSD
إِحْصائِيّ	الإِحْصائِيَّتا	ADJ;NOM;DEF;FEM;DU;PSSD
ٱِحْتِياطِيّ	اِحْتِياطِيّات	ADJ;SPEC;FEM;PL
مُتَوازِي	المُتَوازِيا	ADJ;NOM;DEF;MASC;DU;PSSD
ٱِبْتِداع	اِبْتِداعاتُ	N;NHUM;NOM;MASC;PL;PSSD
يَمِينِيّ	يَمِينِيَّتَيْنِ	ADJ;GEN;INDF;FEM;DU
زانِي	زانِيَيْنِ	N;HUM;GEN;INDF;MASC;DU
ٱِحْتِفالِيّ	اِحْتِفالِيّاً	ADJ;ACC;INDF;MASC;SG
تَسَرَّى	تَسَرَّتا	V;PFV;FEM;IND;DU;3;ACT
عِراقِيّ	العِراقِيَّتَيْ	N;HUM;ACC;DEF;FEM;DU
مَرْهُون	المَرْهُونَةِ	ADJ;GEN;DEF;FEM;SG
خَدَع	تَخْدَعا	V;IPFV;MASC;DU;2;ACT
سُرُور	سُرُورٌ	N;NHUM;NOM;INDF;MASC;SG
تَكَهُّن	تَكَهُّناتٍ	N;NHUM;GEN;INDF;MASC;PL
لاف	يَلُوفانِ	V;IPFV;MASC;IND;DU;3;ACT
بادَر	أُبادِرْ	V;IPFV;JUS;SG;1;ACT
سَلام	سَلام	N;NHUM;INDF;MASC;SG
مُشَخِّص	مُشَخِّصِي	ADJ;GEN;MASC;PL;PSSD
تَأَزُّم	تَأَزُّمات	N;NHUM;INDF;MASC;PL
مُعْتَدِي	مُعْتَدِي	N;HUM;GEN;MASC;PL;PSSD
طَوَّل	أُطَوِّلُ	V;IPFV;IND;SG;1;ACT
عالَمِيّ	العالَمِيَّيْ	ADJ;ACC;DEF;MASC;DU;PSSD
تَفاوُض	التَّفاوُضات	N;NHUM;DEF;MASC;PL
مُوَلِّد	مُوَلِّدَةَ	N;NHUM;ACC;SPEC;FEM;SG
مُقام	مُقامَتَيْ	ADJ;ACC;SPEC;FEM;DU
خَمّار	الخَمّارِي	N;HUM;ACC;DEF;MASC;PL
تَهاوَى	تَتَهاوَيانِ	V;IPFV;MASC;IND;DU;2;ACT
تَرْتِيبِيّ	تَرْتِيبِيِّ	ADJ;GEN;MASC;SG;PSSD
نَيِّر	نَيِّرا	ADJ;NOM;SPEC;MASC;DU
جادّ	جادَّيْ	ADJ;GEN;SPEC;MASC;DU
جاذِب	جاذِبَتا	ADJ;NOM;FEM;DU;PSSD
غائِب	غائِبِ	ADJ;GEN;SPEC;MASC;SG
عَبْرَة	العَبَراتُ	N;NHUM;NOM;DEF;FEM;PL
عاث	عاثا	V;PFV;MASC;IND;DU;3;ACT
أَصْدَر	أَصْدَرا	V;PFV;MASC;IND;DU;3;ACT
حَصِيلَة	حَصائِلُ	N;NHUM;NOM;SPEC;FEM;PL
مانِع	مانِعٌ	ADJ;NOM;INDF;MASC;SG
ٱِخْتِبارِيّ	الاِخْتِبارِيَّتَيْ	ADJ;GEN;DEF;FEM;DU;PSSD
غُبار	أَغْبِرَةِ	N;NHUM;GEN;SPEC;MASC;PL
غائِب	غائِبا	ADJ;NOM;MASC;DU;PSSD
مُضادّ	المُضادّاتُ	N;NHUM;NOM;DEF;MASC;PL
ثالُوث	ثالُوثَةً	N;NHUM;ACC;INDF;FEM;SG
أَدْلَى	يُدْلِيانِ	V;IPFV;MASC;IND;DU;3;ACT
وَصِيف	وَصِيفَ	N;NHUM;ACC;MASC;SG;PSSD
أَضَرّ	أُضَرُّ	V;IPFV;IND;SG;1;PASS
تَحْكِيمِيّ	التَّحْكِيمِيّاتُ	ADJ;NOM;DEF;FEM;PL;PSSD
سِينَمائِيّ	السِّينَمائِيّ	ADJ;DEF;MASC;SG
مُراجِع	مُراجِعَةٍ	N;HUM;GEN;INDF;FEM;SG
مُماثِل	مُماثِلَتَيْ	ADJ;ACC;SPEC;FEM;DU
حُقْب	الحِقابَ	N;NHUM;ACC;DEF;MASC;PL
سائِل	سائِلَتَيْنِ	ADJ;ACC;INDF;FEM;DU
مُكْتَفِي	مُكْتَفِيا	ADJ;NOM;MASC;DU;PSSD
تَذَمَّر	أَتَذَمَّرْ	V;IPFV;JUS;SG;1;ACT
تَزَعَّم	تَزَعَّمْتَ	V;PFV;MASC;IND;SG;2;ACT
مُفْلِس	مُفْلِساتِ	ADJ;ACC;SPEC;FEM;PL
ضَمِن	أَضْمَنَ	V;IPFV;SBJV;SG;1;ACT
وَصَف	تَصِفُوا	V;IPFV;MASC;PL;2;ACT
تَحْرِيم	تَحْرِيماتُ	N;NHUM;NOM;SPEC;MASC;PL
نَفْعِيّ	النَّفْعِيَّيْنِ	ADJ;GEN;DEF;MASC;DU
بايَع	يُبايِعْنَ	V;IPFV;FEM;PL;3;ACT
سَهْل	سَهْل	ADJ;INDF;MASC;SG
سِينارِيو	سِينارِيُواتٍ	N;NHUM;ACC;INDF;MASC;PL
رُؤْيَة	رُؤْيَة	N;NHUM;SPEC;FEM;SG
صَحِيح	صَحِيحَتا	ADJ;NOM;FEM;DU;PSSD
ٱِعْتَصَر	اِعْتَصَرْتُما	V;PFV;MASC;IND;DU;2;ACT
مُدْرَج	المُدْرَجَ	ADJ;ACC;DEF;MASC;SG;PSSD
مُسْتَثْمِر	مُسْتَثْمِرِي	ADJ;ACC;MASC;PL;PSSD
أَسْرَع	أَسْرَعا	ADJ;NOM;CMPR;FEM;PL;PSSD
مَزْرُوعَة	مَزْرُوعَةِ	N;NHUM;GEN;FEM;SG;PSSD
بالِسْتِيّ	بالِسْتِيٌّ	ADJ;NOM;INDF;MASC;SG
مَأْمَن	مَأْمَنَيْ	N;NHUM;GEN;SPEC;MASC;DU
تَوَتَّر	يَتَوَتَّرَ	V;IPFV;MASC;SBJV;SG;3;ACT
فِرْعَوْن	فِرْعَوْنا	N;HUM;NOM;MASC;DU;PSSD
هَدّاف	هَدّافَيْ	N;HUM;ACC;SPEC;MASC;DU
ٱِصْطَلَى	اِصْطَلَيا	V;PFV;MASC;IND;DU;3;ACT
مُتَسَلِّل	مُتَسَلِّلِي	N;HUM;ACC;SPEC;MASC;PL
شاكِي	شاكِياتِ	ADJ;GEN;SPEC;FEM;PL
مالِيزِيّ	مالِيزِيَّةَ	ADJ;ACC;SPEC;FEM;SG
طَلّاء	طَلّاءَتانِ	N;NHUM;NOM;SPEC;FEM;DU
جُرْمِيّ	الجُرْمِيِّي	ADJ;GEN;DEF;MASC;PL;PSSD
مَوْهُوب	المَوْهُوبِينَ	ADJ;GEN;DEF;MASC;PL
صَلاحِيَّة	صَلاحِيّاتُ	N;NHUM;NOM;SPEC;FEM;PL
باراغُوائِيّ	باراجُوائِيُّ	ADJ;NOM;MASC;SG;PSSD
ثَلاثُون	ثَلاثِي	ADJ;ACC;SPEC;MASC;SG
إِعْلانِيّ	إِعْلانِيَّيْنِ	ADJ;ACC;INDF;MASC;DU
تَغاضِي	تَغاضِيا	N;NHUM;NOM;SPEC;MASC;DU
أَحاط	تُحاطُ	V;IPFV;MASC;IND;SG;2;PASS
لِيبِيرِيّ	لِبِيرِيّاتِ	ADJ;ACC;SPEC;FEM;PL
حِسابِيّ	حِسابِيِّي	ADJ;ACC;MASC;PL;PSSD
كلاسِيكِيّ	كلاسِكِيّاتِ	N;NHUM;GEN;FEM;PL;PSSD
مَعْهُود	مَعْهُودَةً	ADJ;ACC;INDF;FEM;SG
مَقْرَب	مَقْرَبَةُ	N;NHUM;NOM;SPEC;FEM;SG
مِقْصَلَة	مِقْصَلَةَ	N;NHUM;ACC;SPEC;FEM;SG
شابَّة	شابَّة	ADJ;SPEC;FEM;SG
ٱِخْتَبَأ	اِخْتَبَأُوا	V;PFV;MASC;IND;PL;3;ACT
كافَح	كافَحَ	V;PFV;MASC;IND;SG;3;ACT
فَحْص	الفُحُوصِ	N;NHUM;GEN;DEF;MASC;PL
واعِد	واعِدَيْنِ	ADJ;ACC;INDF;MASC;DU
ٱِرْتَسَم	أَرْتَسِمَ	V;IPFV;SBJV;SG;1;ACT
أَفْتَك	الأَفْتَكا	ADJ;NOM;CMPR;DEF;MASC;DU
جُمْهُور	جُمْهُورُ	N;NHUM;NOM;SPEC;MASC;SG
أَكّال	الأَكّالُ	N;HUM;NOM;DEF;MASC;SG
تَجادَل	أَتَجادَلُ	V;IPFV;IND;SG;1;ACT
صارِخ	صارِخُونَ	ADJ;NOM;INDF;MASC;PL
راجِع	راجِعَةٌ	ADJ;NOM;INDF;FEM;SG
نَجْل	أَنْجالاً	N;NHUM;ACC;INDF;MASC;PL
مُتَعاطِف	مُتَعاطِفا	ADJ;NOM;SPEC;MASC;DU
عُمُومِيَّة	عُمُومِيّاتِ	N;NHUM;GEN;SPEC;FEM;PL
إِعْدادِيّ	إِعْدادِيَّتَيْ	ADJ;GEN;SPEC;FEM;DU
نِصْفِيّ	نِصْفِيَّةٍ	ADJ;GEN;INDF;FEM;SG
مَعْنِيّ	مَعْنِيّاتٍ	ADJ;ACC;INDF;FEM;PL
فالِح	فالِحاتٍ	ADJ;GEN;INDF;FEM;PL
مُمَيِّز	المُمَيِّزَةُ	N;NHUM;NOM;DEF;FEM;SG
مَطّاطِيّ	مَطّاطِيَّيْ	ADJ;ACC;SPEC;MASC;DU
تَصْدِيق	التَّصْدِيقَ	N;NHUM;ACC;DEF;MASC;SG
تَوَغَّل	تَتَوَغَّلِي	V;IPFV;FEM;SG;2;ACT
عُبُور	عُبُورٌ	N;NHUM;NOM;INDF;MASC;SG
قُرَشِيّ	القُرَشِيِّي	ADJ;ACC;DEF;MASC;PL;PSSD
كَلِيل	الكَلِيلَ	ADJ;ACC;DEF;MASC;SG;PSSD
مَضْجَع	مَضْجَعَيْ	N;NHUM;GEN;MASC;DU;PSSD
مُساهِم	مُساهِمَيْنِ	ADJ;GEN;INDF;MASC;DU
مُعْتَدَى	المُعْتَدَىُ	ADJ;NOM;DEF;MASC;SG
كَثَّف	كَثَّفْتِ	V;PFV;FEM;IND;SG;2;ACT
باكِي	باكِيَيْ	N;HUM;ACC;MASC;DU;PSSD
مُضْمَر	المُضْمَرَيْ	ADJ;ACC;DEF;MASC;DU;PSSD
ٱِعْتَمَد	يُعْتَمَدَ	V;IPFV;MASC;SBJV;SG;3;PASS
تَحْلِيلِيّ	التَّحْلِيلِيِّ	ADJ;GEN;DEF;MASC;SG
ٱِشْتِراكِيّ	اِشْتِراكِيَّتانِ	ADJ;NOM;INDF;FEM;DU
نِيلِيّ	نِيلِيَّة	N;NHUM;INDF;FEM;SG
مُدْرِك	المُدْرِكِينَ	ADJ;ACC;DEF;MASC;PL
ٱِشْتَهَر	اِشْتَهَرْتُما	V;PFV;MASC;IND;DU;2;ACT
رام	يَرُومُ	V;IPFV;MASC;IND;SG;3;ACT
مُلَبِّي	مُلَبِّيا	N;NHUM;NOM;SPEC;MASC;DU
مُسْتَعِدّ	المُسْتَعِدَّيْ	ADJ;GEN;DEF;MASC;DU;PSSD
لَفْتَة	لَفْتَةً	N;NHUM;ACC;INDF;FEM;SG
شَخَّص	تُشَخِّصْنَ	V;IPFV;FEM;PL;2;ACT
تِرْسانَة	تَرْسان	N;NHUM;INDF;MASC;SG
مَكْبُوت	مَكْبُوتَيْ	ADJ;GEN;SPEC;MASC;DU
مُوَحَّد	المُوَحَّدَيْنِ	ADJ;ACC;DEF;MASC;DU
مُغَبَّر	مُغَبَّرَيْ	ADJ;GEN;MASC;DU;PSSD
صارِخ	الصّارِخُونَ	ADJ;NOM;DEF;MASC;PL
مُؤَسِّس	مُؤَسِّسٌ	ADJ;NOM;INDF;MASC;SG
مُحاوِل	المُحاوِلاتِ	ADJ;GEN;DEF;FEM;PL
شَرارَة	الشَّرارَةِ	N;NHUM;GEN;DEF;FEM;SG
ٱِنْطِباعِيّ	اِنْطِباعِيُّ	ADJ;NOM;MASC;SG;PSSD
مُقْفَل	المُقْفَلَ	ADJ;ACC;DEF;MASC;SG;PSSD
ثَرْثَرَة	ثَرْثَرات	N;NHUM;SPEC;FEM;PL
مُصاب	مُصابَة	ADJ;SPEC;FEM;SG
أُسْبُوع	أُسْبُوعا	N;NHUM;NOM;MASC;DU;PSSD
تَحتْمائِيّ	التَّحتْمائِيّانِ	ADJ;NOM;DEF;MASC;DU
شِبْر	شِبْرُ	N;NHUM;NOM;SPEC;MASC;SG
أَنْذَر	تُنْذِرُونَ	V;IPFV;MASC;IND;PL;2;ACT
مَلْمُوس	مَلْمُوسَتَيْنِ	ADJ;GEN;INDF;FEM;DU
مُكافَحَة	مُكافَحاتِ	N;NHUM;ACC;FEM;PL;PSSD
وَصَف	وُصِفَتا	V;PFV;FEM;IND;DU;3;PASS
صاعِد	صاعِدَتانِ	N;NHUM;NOM;INDF;FEM;DU
دُعاء	دُعاءٍ	N;NHUM;GEN;INDF;MASC;SG
أَحَرّ	أَحَرّا	ADJ;NOM;CMPR;SPEC;MASC;PL
قانِئ	قانِئَةٌ	ADJ;NOM;INDF;FEM;SG
ٱِسْتَبْعَد	يُسْتَبْعَدْ	V;IPFV;MASC;JUS;SG;3;PASS
مُلْتَصِق	مُلْتَصِقِي	ADJ;GEN;SPEC;MASC;PL
مُحَمَّل	المُحَمَّلاتِ	ADJ;GEN;DEF;FEM;PL;PSSD
تَرَقَّى	يَتَرَقَّى	V;IPFV;MASC;SBJV;SG;3;ACT
خاسِر	خاسِراتِ	N;HUM;ACC;FEM;PL;PSSD
مُناهِض	المُناهِضُونَ	ADJ;NOM;DEF;MASC;PL
رَحِيق	رَحِيقِ	N;NHUM;GEN;SPEC;MASC;SG
تَعْبِير	التَّعابِيرَ	N;NHUM;ACC;DEF;MASC;PL
سَبَّب	تُسَبِّبِينَ	V;IPFV;FEM;IND;SG;2;ACT
رَطْب	رَطْبا	N;NHUM;NOM;MASC;DU;PSSD
مُعْظَم	مُعْظَمٍ	N;GEN;INDF;MASC;PL
كَسْر	كُسُورٍ	N;NHUM;GEN;INDF;MASC;PL
تَوَخَّى	أَتَوَخَّى	V;IPFV;SBJV;SG;1;ACT
رَضَّى	رَضَّيْتُما	V;PFV;MASC;IND;DU;2;ACT
شابَّة	شابَّتَيْنِ	N;HUM;ACC;INDF;FEM;DU
عَصِيب	عَصِيبَتَيْنِ	ADJ;GEN;INDF;FEM;DU
تَخَطَّى	تَخَطَّى	V;PFV;MASC;IND;SG;3;ACT
مُحْرَق	مُحْرَقَتَيْنِ	N;NHUM;GEN;INDF;FEM;DU
نَسِيب	نَسِيباً	N;HUM;ACC;INDF;MASC;SG
مَنْكِب	مَنْكِبَيْ	N;NHUM;GEN;MASC;DU;PSSD
قِرْن	قِرْنٌ	N;NHUM;NOM;INDF;MASC;SG
وافِر	وافِرَيْ	ADJ;GEN;SPEC;MASC;DU
أَرْسَى	أَرْسَى	V;PFV;MASC;IND;SG;3;ACT
نَزِل	أَنْزَلْ	V;IPFV;JUS;SG;1;ACT
ٱِفْتِراء	اِفْتِراءَيْ	N;NHUM;ACC;SPEC;MASC;DU
جَرُؤ	تَجْرَأْنَ	V;IPFV;FEM;PL;2;ACT
عَمِيل	عَمِيلِ	N;HUM;GEN;MASC;SG;PSSD
مُلْصَق	المُلْصَقَيْ	ADJ;GEN;DEF;MASC;DU;PSSD
شَبّ	شَبَّتانِ	ADJ;NOM;SPEC;FEM;DU
فَتْحَة	فَتْحَتَيْنِ	N;NHUM;GEN;INDF;FEM;DU
مُتَحَيِّز	مُتَحَيِّزُ	ADJ;NOM;SPEC;MASC;SG
مُصَفَّح	المُصَفَّحَة	ADJ;DEF;FEM;SG
عامِّيّ	العامِّيَّتَيْ	ADJ;ACC;DEF;FEM;DU;PSSD
كاذِب	كاذِبٌ	ADJ;NOM;INDF;MASC;SG
مَجْرُوح	المَجْرُوحَةِ	ADJ;GEN;DEF;FEM;SG
ٱِسْتِقْطار	اِسْتِقْطاراتُ	N;NHUM;NOM;SPEC;MASC;PL
حَسّاسِيَّة	حَسّاسِيّاتِ	N;NHUM;GEN;FEM;PL;PSSD
مَطْلُوب	المَطْلُوبَتانِ	ADJ;NOM;DEF;FEM;DU
أَسْهَب	تُسْهِبا	V;IPFV;FEM;DU;3;ACT
مَرَضِيّ	المَرَضِيَّةَ	ADJ;ACC;DEF;FEM;SG;PSSD
مُتَطَوِّع	مُتَطَوِّعَتَيْ	ADJ;GEN;SPEC;FEM;DU
جِينِيّ	جِينِيّات	N;NHUM;INDF;FEM;PL
رَبَّب	رَبَّبْتُ	V;PFV;IND;SG;1;ACT
ٱِنْقِلابِيّ	الاِنْقِلابِيِّي	ADJ;ACC;DEF;MASC;PL;PSSD
مَحْسُوم	المَحْسُومَة	ADJ;DEF;FEM;SG
عَسْكَرِيّ	العَسْكَرِيَّتا	ADJ;NOM;DEF;FEM;DU;PSSD
مُمْتَلِئ	مُمْتَلِئ	N;NHUM;INDF;MASC;SG
حَصِير	حَصِيرا	N;NHUM;NOM;SPEC;MASC;DU
وَضْعِيَّة	وَضْعِيّاتٌ	N;NHUM;NOM;INDF;FEM;PL
عِلْمانِيّ	العِلْمانِيّات	ADJ;DEF;FEM;PL;PSSD
جَمايْكِيّ	الجامايْكِيّاتُ	ADJ;NOM;DEF;FEM;PL;PSSD
مُذَكِّر	مُذَكِّر	ADJ;INDF;MASC;SG
مِيكانِيكِيّ	مِيكانِيكِيَّةً	ADJ;ACC;INDF;FEM;SG
طَرَد	أَطْرُدَ	V;IPFV;SBJV;SG;1;ACT
قِيثار	القَياثِير	N;NHUM;DEF;MASC;PL
مُنَدِّد	مُنَدِّدِي	ADJ;ACC;MASC;PL;PSSD
إِشْراق	الإِشْراق	N;NHUM;DEF;MASC;SG
غائِم	غائِم	ADJ;INDF;MASC;SG
تَرْبَوِيّ	تَرْبَوِيَّتَيْ	N;HUM;GEN;FEM;DU;PSSD
نُون	نُونٍ	N;NHUM;GEN;INDF;MASC;SG
راحَة	راحَتَيْ	N;NHUM;GEN;SPEC;FEM;DU
أَصْدَر	تُصْدِرْنَ	V;IPFV;FEM;PL;2;ACT
ٱِسْتِئْذان	اِسْتِئْذانَ	N;NHUM;ACC;SPEC;MASC;SG
فاصِل	فاصِلَيْنِ	ADJ;ACC;INDF;MASC;DU
مَشْطُوب	المَشْطُوبِينَ	ADJ;GEN;DEF;MASC;PL
تَعَلُّق	تَعَلُّقاتُ	N;NHUM;NOM;MASC;PL;PSSD
مُتَشائِم	مُتَشائِمَتانِ	ADJ;NOM;SPEC;FEM;DU
حَزَم	حَزَمْنا	V;PFV;IND;PL;1;ACT
ٱِسْتِخْراج	اِسْتِخْراجاتٍ	N;NHUM;ACC;INDF;MASC;PL
إِرْهاف	إِرْهافِ	N;NHUM;GEN;SPEC;MASC;SG
شاهِدَة	شاهِدَة	N;NHUM;INDF;FEM;SG
سُكُون	السُّكُونُ	N;NHUM;NOM;DEF;MASC;SG
مَحْصُور	مَحْصُورات	ADJ;SPEC;FEM;PL
رَمَق	رَمَقاً	N;NHUM;ACC;INDF;MASC;SG
مُؤَدِّي	المُؤَدِّيَةِ	ADJ;GEN;DEF;FEM;SG
طَرَح	تَطْرَحْنَ	V;IPFV;FEM;PL;2;ACT
كُرّاس	الكُرّاسا	N;NHUM;NOM;DEF;MASC;DU
لَبْوَة	لَبَوات	N;NHUM;FEM;PL;PSSD
ٱِسْتَنْتَج	تُسْتَنْتَجْ	V;IPFV;MASC;JUS;SG;2;PASS
يَهُودِيَّة	يَهُودِيَّةِ	N;NHUM;GEN;FEM;SG;PSSD
أَكادِيمِيّ	الأَكادِيمِيُّو	N;HUM;NOM;DEF;MASC;PL
فاس	فاسا	N;NHUM;NOM;SPEC;MASC;DU
مُكَرِّر	مُكَرِّرٌ	ADJ;NOM;INDF;MASC;SG
لاح	أَلُوحَ	V;IPFV;SBJV;SG;1;ACT
غَوْغائِيّ	غَوْغائِيَّتَيْ	ADJ;GEN;FEM;DU;PSSD
قاطِن	القُطّانَ	ADJ;ACC;DEF;MASC;PL;PSSD
مُكَسَّر	مُكَسَّر	ADJ;INDF;MASC;SG
خَطَّط	خَطَّطَت	V;PFV;FEM;IND;SG;3;ACT
بَدِيهِيَّة	البَدِيهِيّات	N;NHUM;DEF;FEM;PL
مُسْتَمَدّ	المُسْتَمَدَّيْ	ADJ;GEN;DEF;MASC;DU;PSSD
قُدُوم	قُدُومُ	N;NHUM;NOM;SPEC;MASC;SG
عَكَف	تَعْكُفُ	V;IPFV;FEM;IND;SG;3;ACT
عَلَوِيّ	عَلَوِيَّيْ	ADJ;ACC;MASC;DU;PSSD
غَوْغائِيّ	غَوْغائِيَّتَيْنِ	ADJ;GEN;INDF;FEM;DU
مُنَوَّر	المُنَوَّرَيْنِ	ADJ;ACC;DEF;MASC;DU
حِسابِيّ	حِسابِيّاتُ	ADJ;NOM;FEM;PL;PSSD
حِداد	حِدادَ	N;NHUM;ACC;MASC;SG;PSSD
تَرْحِيبِيّ	التَّرْحِيبِيَّتا	ADJ;NOM;DEF;FEM;DU;PSSD
صَرِيح	صَرائِحُ	ADJ;NOM;MASC;PL;PSSD
نِسائِيّ	نِسائِيّاً	ADJ;ACC;INDF;MASC;SG
كُولُومْبِيّ	كُولُومْبِيُّونَ	ADJ;NOM;INDF;MASC;PL
حَدِيقَة	حَدِيقَةٌ	N;NHUM;NOM;INDF;FEM;SG
بَدَنِيّ	البَدَنِيَّتَيْنِ	ADJ;GEN;DEF;FEM;DU
مُكْتَشِف	المُكْتَشِفَةُ	N;HUM;NOM;DEF;FEM;SG
تَعْلِيل	تَعْلِيلُ	N;NHUM;NOM;SPEC;MASC;SG
عائِد	عائِدَةِ	ADJ;GEN;FEM;SG;PSSD
رِيش	الرِّيشِ	N;NHUM;GEN;DEF;MASC;SG
كَفّ	الكَفِّ	N;NHUM;GEN;DEF;MASC;SG
تَأْوِيلِيّ	تَأْوِيلِيِّينَ	ADJ;GEN;INDF;MASC;PL
كاشِف	الكَشَفَةِ	N;HUM;GEN;DEF;MASC;PL
نِيابِيّ	النِّيابِيَّةِ	ADJ;GEN;DEF;FEM;SG
خُمّ	أَخْمامُ	N;NHUM;NOM;MASC;PL;PSSD
سالِك	سالِكَةُ	ADJ;NOM;SPEC;FEM;SG
ذائِع	الذّائِعِينَ	ADJ;ACC;DEF;MASC;PL
مَطّاط	مَطّاطُ	N;NHUM;NOM;SPEC;MASC;SG
غاضِب	غاضِبَيْنِ	ADJ;ACC;INDF;MASC;DU
ٱِسْتَهان	تَسْتَهِنَّ	V;IPFV;FEM;PL;2;ACT
أَخْلاقِيّ	أَخْلاقِيّات	ADJ;FEM;PL;PSSD
أَنْزِيم	أَنْزِيمِ	N;NHUM;GEN;SPEC;MASC;SG
مُتَعاقَد	مُتَعاقَدَ	ADJ;ACC;SPEC;MASC;SG
حَبِيب	حَبِيبَ	ADJ;ACC;SPEC;MASC;SG
ٱِسْتَعَر	اِسْتَعَرْتُ	V;PFV;IND;SG;1;ACT
إِسْكان	إِسْكانا	N;NHUM;NOM;SPEC;MASC;DU
تَدَهْوَر	تَدَهْوَرْتِ	V;PFV;FEM;IND;SG;2;ACT
مُنْتَقِد	مُنْتَقِداتِ	ADJ;ACC;FEM;PL;PSSD
مُمَرِّض	المُمَرِّضَةِ	N;HUM;GEN;DEF;FEM;SG
مُتَحَدِّث	المُتَحَدِّثُ	ADJ;NOM;DEF;MASC;SG;PSSD
أَفْغانِيّ	أَفْغانِيّاتِ	N;HUM;ACC;SPEC;FEM;PL
مُتَراصّ	المُتَراصَّ	ADJ;ACC;DEF;MASC;SG;PSSD
سَفّاك	السَّفّاكِ	N;HUM;GEN;DEF;MASC;SG
تَحَدَّث	تَتَحَدَّثا	V;IPFV;FEM;DU;3;ACT
عَنْوَن	تُعَنْوِنْ	V;IPFV;FEM;JUS;SG;3;ACT
غَرِيم	الغَرِيمَةَ	N;NHUM;ACC;DEF;FEM;SG
إِهْدار	إِهْداراتٍ	N;NHUM;ACC;INDF;MASC;PL
مُوسِيقِيّ	مُوسِيقِيَّتَيْ	ADJ;ACC;FEM;DU;PSSD
سَمِع	يَسْمَعُ	V;IPFV;MASC;IND;SG;3;ACT
مُتَأَهِّل	مُتَأَهِّلَةِ	N;HUM;GEN;SPEC;FEM;SG
كَنَدِيّ	كَنَدِيُّ	N;HUM;NOM;SPEC;MASC;SG
جِذْر	جَذْرَيْنِ	N;NHUM;ACC;INDF;MASC;DU
ٱِسْتَباح	اِسْتَبَحْتُ	V;PFV;IND;SG;1;ACT
ضالِع	الضّالِعَ	ADJ;ACC;DEF;MASC;SG
تُرابِيّ	تُرابِيَّيْ	ADJ;GEN;SPEC;MASC;DU
ٱِسْتَوْرَد	نَسْتَوْرِدْ	V;IPFV;JUS;PL;1;ACT
فَخُور	فَخُورَةِ	ADJ;GEN;SPEC;FEM;SG
مُتَنَقِّل	مُتَنَقِّلِي	ADJ;ACC;SPEC;MASC;PL
ضاجَع	ضاجَعَ	V;PFV;MASC;IND;SG;3;ACT
مُذَكِّرَة	مُذَكِّرَةً	N;NHUM;ACC;INDF;FEM;SG
ٱِنْتِقالِيّ	اِنْتِقالِيَّةُ	ADJ;NOM;SPEC;FEM;SG
عَدُوّ	العَدُوَّةِ	ADJ;GEN;DEF;FEM;SG
مُوغِل	المُوغِلِ	ADJ;GEN;DEF;MASC;SG
بُورُونْدِيّ	بُرُنْدِيُّو	N;HUM;NOM;MASC;PL;PSSD
مُنْشَقّ	المُنْشَقَّةِ	ADJ;GEN;DEF;FEM;SG;PSSD
طائِف	طائِفُ	ADJ;NOM;MASC;SG;PSSD
خَلَّى	تُخَلِّ	V;IPFV;FEM;JUS;SG;3;ACT
قُدْسِيّ	القُدْسِيُّو	ADJ;NOM;DEF;MASC;PL;PSSD
خَمْسِيّ	الخَمْسِيّانِ	ADJ;NOM;DEF;MASC;DU
أُورُومُتَوَسِّطِيّ	أُورُومُتَوَسِّطِيّات	ADJ;SPEC;FEM;PL
مَوْعُود	المَوْعُودَتَيْ	N;NHUM;GEN;DEF;FEM;DU
مُعَرَّض	المُعَرَّضانِ	ADJ;NOM;DEF;MASC;DU
ٱِنْتَظَر	تُنْتَظَرانِ	V;IPFV;FEM;IND;DU;3;PASS
حُوت	حُوتِ	N;NHUM;GEN;MASC;SG;PSSD
مَزَّة	المَزّاتِ	N;NHUM;GEN;DEF;FEM;PL
مُعْتَدِل	المُعْتَدِلَةَ	ADJ;ACC;DEF;FEM;SG
أُورُوغُوايانِيّ	أُورُوغُويانِيّ	N;HUM;INDF;MASC;SG
ٱِفْتَكَر	تَفْتَكِرْ	V;IPFV;FEM;JUS;SG;3;ACT
تَسْلِيف	التَّسْلِيف	N;NHUM;DEF;MASC;SG
رَجْعِيّ	رَجْعِيُّو	ADJ;NOM;MASC;PL;PSSD
وَفَى	وَفَيْنا	V;PFV;IND;PL;1;ACT
مُبَلَّل	مُبَلَّلاتٍ	N;NHUM;ACC;INDF;FEM;PL
جَزائِيّ	الجَزائِيُّو	ADJ;NOM;DEF;MASC;PL;PSSD
تَوافَد	يَتَوافَدُونَ	V;IPFV;MASC;IND;PL;3;ACT
إِرْغام	إِرْغامٌ	N;NHUM;NOM;INDF;MASC;SG
إِسْبانِيّ	إِسْباناً	ADJ;ACC;INDF;MASC;PL
أَحْرَج	أُحْرَجْ	V;IPFV;JUS;SG;1;PASS
تَأَبَّط	أَتَأَبَّطَ	V;IPFV;SBJV;SG;1;ACT
لَوَّح	يُلَوِّحُ	V;IPFV;MASC;IND;SG;3;ACT
مُسَنَّن	مُسَنَّنَةِ	ADJ;GEN;SPEC;FEM;SG
هَدْرَج	يُهَدْرِجْنَ	V;IPFV;FEM;PL;3;ACT
سَكِينَة	سَكِينَةُ	N;NHUM;NOM;SPEC;FEM;SG
ٱِسْتَعْلَم	يَسْتَعْلِمُوا	V;IPFV;MASC;PL;3;ACT
عاوِز	عاوِزِينَ	ADJ;ACC;INDF;MASC;PL
مُغْتاظ	المُغْتاظَةُ	ADJ;NOM;DEF;FEM;SG;PSSD
جَرَّف	جَرَّفْتُ	V;PFV;IND;SG;1;ACT
عَرْقَل	يُعَرْقِلا	V;IPFV;MASC;DU;3;ACT
مِهْبَل	المِهْبَلُ	N;NHUM;NOM;DEF;MASC;SG
مِنْشَفَة	مَناشِفُ	N;NHUM;NOM;SPEC;FEM;PL
ضاحِك	الضّاحِك	ADJ;DEF;MASC;SG
إِفْراج	إِفْراجٌ	N;NHUM;NOM;INDF;MASC;SG
أَوْضَح	أَوْضَحَت	V;PFV;FEM;IND;SG;3;ACT
تَقَدُّمِيّ	تَقَدُّمِيّاتٌ	ADJ;NOM;INDF;FEM;PL
حَرْبِيّ	حَرْبِيَّةَ	ADJ;ACC;FEM;SG;PSSD
مُعاقَبَة	مُعاقَبَتَيْ	N;NHUM;ACC;FEM;DU;PSSD
تَأْمِين	تَأْمِينا	N;NHUM;NOM;MASC;DU;PSSD
تَحاوُر	تَحاوُرَيْ	N;NHUM;GEN;MASC;DU;PSSD
مُناوَأَة	مُناوَأَتَيْنِ	N;NHUM;GEN;INDF;FEM;DU
مُبْتَدَأ	مُبْتَدَئَيْنِ	N;NHUM;ACC;INDF;MASC;DU
مُمَيَّز	مُمَيَّزٌ	ADJ;NOM;INDF;MASC;SG
فِيلِيبِّينِيّ	الفِلِبِّينِيَّتَيْ	ADJ;GEN;DEF;FEM;DU;PSSD
مَوْضُوعِيّ	مَوْضُوعِيَّتَيْ	ADJ;ACC;FEM;DU;PSSD
مُسَخِّر	المُسَخِّرَ	ADJ;ACC;DEF;MASC;SG
عَمِيق	عُمُقِ	ADJ;GEN;SPEC;MASC;PL
حائِر	حائِرَيْنِ	ADJ;ACC;INDF;MASC;DU
قُبْرُصِيّ	القُبْرُسِيَّةَ	N;HUM;ACC;DEF;FEM;SG
سَخَّر	أُسَخِّرْ	V;IPFV;JUS;SG;1;ACT
مُعاش	مُعاشَيْ	ADJ;GEN;SPEC;MASC;DU
مِعْمارِيّ	المِعْمارِيّاتُ	ADJ;NOM;DEF;FEM;PL;PSSD
زاغ	زاغَت	V;PFV;FEM;IND;SG;3;ACT
أَخْطَأ	أَخْطَأْتُنَّ	V;PFV;FEM;IND;PL;2;ACT
عاطِفِيّ	العاطِفِيّ	ADJ;DEF;MASC;SG
ٱِبْتَكَر	اِبْتَكَرْنا	V;PFV;IND;PL;1;ACT
إِقْطاع	إِقْطاعَ	N;NHUM;ACC;MASC;SG;PSSD
مُنْهِي	مُنْهِيَيْ	ADJ;ACC;MASC;DU;PSSD
مُحَمَّل	مُحَمَّلَتا	ADJ;NOM;FEM;DU;PSSD
بَكِي	نَبْكَى	V;IPFV;IND;PL;1;ACT
غايَة	غاياتٍ	N;NHUM;ACC;INDF;FEM;PL
مُحَقِّق	مُحَقِّقَتَيْ	N;HUM;GEN;FEM;DU;PSSD
أَوْضَح	أَوْضَحِ	ADJ;GEN;CMPR;SPEC;FEM;PL
مَجْرُور	مَجْرُورانِ	N;NHUM;NOM;INDF;MASC;DU
قَرُب	قَرُبْتُم	V;PFV;MASC;IND;PL;2;ACT
رَدْعِيّ	الرَّدْعِيَّتانِ	N;NHUM;NOM;DEF;FEM;DU
أَحاط	تُحاطُونَ	V;IPFV;MASC;IND;PL;2;PASS
مُسَلْسَل	مُسَلْسَلَتَيْنِ	N;NHUM;GEN;INDF;FEM;DU
تَحْرِيم	تَحْرِيمِ	N;NHUM;GEN;SPEC;MASC;SG
مُفْتَرِس	مُفْتَرِساتِ	ADJ;ACC;FEM;PL;PSSD
تَبادُل	تَبادُلَيْ	N;NHUM;ACC;SPEC;MASC;DU
فرانْكُوفُونِيّ	فرانْكُفُونِيّات	ADJ;FEM;PL;PSSD
أُولِمْبِيّ	أُولِمْبِيَّةُ	ADJ;NOM;SPEC;FEM;SG
حَلِيب	حَلِيبَ	N;NHUM;ACC;MASC;SG;PSSD
كِيمِياء	كِيمِياءَ	N;NHUM;ACC;SPEC;FEM;SG
ٱِبْتِكار	اِبْتِكارُ	N;NHUM;NOM;SPEC;MASC;SG
أَجاب	يُجِيبَ	V;IPFV;MASC;SBJV;SG;3;ACT
مُنْكَسِر	المُنْكَسِرِ	ADJ;GEN;DEF;MASC;SG
طالِبانِيّ	الطّالِبانِيَّة	ADJ;DEF;FEM;SG;PSSD
مُلْحَق	مُلْحَقِي	N;NHUM;GEN;MASC;PL;PSSD
غاشِم	غاشِمَتانِ	ADJ;NOM;INDF;FEM;DU
هَزْلِيّ	هَزْلِيٍّ	ADJ;GEN;INDF;MASC;SG
مُؤْتَمَن	مُؤْتَمَنَيْنِ	ADJ;ACC;INDF;MASC;DU
مُجَلَّد	مُجَلَّدِي	N;NHUM;GEN;SPEC;MASC;PL
ناتِئَة	النَّواتِئ	N;NHUM;DEF;FEM;PL
عَذْراء	عَذْراءَ	ADJ;ACC;INDF;FEM;SG
جَدَّد	جَدَّدُوا	V;PFV;MASC;IND;PL;3;ACT
مُناوَبَة	مُناوَباتِ	N;NHUM;ACC;SPEC;FEM;PL
عَلِيم	العَلِيماتِ	N;NHUM;GEN;DEF;FEM;PL
رُخامِيّ	رُخامِيِّي	ADJ;ACC;MASC;PL;PSSD
مُضاهِي	مُضاهِيَةُ	ADJ;NOM;SPEC;FEM;SG
تَشْجِير	تَشْجِيراتِ	N;NHUM;ACC;MASC;PL;PSSD
ٱِتِّفاق	اِتِّفاقاتِ	N;NHUM;ACC;SPEC;MASC;PL
أَلَدّ	أَلَدّانِ	ADJ;NOM;INDF;MASC;DU
مُثَقَّف	مُثَقَّفَةَ	ADJ;ACC;SPEC;FEM;SG
بُخارِيّ	بُخارِيَّتَيْنِ	ADJ;ACC;INDF;FEM;DU
تُرْكِيّ	تُرْكِيَّتانِ	N;HUM;NOM;SPEC;FEM;DU
مَشْرِقِيّ	المَشْرِقِيَّيْنِ	ADJ;GEN;DEF;MASC;DU
تَوافُقِيّ	تَوافُقِيِّ	ADJ;GEN;MASC;SG;PSSD
فارِس	فَوارِس	N;HUM;INDF;MASC;PL
مُؤْمِن	المُؤْمِنَيْ	N;HUM;GEN;DEF;MASC;DU
مُجاراة	مُجاراة	N;NHUM;SPEC;FEM;SG
خَلِيجِيّ	خَلِيجِيُّو	ADJ;NOM;MASC;PL;PSSD
خُرْسان	خُرْسانَتا	N;NHUM;NOM;FEM;DU;PSSD
غَضّ	أَغُضُّ	V;IPFV;IND;SG;1;ACT
جِيفَة	الجِيفَةُ	N;NHUM;NOM;DEF;FEM;SG
بَلِيغ	بَلِيغِ	ADJ;GEN;SPEC;MASC;SG
ظُفُر	ظُفُرِ	N;NHUM;GEN;MASC;SG;PSSD
وَرِث	تُورَثْ	V;IPFV;FEM;JUS;SG;3;PASS
جَمال	الجَمالُ	N;NHUM;NOM;DEF;MASC;SG
تَقاطَع	تَقاطَعَت	V;PFV;FEM;IND;SG;3;ACT
مُنْفَجِر	مُنْفَجِرا	ADJ;NOM;SPEC;MASC;DU
مُتَعاطِف	مُتَعاطِفاتُ	N;HUM;NOM;FEM;PL;PSSD
مُسْتَرِدّ	المُسْتَرِدِّينَ	ADJ;ACC;DEF;MASC;PL
ٱِسْتَأْذَن	تَسْتَأْذِنُوا	V;IPFV;MASC;PL;2;ACT
شَوْك	الشَّوْكُ	N;NHUM;NOM;DEF;MASC;SG
فائِق	فائِقِ	ADJ;GEN;MASC;SG;PSSD
شَدّ	تَشُدِّي	V;IPFV;FEM;SG;2;ACT
بازِغ	بازِغُ	ADJ;NOM;MASC;SG;PSSD
مِثال	أَمْثِلَةُ	N;NHUM;NOM;MASC;PL;PSSD
مُخَدَّر	المُخَدَّرَ	ADJ;ACC;DEF;MASC;SG;PSSD
نِقاب	نُقُبِ	N;NHUM;GEN;SPEC;MASC;PL
مُؤاساة	مُؤاساةً	N;NHUM;ACC;INDF;FEM;SG
مارْكِسِيّ	مارْكِسِيُّ	ADJ;NOM;MASC;SG;PSSD
أَعْلَى	أَعْلَيَيْ	ADJ;GEN;CMPR;MASC;DU;PSSD
مُحْدَث	المُحْدَثاتُ	ADJ;NOM;DEF;FEM;PL;PSSD
كُوسْتارِيكِيّ	كُوسْتارِيكِيَّتَيْنِ	N;HUM;ACC;INDF;FEM;DU
مُسانِد	المُسانِدات	ADJ;DEF;FEM;PL
مُسْتَنْبَط	مُسْتَنْبَطِ	ADJ;GEN;MASC;SG;PSSD
مَقْرَب	مَقارِبَ	N;NHUM;ACC;SPEC;MASC;PL
لَقَّب	تُلَقِّبُ	V;IPFV;FEM;IND;SG;3;ACT
مُؤَكِّد	مُؤَكِّداتٍ	ADJ;GEN;INDF;FEM;PL
مُهْدَى	مُهْداتانِ	ADJ;NOM;INDF;FEM;DU
قائِم	قائِمَ	ADJ;ACC;SPEC;MASC;SG
عاطِل	عاطِلَتَيْ	ADJ;GEN;FEM;DU;PSSD
مَنْظُور	مَنْظُوراتٍ	N;NHUM;GEN;INDF;MASC;PL
مُسْتاء	مُسْتاءَتا	ADJ;NOM;FEM;DU;PSSD
طَلْعَة	طَلَعاتِ	N;NHUM;GEN;SPEC;FEM;PL
صِبْغ	صِبْغِ	N;NHUM;GEN;MASC;SG;PSSD
مُرْسِل	مُرْسِلَيْ	N;NHUM;GEN;MASC;DU;PSSD
أُصُولِيّ	الأُصُولِيُّو	ADJ;NOM;DEF;MASC;PL;PSSD
مُشْكِل	مُشْكِلٍ	N;NHUM;GEN;INDF;MASC;SG
مُجْرِم	مُجْرِمَة	ADJ;INDF;FEM;SG
قارّ	القارَّتَيْنِ	ADJ;ACC;DEF;FEM;DU
مُصَوِّر	مُصَوِّراتٍ	ADJ;GEN;INDF;FEM;PL
تَحْضِيرِيّ	تَحْضِيرِيِّ	ADJ;GEN;SPEC;MASC;SG
إِفْشاء	إِفْشاءات	N;NHUM;SPEC;MASC;PL
غائِم	الغائِمَةِ	ADJ;GEN;DEF;FEM;SG
إِلْحادِيّ	إِلْحادِيَّيْنِ	ADJ;GEN;INDF;MASC;DU
سَرَطانِيّ	سَرَطانِيَّة	ADJ;INDF;FEM;SG
ٱِنْكِماش	اِنْكِماشَ	N;NHUM;ACC;MASC;SG;PSSD
مُقِلّ	مُقِلّا	ADJ;NOM;MASC;DU;PSSD
مُحْرَق	مُحْرَقاً	N;NHUM;ACC;INDF;MASC;SG
نَهْضَوِيّ	نَهْضَوِيَّتانِ	ADJ;NOM;SPEC;FEM;DU
غَرِيبَة	غَرِيبَتانِ	N;NHUM;NOM;INDF;FEM;DU
سامِيّ	سامِيَّ	ADJ;ACC;SPEC;MASC;SG
إِدْراك	الإِدْراكاتُ	N;NHUM;NOM;DEF;MASC;PL
مُنْهار	المُنْهارِ	ADJ;GEN;DEF;MASC;SG
سامِيّ	السّامِيَّةِ	N;HUM;GEN;DEF;FEM;SG
سادِس	سادِساتِ	ADJ;ACC;SPEC;FEM;PL
مُشَغَّل	مُشَغَّلَيْنِ	ADJ;ACC;INDF;MASC;DU
طَبَقِيّ	طَبَقِيَّيْنِ	ADJ;ACC;INDF;MASC;DU
ٱِنْبِعاث	الاِنْبِعاثا	N;NHUM;NOM;DEF;MASC;DU
حاضِر	حاضِرا	N;NHUM;NOM;SPEC;MASC;DU
فَهِم	يُفْهَمَ	V;IPFV;MASC;SBJV;SG;3;PASS
راجِع	الرّاجِعَيْ	ADJ;ACC;DEF;MASC;DU;PSSD
مَأْجُور	المَأْجُورات	ADJ;DEF;FEM;PL
كِيمِيائِيّ	كِيمِيُّو	ADJ;NOM;MASC;PL;PSSD
أَحْرَج	أَحْرَجُ	ADJ;NOM;CMPR;INDF;FEM;PL
ٱِتِّهام	اِتِّهاماتِ	N;NHUM;GEN;MASC;PL;PSSD
أَوْسَع	الأَوْسَع	ADJ;CMPR;DEF;MASC;SG
تَلْفَن	تُتَلْفِنِي	V;IPFV;FEM;SG;2;ACT
قُبْرُصِيّ	قُبْرُسِيّاتٍ	ADJ;GEN;INDF;FEM;PL
تَحامَل	تَحامَلْتِ	V;PFV;FEM;IND;SG;2;ACT
مُتَجَوِّل	مُتَجَوِّلَةٍ	ADJ;GEN;INDF;FEM;SG
ٱِسْتِيلاء	اِسْتِيلاءَ	N;NHUM;ACC;MASC;SG;PSSD
مُسْتَخْرَج	مُسْتَخْرَجاً	ADJ;ACC;INDF;MASC;SG
عَطاء	عَطاءات	N;NHUM;MASC;PL;PSSD
ٱِزْدِواج	اِزْدِواجَيْنِ	N;NHUM;GEN;INDF;MASC;DU
عِمْلاق	عَمالِقَةِ	N;NHUM;GEN;SPEC;MASC;PL
ترِينِيدادِيّ	ترِينِيدادِيَّ	ADJ;ACC;SPEC;MASC;SG
نافِد	نافِدٌ	ADJ;NOM;INDF;MASC;SG
ٱِنْزَرَع	اِنْزَرَعَتا	V;PFV;FEM;IND;DU;3;ACT
أَعْفَى	يُعْفِيَ	V;IPFV;MASC;SBJV;SG;3;ACT
طَعَن	طَعَنُوا	V;PFV;MASC;IND;PL;3;ACT
تَلْفَن	تَلْفَنْتُ	V;PFV;IND;SG;1;ACT
دامِي	الدّامُو	ADJ;NOM;DEF;MASC;PL;PSSD
جَنُوبِيّ	الجَنُوبِيُّو	ADJ;NOM;DEF;MASC;PL;PSSD
مِغْسَل	المِغْسَلا	N;NHUM;NOM;DEF;MASC;DU
إِسْتراتِيجِيّ	الإِسْتراتِيجِيِّ	N;NHUM;GEN;DEF;MASC;SG
قالِب	قالَبَيْنِ	N;NHUM;ACC;INDF;MASC;DU
هُولانْدِيّ	هُولانْدِيّانِ	ADJ;NOM;INDF;MASC;DU
فَحَم	تَفْحَما	V;IPFV;FEM;DU;3;ACT
تَصاعَد	تَتَصاعَدُوا	V;IPFV;MASC;PL;2;ACT
دَفْع	دَفْعُ	N;NHUM;NOM;MASC;SG;PSSD
حَدِيدِيّ	حَدِيدِيَّة	ADJ;INDF;FEM;SG
تَرَعْرَع	نَتَرَعْرَعُ	V;IPFV;IND;PL;1;ACT
رَئِيس	رُؤَساءُ	N;HUM;NOM;INDF;MASC;PL
حَجَرِيّ	الحَجَرِيَّتَيْ	ADJ;GEN;DEF;FEM;DU;PSSD
خَبِير	خَبِيرات	ADJ;INDF;FEM;PL
أَراب	أُرِبْ	V;IPFV;JUS;SG;1;ACT
مَجْنُون	المَجْنُونَيْنِ	ADJ;ACC;DEF;MASC;DU
جُزَيْئِيّ	جُزَيْئِيَّتَيْ	ADJ;ACC;SPEC;FEM;DU
تَتْوِيج	تَتْوِيجاتٌ	N;NHUM;NOM;INDF;MASC;PL
فَقْرَة	فَقَراتُ	N;NHUM;NOM;SPEC;FEM;PL
ٱِبْتَأَس	اِبْتَأَسْنا	V;PFV;IND;PL;1;ACT
أُرْثُودُكسِيّ	أُرْثُودُكسِيَّةِ	ADJ;GEN;FEM;SG;PSSD
وَكَس	تَكِسْنَ	V;IPFV;FEM;PL;2;ACT
مُبْدِع	مُبْدِعَتَيْنِ	N;HUM;ACC;INDF;FEM;DU
وَصَل	يُوصَلُ	V;IPFV;MASC;IND;SG;3;PASS
غاز	غازَيْ	N;NHUM;GEN;MASC;DU;PSSD
شَفَة	الشَّفَتَيْ	N;NHUM;GEN;DEF;FEM;DU
حاضِنَة	حاضِنَةُ	N;NHUM;NOM;FEM;SG;PSSD
ضِفَّة	ضِفَّتَيْ	N;NHUM;GEN;FEM;DU;PSSD
وَصْفِيّ	وَصْفِيٌّ	ADJ;NOM;INDF;MASC;SG
ٱِخْتِيارِيّ	الاِخْتِيارِيَّتَيْنِ	ADJ;GEN;DEF;FEM;DU
مُعاق	المُعاقِ	ADJ;GEN;DEF;MASC;SG;PSSD
رَجْعِيّ	الرَّجْعِيَّتَيْ	ADJ;GEN;DEF;FEM;DU;PSSD
مُشاحَنَة	مُشاحَنات	N;NHUM;FEM;PL;PSSD
إِرِيترِيّ	الإِرِترِيَّتا	ADJ;NOM;DEF;FEM;DU;PSSD
أَقْعَد	أَقْعَدْتُنَّ	V;PFV;FEM;IND;PL;2;ACT
لِيبِيّ	اللِّيبِيّاتُ	N;HUM;NOM;DEF;FEM;PL
أَمِيرِيّ	الأَمِيرِيُّ	ADJ;NOM;DEF;MASC;SG
طالِبانِيّ	الطّالِبانِيّاتِ	ADJ;GEN;DEF;FEM;PL
مَهْزَلَة	المَهازِلِ	N;NHUM;GEN;DEF;FEM;PL
واهِم	واهِمانِ	ADJ;NOM;INDF;MASC;DU
ساكِت	السّاكِتَيْنِ	ADJ;ACC;DEF;MASC;DU
وِقِيَّة	الوِقِيَّةَ	N;NHUM;ACC;DEF;FEM;SG
أَثْنَى	يُثْنِي	V;IPFV;MASC;IND;SG;3;ACT
مُتَعاقِد	مُتَعاقِدا	N;HUM;NOM;MASC;DU;PSSD
بَرْبَرِيّ	البَرْبَرِيَّة	ADJ;DEF;FEM;SG
أَعار	أَعارَت	V;PFV;FEM;IND;SG;3;ACT
مُسْرِف	المُسْرِفُ	ADJ;NOM;DEF;MASC;SG;PSSD
مُحْزِن	المُحْزِنَةَ	ADJ;ACC;DEF;FEM;SG;PSSD
ٱِتِّهامِيّ	الاِتِّهامِيَّ	ADJ;ACC;DEF;MASC;SG
مَقْبُول	مَقْبُولِ	ADJ;GEN;SPEC;MASC;SG
قَضَى	قَضَيْتُنَّ	V;PFV;FEM;IND;PL;2;ACT
وَطِيء	وَطِيئَ	ADJ;ACC;MASC;SG;PSSD
ٱِسْتَدْفَأ	يَسْتَدْفِئْ	V;IPFV;MASC;JUS;SG;3;ACT
تاجَر	يُتاجِرَ	V;IPFV;MASC;SBJV;SG;3;ACT
تَثْقِيف	تَثْقِيفُ	N;NHUM;NOM;MASC;SG;PSSD
يَسارِيّ	يَسارِيّاً	N;HUM;ACC;INDF;MASC;SG
مَذْهَب	المَذاهِب	N;NHUM;DEF;MASC;PL
خِفَّة	خِفَّة	N;NHUM;FEM;SG;PSSD
بَطَّأ	يُبَطَّأُونَ	V;IPFV;MASC;IND;PL;3;PASS
فَراشَة	فَراشَةِ	N;NHUM;GEN;FEM;SG;PSSD
مَعْمُول	المَعْمُولُ	ADJ;NOM;DEF;MASC;SG;PSSD
نَبِيّ	نَبِيَّةِ	N;HUM;GEN;FEM;SG;PSSD
قَرِع	تَقْرَعُونَ	V;IPFV;MASC;IND;PL;2;ACT
وَسِيطَة	وَسائِطُ	N;NHUM;NOM;SPEC;FEM;PL
شَتَوِيّ	شَتَوِيَّتَيْ	ADJ;ACC;FEM;DU;PSSD
مُبَيِّن	مُبَيِّنٍ	N;NHUM;GEN;INDF;MASC;SG
بَشِير	البَشِيرُ	N;HUM;NOM;DEF;MASC;SG
لَأَم	تَلْأَمِي	V;IPFV;FEM;SG;2;ACT
ٱِكْتَسَح	اِكْتَسَحَت	V;PFV;FEM;IND;SG;3;ACT
مُمْتَلِئ	المُمْتَلِئا	N;NHUM;NOM;DEF;MASC;DU
مُتَكاتِف	المُتَكاتِفَتَيْ	ADJ;ACC;DEF;FEM;DU;PSSD
قام	تَقُمْنَ	V;IPFV;FEM;PL;2;ACT
فُضُولِيّ	فُضُولِيّاتُ	ADJ;NOM;FEM;PL;PSSD
تَخْمِير	تَخْمِيرا	N;NHUM;NOM;MASC;DU;PSSD
تَرَف	تَرَفِ	N;NHUM;GEN;SPEC;MASC;SG
إِعارَة	الإِعاراتِ	N;NHUM;GEN;DEF;FEM;PL
مُصارَعَة	مُصارَعَتَيْنِ	N;NHUM;GEN;INDF;FEM;DU
أَمْرِيكِيّ	أَمِيرْكِيَّيْنِ	ADJ;GEN;INDF;MASC;DU
مَحْبُوك	مَحْبُوكِ	ADJ;GEN;MASC;SG;PSSD
دِيك	الدِّيكَ	N;NHUM;ACC;DEF;MASC;SG
مُصَغَّر	مُصَغَّرَيْ	ADJ;ACC;MASC;DU;PSSD
ٱِنْحَنَى	يَنْحَنِيا	V;IPFV;MASC;DU;3;ACT
مُمَلَّح	مُمَلَّحِ	ADJ;GEN;MASC;SG;PSSD
ٱِحْمِرار	اِحْمِرار	N;NHUM;INDF;MASC;SG
نَفَى	نَفَيْنَ	V;PFV;FEM;IND;PL;3;ACT
مَعْمَلِيّ	مَعْمَلِيَّيْ	ADJ;GEN;SPEC;MASC;DU
جُغْرافِيا	الجُغْرافِيَّةَ	N;NHUM;ACC;DEF;FEM;SG
أَنْغُولِيّ	الأَنْغُولِيَّتانِ	ADJ;NOM;DEF;FEM;DU
مُخْتار	مُخْتارٌ	N;NHUM;NOM;INDF;MASC;SG
بَنَفْسَجِيّ	البَنَفْسَجِيَّيْ	ADJ;GEN;DEF;MASC;DU;PSSD
أَفْسَح	أُفْسِحُ	V;IPFV;IND;SG;1;ACT
طَيَّب	طَيَّبْنَ	V;PFV;FEM;IND;PL;3;ACT
مُتَنامِي	المُتَنامِيَةَ	ADJ;ACC;DEF;FEM;SG;PSSD
هِمَّة	هِمَم	N;NHUM;INDF;FEM;PL
خَطَأ	خَطاءُ	N;NHUM;NOM;MASC;PL;PSSD
مُواتِي	مُواتِيَةٌ	ADJ;NOM;INDF;FEM;SG
صَراحَة	صَراحَةَ	N;NHUM;ACC;SPEC;FEM;SG
مُشاكِس	المُشاكِسَتَيْنِ	ADJ;ACC;DEF;FEM;DU
أَوْعَز	يُوعِزا	V;IPFV;MASC;DU;3;ACT
مُسْرِف	المُسْرِفِينَ	ADJ;GEN;DEF;MASC;PL
أُرْدُنِّيّ	أُرْدُنِّيّاتٍ	N;HUM;GEN;INDF;FEM;PL
وَثْبَة	وَثْبَتَيْنِ	N;NHUM;GEN;INDF;FEM;DU
مُزْدان	المُزْدان	ADJ;DEF;MASC;SG;PSSD
مُعْتَبَر	المُعْتَبَرُ	ADJ;NOM;DEF;MASC;SG;PSSD
خائِن	خائِنَيْ	N;HUM;ACC;MASC;DU;PSSD
تَأَمُّلِيّ	تَأَمُّلِيَّتَيْ	ADJ;GEN;SPEC;FEM;DU
ٱِسْتِشْراقِيّ	اِسْتِشْراقِيّا	ADJ;NOM;MASC;DU;PSSD
مُسَخِّر	المُسَخِّرِ	ADJ;GEN;DEF;MASC;SG
جَهْوَرِيّ	الجَهْوَرِيِّي	ADJ;ACC;DEF;MASC;PL;PSSD
ٱِسْتِتْباع	اِسْتِتْباعٍ	N;NHUM;GEN;INDF;MASC;SG
مَعْصُوم	المَعْصُومُ	ADJ;NOM;DEF;MASC;SG
ٱِبْتَأَس	تَبْتَئِسْنَ	V;IPFV;FEM;PL;2;ACT
ٱِسْتَساغ	تَسْتَسِغْنَ	V;IPFV;FEM;PL;2;ACT
تَسَرَّى	تَتَسَرَّى	V;IPFV;MASC;SBJV;SG;2;ACT
قَضِم	قَضِمْتِ	V;PFV;FEM;IND;SG;2;ACT
ثَرِيّ	ثَرِيَّة	N;HUM;SPEC;FEM;SG
غارِق	غارِقاتِ	ADJ;GEN;SPEC;FEM;PL
ٱِضْمِحْلال	اِضْمِحْلالَ	N;NHUM;ACC;SPEC;MASC;SG
سَوْط	سَوْطَيْ	N;NHUM;ACC;MASC;DU;PSSD
بارِي	البارِي	N;HUM;GEN;DEF;MASC;PL
نَهْضَة	نَهَضاتِ	N;NHUM;GEN;SPEC;FEM;PL
مَشْرُوع	المَشارِيعِ	N;NHUM;GEN;DEF;MASC;PL
وُقِّع	وُقِّعْتَ	V;PFV;MASC;IND;SG;2;PASS
قُدْسِيّ	قُدْسِيّاتٌ	ADJ;NOM;INDF;FEM;PL
تَبْرِئَة	تَبْرِئَةٍ	N;NHUM;GEN;INDF;FEM;SG
هُورْمُون	هُرْمُونِ	N;NHUM;GEN;SPEC;MASC;SG
كُرْدِيّ	الكُرْدِيّات	ADJ;DEF;FEM;PL;PSSD
مِئَوِيّ	مِئَوِيِّي	ADJ;ACC;MASC;PL;PSSD
مُسْتَمَدّ	مُسْتَمَدَّة	ADJ;SPEC;FEM;SG
تَمَرْكُز	تَمَرْكُزَيْ	N;NHUM;GEN;SPEC;MASC;DU
رُومَنْطِيقِيّ	الرُّومَنْطِيقِيَّيْ	ADJ;GEN;DEF;MASC;DU;PSSD
لَفَظ	لَفَظْنا	V;PFV;IND;PL;1;ACT
مَغْمُور	المَغْمُورَتَيْنِ	ADJ;ACC;DEF;FEM;DU
مُنافِس	المُنافِسَتَيْ	N;HUM;GEN;DEF;FEM;DU
ٱِحْتَدَم	يَحْتَدِمُوا	V;IPFV;MASC;PL;3;ACT
غُصْن	الغُصْنَيْ	N;NHUM;ACC;DEF;MASC;DU
أَقْسَم	أَقْسَمْتِ	V;PFV;FEM;IND;SG;2;ACT
مُعَظَّم	المُعَظَّماتُ	ADJ;NOM;DEF;FEM;PL
تَوَقَّف	تَوَقَّفَت	V;PFV;FEM;IND;SG;3;ACT
زَمانِيّ	زَمانِيِّينَ	ADJ;GEN;INDF;MASC;PL
ٱِكْتَفَى	تَكْتَفِيْنَ	V;IPFV;FEM;PL;2;ACT
كَرَّس	أُكَرِّسُ	V;IPFV;IND;SG;1;ACT
مُرْتَكِز	المُرْتَكِزَةَ	ADJ;ACC;DEF;FEM;SG;PSSD
دِراسِيّ	الدِّراسِيَّتَيْ	ADJ;ACC;DEF;FEM;DU;PSSD
شَقِيق	شَقِيقٍ	ADJ;GEN;INDF;MASC;SG
مالِك	مالِكَةَ	N;HUM;ACC;FEM;SG;PSSD
مَلَكِيّ	المَلَكِيِّينَ	ADJ;ACC;DEF;MASC;PL
مُرابَطَة	مُرابَطَة	N;NHUM;SPEC;FEM;SG
براغْماتِيّ	براغْماتِيُّ	ADJ;NOM;SPEC;MASC;SG
ٱِتِّفاقِيّ	الاِتِّفاقِيَّتا	ADJ;NOM;DEF;FEM;DU;PSSD
أَوْسَع	تُوسِعُ	V;IPFV;MASC;IND;SG;2;ACT
كَرْتُون	كارْتُونَ	N;NHUM;ACC;MASC;SG;PSSD
ٱِسْتِمالَة	اِسْتِمالَة	N;NHUM;SPEC;FEM;SG
ٱِحْتِقان	اِحْتِقاناتٍ	N;NHUM;GEN;INDF;MASC;PL
كِبْرِيتِيّ	الكِبْرِيتِيّ	ADJ;DEF;MASC;SG;PSSD
كُحُولِيّ	كُحُولِيّا	ADJ;NOM;MASC;DU;PSSD
حُكُومِيّ	حُكُومِيِّينَ	ADJ;ACC;INDF;MASC;PL
رَبِيعِيّ	الرَّبِيعِيَّتَيْ	ADJ;GEN;DEF;FEM;DU;PSSD
تَصْمِيم	التَّصْمِيم	N;NHUM;DEF;MASC;SG
خَرِب	خَرِباتِ	N;NHUM;GEN;FEM;PL;PSSD
طَلَب	تُطْلَبْ	V;IPFV;MASC;JUS;SG;2;PASS
عَمالَة	العَمالَةِ	N;NHUM;GEN;DEF;FEM;SG
عَرِيض	العَرِيضا	ADJ;NOM;DEF;MASC;DU;PSSD
مُرْتَقَب	مُرْتَقَبُ	N;NHUM;NOM;MASC;SG;PSSD
سُوقِيّ	السُّوقِيَّ	ADJ;ACC;DEF;MASC;SG;PSSD
رادِيكالِيّ	الرّادِكالِيِّ	ADJ;GEN;DEF;MASC;SG;PSSD
مُتَفَجِّر	المُتَفَجِّرَةَ	ADJ;ACC;DEF;FEM;SG
أَفْعَى	أَفاعٍ	N;NHUM;GEN;INDF;FEM;PL
كَنْعانِيّ	كَنْعانِيَّةٍ	ADJ;GEN;INDF;FEM;SG
تَرْك	تَرْكٌ	N;NHUM;NOM;INDF;MASC;SG
ناعُورَة	نَواعِيرِ	N;NHUM;GEN;SPEC;FEM;PL
أَسْمَى	أَسْمَيَيْ	ADJ;GEN;SPEC;MASC;DU
حَصْرِيّ	الحَصْرِيَّيْ	N;NHUM;ACC;DEF;MASC;DU
مُحَرَّر	مُحَرَّرَة	ADJ;SPEC;FEM;SG
فَتّاك	فَتّاكُ	ADJ;NOM;SPEC;MASC;SG
جائِز	جائِزا	ADJ;NOM;MASC;DU;PSSD
وَرِيث	وَرِيثاتٍ	N;HUM;GEN;INDF;FEM;PL
كَرْم	الكَرْمَ	N;NHUM;ACC;DEF;MASC;SG
قاسَم	تُقاسِمانِ	V;IPFV;MASC;IND;DU;2;ACT
رِبْح	أَرْباحَ	N;NHUM;ACC;SPEC;MASC;PL
عابِث	العابِثات	ADJ;DEF;FEM;PL;PSSD
صالُون	صالُونا	N;NHUM;NOM;MASC;DU;PSSD
بِساط	بُسُط	N;NHUM;INDF;MASC;PL
فَصاحَة	الفَصاحَةُ	N;NHUM;NOM;DEF;FEM;SG
لِيبِيرِيّ	لِبِيرِيَّيْنِ	ADJ;ACC;INDF;MASC;DU
مُشَرِّف	المُشَرِّفَة	ADJ;DEF;FEM;SG;PSSD
تِلْقائِيّ	التِّلْقائِيَّ	ADJ;ACC;DEF;MASC;SG
بُزّ	بُزّاً	N;NHUM;ACC;INDF;MASC;SG
مُكَلِّف	المُكَلِّفات	ADJ;DEF;FEM;PL
جَلِيس	جَلِيساتٍ	N;HUM;GEN;INDF;FEM;PL
شارِد	شارِدَتَيْ	N;NHUM;ACC;SPEC;FEM;DU
إِسْهاب	إِسْهاباتِ	N;NHUM;ACC;SPEC;MASC;PL
رَفِيق	الرِّفاقِ	N;HUM;GEN;DEF;MASC;PL
ٱِئْتِمان	اِئْتِمانَيْنِ	N;NHUM;GEN;INDF;MASC;DU
نَدَى	أَنْداءُ	N;NHUM;NOM;SPEC;MASC;PL
هانِئ	الهانِئَةَ	ADJ;ACC;DEF;FEM;SG;PSSD
مَفْهُوم	المَفْهُومَيْ	N;NHUM;ACC;DEF;MASC;DU
بَرازِيلِيّ	بَرازِيلِيِّي	N;HUM;ACC;MASC;PL;PSSD
مُفَوَّه	مُفَوَّهَتانِ	ADJ;NOM;SPEC;FEM;DU
غَيْرِيّ	غَيْرِيَّ	ADJ;ACC;SPEC;MASC;SG
أَسْفَل	أَسْفَلُ	ADJ;NOM;CMPR;INDF;FEM;PL
مَصاعِب	مَصاعِبَ	N;NHUM;ACC;INDF;MASC;PL
لاحِق	لاحِقَتَيْ	ADJ;ACC;FEM;DU;PSSD
تَشَدَّق	تَشَدَّقْتُم	V;PFV;MASC;IND;PL;2;ACT
مُعَيَّن	مُعَيَّنَة	ADJ;FEM;SG;PSSD
طَفِيف	الطَّفِيفَيْنِ	ADJ;GEN;DEF;MASC;DU
إِسْتَرْلِينِيّ	إِسْتَرْلِينِيَّتَيْنِ	ADJ;GEN;INDF;FEM;DU
كَبْح	كَبْحُ	N;NHUM;NOM;SPEC;MASC;SG
جازَف	يُجازِفْنَ	V;IPFV;FEM;PL;3;ACT
مَدْفُون	المَدْفُونَةَ	ADJ;ACC;DEF;FEM;SG;PSSD
وَزِير	وَزِيرَتَيْ	N;HUM;GEN;FEM;DU;PSSD
جَبَل	يَجْبُلُونَ	V;IPFV;MASC;IND;PL;3;ACT
ٱِنْضِغاط	اِنْضِغاطٍ	N;NHUM;GEN;INDF;MASC;SG
مُتَجَدِّد	المُتَجَدِّد	ADJ;DEF;MASC;SG;PSSD
عَجُوز	العَجُوزَ	ADJ;ACC;DEF;MASC;SG
مُزْمَع	مُزْمَعَ	ADJ;ACC;SPEC;MASC;SG
فَكَّك	تُفَكِّكَ	V;IPFV;MASC;SBJV;SG;2;ACT
رَدّ	رَدَّتانِ	N;NHUM;NOM;INDF;FEM;DU
حَيَوان	حَيَوانِ	N;NHUM;GEN;SPEC;MASC;SG
أَنْدَر	أَنْدَرَ	ADJ;ACC;CMPR;INDF;FEM;SG
ساذِج	ساذِجَيْنِ	ADJ;GEN;INDF;MASC;DU
ٱِنْتِشال	اِنْتِشالاتِ	N;NHUM;ACC;SPEC;MASC;PL
عَجُوز	عَجائِزُ	N;HUM;NOM;INDF;MASC;PL
مُخْتار	مُخْتارَتَيْنِ	N;HUM;GEN;INDF;FEM;DU
مَطّاط	مَطّاطَتَيْنِ	N;NHUM;ACC;INDF;FEM;DU
مَدْخَل	مَدْخَلَ	N;NHUM;ACC;SPEC;MASC;SG
مُعْتاد	مُعْتادا	N;NHUM;NOM;MASC;DU;PSSD
مَأْسَوِيّ	المَأْسَوِيُّونَ	ADJ;NOM;DEF;MASC;PL
تَسْوِيَة	التَّسْوِيَةَ	N;NHUM;ACC;DEF;FEM;SG
أَدْفَأ	نُدْفَأُ	V;IPFV;IND;PL;1;PASS
سَيِّئَة	سَيِّئات	N;NHUM;INDF;FEM;PL
مُنْدَسّ	المُنْدَسِّ	ADJ;GEN;DEF;MASC;SG;PSSD
وَصْفِيّ	الوَصْفِيِّينَ	ADJ;ACC;DEF;MASC;PL
هَمَّش	تُهَمِّشْنَ	V;IPFV;FEM;PL;2;ACT
ٱِعْتَمَر	يَعْتَمِرُونَ	V;IPFV;MASC;IND;PL;3;ACT
لِيف	أَلْيافُ	N;NHUM;NOM;MASC;PL;PSSD
أَيْضِيّ	أَيْضِيَّتانِ	ADJ;NOM;INDF;FEM;DU
لَغْم	أَلْغاماً	N;NHUM;ACC;INDF;MASC;PL
بَصَم	يَبْصُمانِ	V;IPFV;MASC;IND;DU;3;ACT
جَلِيس	جُلَساءِ	N;HUM;GEN;SPEC;MASC;PL
تَدَهْوَر	تَتَدَهْوَرا	V;IPFV;FEM;DU;3;ACT
طَعْنَة	طَعْنَتَيْ	N;NHUM;GEN;SPEC;FEM;DU
ٱِسْتَحْضَر	اِسْتَحْضَرْتِ	V;PFV;FEM;IND;SG;2;ACT
مُتَراكِم	المُتَراكِم	ADJ;DEF;MASC;SG;PSSD
مِسَرَّة	مِسَرَّة	N;NHUM;FEM;SG;PSSD
مُسْتَخْدَم	مُسْتَخْدَمَيْنِ	ADJ;GEN;INDF;MASC;DU
مُضْطَهِد	المُضْطَهِدَتا	ADJ;NOM;DEF;FEM;DU;PSSD
مُتَطَوِّع	مُتَطَوِّعَة	ADJ;FEM;SG;PSSD
مَصْحُوب	المَصْحُوبَةِ	ADJ;GEN;DEF;FEM;SG
مُغَنِّي	مُغَنِّياتِ	N;HUM;GEN;SPEC;FEM;PL
مُرافَعَة	المُرافَعاتِ	N;NHUM;ACC;DEF;FEM;PL
صَلِيبِيّ	صَلِيبِيَّةٍ	N;HUM;GEN;INDF;FEM;SG
مُعَبَّد	مُعَبَّدُ	ADJ;NOM;SPEC;MASC;SG
ٱِشْتَكَى	يَشْتَكِيا	V;IPFV;MASC;DU;3;ACT
أَباح	أُبِحْ	V;IPFV;JUS;SG;1;ACT
جَوْهَر	جَوْهَرَة	N;NHUM;FEM;SG;PSSD
دَقِيقَة	دَقِيقَةِ	N;NHUM;GEN;FEM;SG;PSSD
كُورِيّ	الكُورِيّا	N;HUM;NOM;DEF;MASC;DU
تَعْمِيم	تَعْمِيماتُ	N;NHUM;NOM;MASC;PL;PSSD
ٱِقْتَرَف	تَقْتَرِفُونَ	V;IPFV;MASC;IND;PL;2;ACT
تَخْفِيض	تَخْفِيضٌ	N;NHUM;NOM;INDF;MASC;SG
لِسانِيّات	لِسانِيّاتُ	N;NHUM;NOM;SPEC;FEM;SG
مُؤَقَّت	مُؤَقَّتَيْ	ADJ;ACC;MASC;DU;PSSD
مَلّاك	المَلّاكات	N;HUM;DEF;FEM;PL
مَوْضُوع	مَوْضُوعَةٍ	ADJ;GEN;INDF;FEM;SG
مُشَوَّه	مُشَوَّهِ	ADJ;GEN;MASC;SG;PSSD
مَسْرُور	مَسْرُورَة	ADJ;SPEC;FEM;SG
مَسار	مَساراتِ	N;NHUM;GEN;MASC;PL;PSSD
ٱِحْتِرازِيّ	اِحْتِرازِيّانِ	ADJ;NOM;INDF;MASC;DU
أَسْمَع	يُسْمَعُ	V;IPFV;MASC;IND;SG;3;PASS
أَخِصّائِيّ	الأَخِصّائِيّاتُ	ADJ;NOM;DEF;FEM;PL;PSSD
رَفَد	يَرْفِدُ	V;IPFV;MASC;IND;SG;3;ACT
سُلالَة	سُلالَتَيْ	N;NHUM;ACC;FEM;DU;PSSD
تَكْذِيب	تَكْذِيب	N;NHUM;INDF;MASC;SG
خالِق	خالِقَتانِ	N;HUM;NOM;SPEC;FEM;DU
أَعار	أُعارَ	V;IPFV;SBJV;SG;1;PASS
عاوِز	عاوِزَتَيْ	ADJ;ACC;FEM;DU;PSSD
مُبْهَم	مُبْهَمات	N;NHUM;INDF;FEM;PL
مُسْتَخْدَم	مُسْتَخْدَمَةُ	ADJ;NOM;FEM;SG;PSSD
دَرَك	دَرَك	N;NHUM;INDF;MASC;SG
مَشْعَر	مَشْعَر	N;NHUM;INDF;MASC;SG
تَبَقَّى	تَبَقَّيْتِ	V;PFV;FEM;IND;SG;2;ACT
سُودانِيّ	سُودانِيَّة	ADJ;SPEC;FEM;SG
فُكاهَة	الفُكاهَةُ	N;NHUM;NOM;DEF;FEM;SG
مُتَخاذِل	المُتَخاذِل	ADJ;DEF;MASC;SG
مَمْجُوج	مَمْجُوجِي	ADJ;GEN;MASC;PL;PSSD
شَتات	الشَّتِيتَةُ	ADJ;NOM;DEF;FEM;SG
راغِب	الرّاغِبِي	ADJ;GEN;DEF;MASC;PL;PSSD
مُرْسَل	المُرْسَل	ADJ;DEF;MASC;SG;PSSD
نِيابِيّ	النِّيابِيّ	ADJ;DEF;MASC;SG;PSSD
مُحَقِّق	مُحَقِّقَيْنِ	ADJ;GEN;INDF;MASC;DU
ٱِنْتَظَر	تَنْتَظِرَ	V;IPFV;MASC;SBJV;SG;2;ACT
نَمَطِيّ	نَمَطِيّاتٍ	ADJ;ACC;INDF;FEM;PL
مُرْتَكِز	مُرْتَكِزِي	ADJ;ACC;SPEC;MASC;PL
أَحْسَن	الأَحْسَنا	ADJ;NOM;CMPR;DEF;MASC;PL
مُتَواكِب	مُتَواكِبَتَيْ	ADJ;ACC;SPEC;FEM;DU
ٱِنْتِهاز	الاِنْتِهازَ	N;NHUM;ACC;DEF;MASC;SG
مُفَوَّض	مُفَوَّضاتُ	N;HUM;NOM;SPEC;FEM;PL
مَكَّن	تُمَكِّنانِ	V;IPFV;MASC;IND;DU;2;ACT
مُخْتَلّ	مُخْتَلَّتَيْ	ADJ;ACC;SPEC;FEM;DU
تَعْرِفَة	تَعْرِفَتانِ	N;NHUM;NOM;SPEC;FEM;DU
قَناعَة	قَناعَة	N;NHUM;FEM;SG;PSSD
مُصَفَّحَة	المُصَفَّحَةُ	N;NHUM;NOM;DEF;FEM;SG
دَوْلِيّ	الدَّوْلِيَّتَيْ	ADJ;ACC;DEF;FEM;DU;PSSD
دَرّاجَة	دَرّاجَتَيْ	N;NHUM;GEN;FEM;DU;PSSD
مُساواة	مُساواةِ	N;NHUM;GEN;FEM;SG;PSSD
إِخْلال	إِخْلالَيْ	N;NHUM;GEN;SPEC;MASC;DU
عازِم	العازِمُ	ADJ;NOM;DEF;MASC;SG
نُبُوءَة	نُبُوءات	N;NHUM;INDF;FEM;PL
ثُمالَة	ثُمالَتانِ	N;NHUM;NOM;INDF;FEM;DU
مُودَع	المُودَعَة	ADJ;DEF;FEM;SG
كِيان	كِيانَيْنِ	N;NHUM;ACC;INDF;MASC;DU
لابَس	أُلابِسْ	V;IPFV;JUS;SG;1;ACT
مُمْطِر	مُمْطِرَةُ	N;NHUM;NOM;SPEC;FEM;SG
ٱِسْتَعاد	يُسْتَعادُ	V;IPFV;MASC;IND;SG;3;PASS
تَعِب	يَتْعَبْ	V;IPFV;MASC;JUS;SG;3;ACT
مُهاجَرَة	المُهاجَرَتانِ	N;NHUM;NOM;DEF;FEM;DU
غَرِيب	غَرِيبَتَيْ	N;HUM;GEN;SPEC;FEM;DU
مَمْلَكَة	مَمْلَكَتَيْنِ	N;NHUM;ACC;INDF;FEM;DU
نادِر	نادِرِينَ	ADJ;ACC;INDF;MASC;PL
مُتَعَنِّت	مُتَعَنِّتا	ADJ;NOM;SPEC;MASC;DU
لاسامِيّ	لاسامِيّاتٍ	ADJ;GEN;INDF;FEM;PL
إِسْتِقْواء	إِسْتِقْواءاتِ	N;NHUM;ACC;SPEC;MASC;PL
مُضِيف	مُضِيفَةِ	N;HUM;GEN;SPEC;FEM;SG
مُوَرِّث	مُوَرِّثَةِ	N;HUM;GEN;FEM;SG;PSSD
مُنْهِي	مُنْهِياً	ADJ;ACC;INDF;MASC;SG
ثَلْجِيّ	الثَّلْجِيِّي	ADJ;GEN;DEF;MASC;PL;PSSD
مُسْتَشار	مُسْتَشارَة	N;HUM;SPEC;FEM;SG
مَيْؤُوس	مَيْؤُوسُو	ADJ;NOM;SPEC;MASC;PL
برُوتُون	برُوتُوناتُ	N;NHUM;NOM;SPEC;MASC;PL
خِذْلان	الخِذْلانِ	N;NHUM;GEN;DEF;MASC;SG
ٱِبْتاع	يَبْتَعْ	V;IPFV;MASC;JUS;SG;3;ACT
دَقَّة	دَقَّةِ	N;NHUM;GEN;SPEC;FEM;SG
مُسِيء	مُسِيئَة	ADJ;INDF;FEM;SG
أُكْسِجِين	الأُكْسِجِينَ	N;NHUM;ACC;DEF;MASC;SG
خَشَب	خَشَبَتَيْ	N;NHUM;ACC;FEM;DU;PSSD
نَشَد	نَشَدْتَ	V;PFV;MASC;IND;SG;2;ACT
مُتَّجِه	مُتَّجِهَيْنِ	N;NHUM;ACC;INDF;MASC;DU
فَنّان	فَنّانَةِ	N;HUM;GEN;SPEC;FEM;SG
ظَلُوم	ظَلُومَتا	ADJ;NOM;FEM;DU;PSSD
مُثَقَّف	مُثَقَّفَةَ	N;HUM;ACC;SPEC;FEM;SG
مُشْرِك	مُشْرِكانِ	N;HUM;NOM;INDF;MASC;DU
جُنْدِيّ	الجُنُود	N;HUM;DEF;MASC;PL
صَهْيُونِيّ	الصَّهايِنَةُ	ADJ;NOM;DEF;MASC;PL
ٱِكْتِساب	اِكْتِسابات	N;NHUM;MASC;PL;PSSD
تَضَرَّر	تَضَرَّرْتُما	V;PFV;MASC;IND;DU;2;ACT
باراغُوائِيّ	باراجُوائِيّات	ADJ;INDF;FEM;PL
أَرْهَق	أُرْهَقُ	V;IPFV;IND;SG;1;PASS
وَشَّى	تُوَشِّينَ	V;IPFV;FEM;IND;SG;2;ACT
أَيْدِيُولُوجِيّ	الإِدْيُولُوجِيَّيْ	ADJ;ACC;DEF;MASC;DU;PSSD
جائِز	جائِزَةَ	ADJ;ACC;FEM;SG;PSSD
ٱِسْتِشْفاء	الاِسْتِشْفاءاتِ	N;NHUM;ACC;DEF;MASC;PL
شارِي	شارِيَيْ	N;HUM;ACC;MASC;DU;PSSD
بَطْرِيَرْكِيّ	بَطْرِيَرْكِيّات	ADJ;INDF;FEM;PL
ٱِسْتَهْزَأ	تَسْتَهْزِئا	V;IPFV;MASC;DU;2;ACT
إِمْبِراطُورِيّ	أَمْبِراطُورِيّات	ADJ;SPEC;FEM;PL
مُقْتَبَس	مُقْتَبَسٌ	ADJ;NOM;INDF;MASC;SG
أَفْضَل	الأَفْضَل	ADJ;CMPR;DEF;MASC;SG
ٱِقْتَنَع	تَقْتَنِعانِ	V;IPFV;FEM;IND;DU;3;ACT
مَزْعُوم	مَزْعُومَيْ	ADJ;ACC;MASC;DU;PSSD
ٱِسْتِقْراء	اِسْتِقْراءَيْ	N;NHUM;GEN;MASC;DU;PSSD
طَيَّة	طَيّاتٍ	N;NHUM;ACC;INDF;FEM;PL
خُلُوّ	خُلُوِّ	N;NHUM;GEN;MASC;SG;PSSD
ماهِر	ماهِرَةِ	ADJ;GEN;FEM;SG;PSSD
مِقْلاع	مَقالِيعَ	N;NHUM;ACC;SPEC;MASC;PL
بَقاء	البَقاءَ	N;NHUM;ACC;DEF;MASC;SG
مُحَرِّر	مُحَرِّرَةً	N;HUM;ACC;INDF;FEM;SG
قَدَر	قَدَرَ	N;NHUM;ACC;SPEC;MASC;SG
قِرَّة	قِرَّةٌ	N;NHUM;NOM;INDF;FEM;SG
فَرْعِيّ	الفَرْعِيَّةَ	ADJ;ACC;DEF;FEM;SG
أَساء	أَسَأْتِ	V;PFV;FEM;IND;SG;2;ACT
حَذِر	حَذِرٍ	ADJ;GEN;INDF;MASC;SG
مُمْتَلَك	مُمْتَلَكَتَيْ	ADJ;GEN;SPEC;FEM;DU
مُخَصِّب	المُخَصِّبَتا	ADJ;NOM;DEF;FEM;DU;PSSD
عاتِي	العُتاة	ADJ;DEF;MASC;PL;PSSD
أُوكرانِيّ	أُوكرانِيَّةُ	ADJ;NOM;SPEC;FEM;SG
حافَّة	حافَّةِ	N;NHUM;GEN;SPEC;FEM;SG
مُسْتَبْعَد	مُسْتَبْعَداتٍ	N;NHUM;GEN;INDF;FEM;PL
مالِك	المالِكِينَ	ADJ;ACC;DEF;MASC;PL
أَدْنَى	أَدْنا	N;NHUM;INDF;MASC;SG
مُنْصَرِم	المُنْصَرِمَتَيْ	ADJ;ACC;DEF;FEM;DU;PSSD
غَزال	غَزالَةَ	N;NHUM;ACC;SPEC;FEM;SG
تَسْوِيق	التَّسْوِيقاتِ	N;NHUM;GEN;DEF;MASC;PL
هاجَر	هاجَرْتُ	V;PFV;IND;SG;1;ACT
كامِل	كامِلُ	ADJ;NOM;MASC;SG;PSSD
طائِر	طائِر	ADJ;INDF;MASC;SG
تَوْصِيل	تَوْصِيلَتَيْ	N;NHUM;ACC;FEM;DU;PSSD
غَدِق	غَدِقَتا	V;PFV;FEM;IND;DU;3;ACT
حَجّار	حَجّارانِ	N;HUM;NOM;INDF;MASC;DU
مُعْتَمِر	مُعْتَمِرٍ	N;HUM;GEN;INDF;MASC;SG
تَطَرُّق	تَطَرُّقُ	N;NHUM;NOM;MASC;SG;PSSD
رِثَّة	رِثَّةَ	N;NHUM;ACC;FEM;SG;PSSD
ٱِسْتَنْسَب	اِسْتَنْسَبَ	V;PFV;MASC;IND;SG;3;ACT
مُناسِب	المُناسِبَتَيْنِ	ADJ;ACC;DEF;FEM;DU
بُنْدُقِيَّة	بُنْدُقِيَّةِ	N;NHUM;GEN;FEM;SG;PSSD
ٱِسْتَخْرَج	اِسْتَخْرَجْتَ	V;PFV;MASC;IND;SG;2;ACT
أَوَّى	تُؤَوُّوا	V;IPFV;MASC;PL;2;ACT
مُتَحَدِّر	مُتَحَدِّراتُ	ADJ;NOM;SPEC;FEM;PL
سافِر	سافِرَةِ	ADJ;GEN;SPEC;FEM;SG
مُحَرَّم	مُحَرَّمَةِ	ADJ;GEN;FEM;SG;PSSD
ٱِرْتَعَى	اِرْتَعَوْا	V;PFV;MASC;IND;PL;3;ACT
تَفَكُّك	تَفَكُّكِ	N;NHUM;GEN;SPEC;MASC;SG
راكِد	الرّاكِدَةُ	ADJ;NOM;DEF;FEM;SG
جِيبُوتِيّ	جِيبُوتِيَّةٌ	ADJ;NOM;INDF;FEM;SG
مُعَلِّم	المُعَلِّمَتَيْ	N;HUM;ACC;DEF;FEM;DU
ٱِنْتِشال	اِنْتِشالَيْنِ	N;NHUM;ACC;INDF;MASC;DU
كَرْب	الكُرُوبُ	N;NHUM;NOM;DEF;MASC;PL
جائِر	جائِرٌ	N;NHUM;NOM;INDF;MASC;SG
وَسِيط	وُسَطاءَ	N;HUM;GEN;INDF;MASC;PL
لاجِئ	لاجِئُو	ADJ;NOM;MASC;PL;PSSD
مُزاوَجَة	مُزاوَجَتانِ	N;NHUM;NOM;SPEC;FEM;DU
ٱِقْتِصادِيّ	اِقْتِصادِيّات	N;HUM;SPEC;FEM;PL
وَفْدِيّ	الوَفْدِيَّ	ADJ;ACC;DEF;MASC;SG
ٱِسْتِكْمال	الاِسْتِكْمالُ	N;NHUM;NOM;DEF;MASC;SG
تارِيخِيّ	التّارِيخِيِّ	ADJ;GEN;DEF;MASC;SG;PSSD
خَيْمَة	خَيْمَة	N;NHUM;FEM;SG;PSSD
رَقَّى	يُرَقَّيْنَ	V;IPFV;FEM;PL;3;PASS
رِوِش	الرِّوِش	ADJ;DEF;MASC;SG;PSSD
قَبِل	قَبِلَت	V;PFV;FEM;IND;SG;3;ACT
مَدْسُوس	مَدْسُوسَتَيْ	ADJ;GEN;FEM;DU;PSSD
آذَن	تُؤْذِنُ	V;IPFV;MASC;IND;SG;2;ACT
مَرْتَع	مَرْتَعَيْ	N;NHUM;ACC;SPEC;MASC;DU
نَحْل	نَحْلَتَيْ	N;NHUM;ACC;FEM;DU;PSSD
مُونْدِيالِيّ	المُونْدِيالِيُّ	N;NHUM;NOM;DEF;MASC;SG
مُقَنَّن	المُقَنَّنُ	ADJ;NOM;DEF;MASC;SG;PSSD
ٱِسْتِشارَة	اِسْتِشاراتُ	N;NHUM;NOM;FEM;PL;PSSD
مُحَقِّق	مُحَقِّقِينَ	N;HUM;GEN;INDF;MASC;PL
عَناء	العَناءِ	N;NHUM;GEN;DEF;MASC;SG
أَيْقَن	أَيْقَنْتُم	V;PFV;MASC;IND;PL;2;ACT
مُؤَخَّر	مُؤَخَّراً	ADJ;ACC;INDF;MASC;SG
تَلاقَى	تَلاقَيْتُ	V;PFV;IND;SG;1;ACT
غُبار	غُبارُ	N;NHUM;NOM;SPEC;MASC;SG
ذَكَر	نَذْكُرُ	V;IPFV;IND;PL;1;ACT
أَخْذ	أَخْذٍ	N;NHUM;GEN;INDF;MASC;SG
تَدْقِيق	تَدْقِيقات	N;NHUM;INDF;MASC;PL
واعِي	واعِيَةً	ADJ;ACC;INDF;FEM;SG
تَلَبُّس	تَلَبُّسات	N;NHUM;SPEC;MASC;PL
هالِك	هالِكا	ADJ;NOM;MASC;DU;PSSD
مُلَقَّح	المُلَقَّحَةِ	ADJ;GEN;DEF;FEM;SG
شَهِيد	الشَّهِيدِ	N;HUM;GEN;DEF;MASC;SG
مُسَلَّم	مُسَلَّمَتَيْ	ADJ;GEN;FEM;DU;PSSD
إِجْبارِيّ	إِجْبارِيّا	ADJ;NOM;MASC;DU;PSSD
أُرْثُودُكسِيّ	الأُرْثُودُكسَ	N;HUM;ACC;DEF;MASC;SG
أَرْتُوازِيّ	أَرْتُوازِيَّةَ	ADJ;ACC;SPEC;FEM;SG
يُونانِيّ	يُونانِيَّةٌ	ADJ;NOM;INDF;FEM;SG
ٱِعْتِدائِيّ	اِعْتِدائِيِّينَ	ADJ;GEN;INDF;MASC;PL
مُتَقاتِل	مُتَقاتِلَتَيْنِ	ADJ;GEN;INDF;FEM;DU
أَيْرلَنْدِيّ	الإِرْلَنْدِيَّيْ	ADJ;GEN;DEF;MASC;DU;PSSD
ٱِسْتِمْساك	الاِسْتِمْساكاتُ	N;NHUM;NOM;DEF;MASC;PL
أَتْقَن	نُتْقِنُ	V;IPFV;IND;PL;1;ACT
مُنْكَبّ	المُنْكَبُّونَ	ADJ;NOM;DEF;MASC;PL
ٱِسْتِوائِيّ	اِسْتِوائِيَّة	ADJ;INDF;FEM;SG
مُعْطَى	مُعْطاةِ	N;NHUM;GEN;FEM;SG;PSSD
زُجاجَة	زُجاجَتَيْنِ	N;NHUM;ACC;INDF;FEM;DU
رَأْسمال	راسْمالُ	N;NHUM;NOM;MASC;SG;PSSD
باطِن	الباطِناتُ	ADJ;NOM;DEF;FEM;PL
لاحَرْب	لاحَرْبُ	N;NHUM;NOM;SPEC;MASC;SG
وَحْش	الوَحْشَ	N;NHUM;ACC;DEF;MASC;SG
عاطِل	العاطِلَتانِ	ADJ;NOM;DEF;FEM;DU
أَبار	يُبِيرُ	V;IPFV;MASC;IND;SG;3;ACT
نات	نُتَّ	V;PFV;MASC;IND;SG;2;ACT
مَهْزُوز	مَهْزُوزَةٌ	ADJ;NOM;INDF;FEM;SG
رَقِيق	رَقِيقاتِ	ADJ;ACC;SPEC;FEM;PL
ٱِسْتَوْرَد	تَسْتَوْرِدا	V;IPFV;FEM;DU;3;ACT
قَفَز	تَقْفِزِينَ	V;IPFV;FEM;IND;SG;2;ACT
مَحْرُوق	مَحْرُوقِ	ADJ;GEN;MASC;SG;PSSD
أَعْطَى	أَعْطَيا	V;PFV;MASC;IND;DU;3;ACT
جُمْهُورِيَّة	جُمْهُورِيّاتُ	N;NHUM;NOM;SPEC;FEM;PL
كاسِح	كاسِحَةِ	ADJ;GEN;SPEC;FEM;SG
طَبّال	طَبّالَتا	N;HUM;NOM;FEM;DU;PSSD
عِبْرِيّ	عِبْرِيَّيْنِ	N;HUM;ACC;INDF;MASC;DU
شاغِل	شاغِلاتِ	ADJ;GEN;SPEC;FEM;PL
مَلْعُون	المَلاعِين	ADJ;DEF;MASC;SG;PSSD
مُصِرّ	المُصِرَّتَيْنِ	ADJ;ACC;DEF;FEM;DU
مُجَفَّف	مُجَفَّفِينَ	ADJ;ACC;INDF;MASC;PL
مُحايِد	مُحايِدِي	ADJ;ACC;MASC;PL;PSSD
مَلْعُون	مَلْعُونَيْنِ	ADJ;GEN;INDF;MASC;DU
غَرِيزَة	غَرِيزَةً	N;NHUM;ACC;INDF;FEM;SG
فاتُورَة	الفاتُورَتَيْ	N;NHUM;ACC;DEF;FEM;DU
تَخْوِيل	تَخْوِيلاتِ	N;NHUM;ACC;SPEC;MASC;PL
مُبْتَذَل	المُبْتَذَلَيْ	N;NHUM;ACC;DEF;MASC;DU
رَزَّز	تُرَزِّزْنَ	V;IPFV;FEM;PL;2;ACT
طابُور	طابُورَيْنِ	N;NHUM;GEN;INDF;MASC;DU
مُرَكَّب	مُرَكَّبَةِ	ADJ;GEN;SPEC;FEM;SG
جَمّال	جَمّالاتِ	N;HUM;GEN;SPEC;FEM;PL
شَرْم	شَرْمَيْنِ	N;NHUM;GEN;INDF;MASC;DU
مَحْكِيّ	المَحْكِيُّونَ	ADJ;NOM;DEF;MASC;PL
مُفْجِع	المُفْجِعَتَيْنِ	ADJ;GEN;DEF;FEM;DU
بِرْقِش	البَراقِشَ	N;NHUM;ACC;DEF;MASC;PL
نَمُوذَجِيّ	النَّمُوذَجِيّاتُ	ADJ;NOM;DEF;FEM;PL;PSSD
مَرِن	مَرِنَ	ADJ;ACC;SPEC;MASC;SG
أَقَلّ	يُقِلُّ	V;IPFV;MASC;IND;SG;3;ACT
تَسَلَّل	يَتَسَلَّلُ	V;IPFV;MASC;IND;SG;3;ACT
بَدَوِيّ	بَدَوِيَّتَيْ	ADJ;GEN;SPEC;FEM;DU
شارِح	الشّارِحَيْ	ADJ;ACC;DEF;MASC;DU;PSSD
ٱِتِّفاقِيّ	الاِتِّفاقِيّا	ADJ;NOM;DEF;MASC;DU;PSSD
مُخْجِل	مُخْجِلَةُ	ADJ;NOM;FEM;SG;PSSD
ساعِد	السّاعِدَةُ	ADJ;NOM;DEF;FEM;SG
مُبالَغ	المُبالَغِ	ADJ;GEN;DEF;MASC;SG;PSSD
مُبالاة	مُبالاةٌ	N;NHUM;NOM;INDF;FEM;SG
مُؤْلِم	مُؤْلِمَة	ADJ;SPEC;FEM;SG
أَيْض	أَيْضِ	N;NHUM;GEN;MASC;SG;PSSD
إِحْتِكام	إِحْتِكامِي	N;NHUM;ACC;MASC;PL;PSSD
أَرْمَنِيّ	الأَرْمَن	ADJ;DEF;MASC;PL;PSSD
ٱِحْتِفاء	اِحْتِفاءا	N;NHUM;NOM;SPEC;MASC;DU
قابِض	القابِضَتا	ADJ;NOM;DEF;FEM;DU;PSSD
تَرْهِيب	تَرْهِيبَيْ	N;NHUM;ACC;MASC;DU;PSSD
سِيجارَة	سِجارَةً	N;NHUM;ACC;INDF;FEM;SG
مُخَنَّث	مُخَنَّثات	ADJ;FEM;PL;PSSD
ٱِسْتَهْوَى	اِسْتَهْوَتا	V;PFV;FEM;IND;DU;3;ACT
تَكَبُّد	التَّكَبُّداتِ	N;NHUM;GEN;DEF;MASC;PL
مُثْمِر	مُثْمِرُ	ADJ;NOM;MASC;SG;PSSD
مَحْظُور	مَحْظُوراتِ	ADJ;GEN;FEM;PL;PSSD
حَكِيم	حَكِيمَةَ	ADJ;ACC;FEM;SG;PSSD
نام	ناما	V;PFV;MASC;IND;DU;3;ACT
حَذِر	الحَذِراتِ	ADJ;ACC;DEF;FEM;PL
تاجِر	تُجّار	N;HUM;INDF;MASC;PL
عِدَة	العِدَتَيْ	N;NHUM;ACC;DEF;FEM;DU
ناصِح	النّاصِحَتَيْ	ADJ;GEN;DEF;FEM;DU;PSSD
حَلِيف	حَلِيفِ	N;HUM;GEN;SPEC;MASC;SG
ٱِحْتَجَز	يَحْتَجِزانِ	V;IPFV;MASC;IND;DU;3;ACT
ٱِسْتِلْهام	اِسْتِلْهامات	N;NHUM;INDF;MASC;PL
إِغاثِيّ	إِغاثِيَّيْ	ADJ;GEN;MASC;DU;PSSD
مَحْض	المَحْضُ	N;NHUM;NOM;DEF;MASC;SG
مُوَقِّت	المُوَقِّتِي	ADJ;GEN;DEF;MASC;PL;PSSD
شَرْطِيّ	شَرْطِيَّةُ	ADJ;NOM;SPEC;FEM;SG
طَبْعَة	الطَّبْعَة	N;NHUM;DEF;FEM;SG
تَقْنِيَّة	التَّقْنِيّاتُ	N;NHUM;NOM;DEF;FEM;PL
زَوَر	الزَّوَرِ	N;NHUM;GEN;DEF;MASC;SG
دِرامِيّ	دِرامِيّاتِ	ADJ;GEN;SPEC;FEM;PL
رُكْنِيّ	رُكْنِيَّة	ADJ;INDF;FEM;SG
يُوان	اليُوانَ	N;NHUM;ACC;DEF;MASC;SG
جَلْجَلَة	الجَلْجَلَةَ	N;NHUM;ACC;DEF;FEM;SG
حَوَّل	نُحَوِّلَ	V;IPFV;SBJV;PL;1;ACT
بَغِيّ	البَغِيّا	N;HUM;NOM;DEF;FEM;DU
تَجْرِيف	تَجْرِيفَ	N;NHUM;ACC;MASC;SG;PSSD
مُتَفاقِم	مُتَفاقِمَةِ	ADJ;GEN;SPEC;FEM;SG
فاهِم	الفاهِمَيْ	N;HUM;GEN;DEF;MASC;DU
ٱِسْتِعْدادِيّ	اِسْتِعْدادِيِّينَ	ADJ;ACC;INDF;MASC;PL
أَطْرَش	طُرْشِ	ADJ;GEN;MASC;PL;PSSD
قَطَن	تَقْطُنَ	V;IPFV;MASC;SBJV;SG;2;ACT
نَوْط	نِياطَ	N;NHUM;ACC;SPEC;MASC;PL
مُتَذَكِّر	المُتَذَكِّرَ	ADJ;ACC;DEF;MASC;SG;PSSD
مُنْدَمِج	مُنْدَمِجَةَ	ADJ;ACC;FEM;SG;PSSD
إِجْهاز	إِجْهازٌ	N;NHUM;NOM;INDF;MASC;SG
أَسَرّ	يُسِرَّ	V;IPFV;MASC;JUS;SG;3;ACT
وَتَر	أَوْتارٌ	N;NHUM;NOM;INDF;MASC;PL
مُزْدَوِج	المُزْدَوِجاتِ	ADJ;ACC;DEF;FEM;PL
إِخْبارِيّ	الإِخْبارِيِّينَ	ADJ;GEN;DEF;MASC;PL
إِجْمالِيّ	إِجْمالِيّات	N;NHUM;SPEC;FEM;PL
تَخْوِيل	تَخْوِيلَيْنِ	N;NHUM;GEN;INDF;MASC;DU
عَزِيز	عَزِيزَتانِ	ADJ;NOM;INDF;FEM;DU
زَعْلان	الزَّعْلانَتَيْ	ADJ;GEN;DEF;FEM;DU;PSSD
جَفاء	جَفاءً	N;NHUM;ACC;INDF;MASC;SG
مُتَوَفِّر	مُتَوَفِّرَةَ	ADJ;ACC;SPEC;FEM;SG
مُشْتَرَك	المُشْتَرَكُ	ADJ;NOM;DEF;MASC;SG
