schossfest	schossfestes	ADJ;ACC;NEUT;SG
Spießer	Spießern	N;DAT;MASC;PL
verarbeiten	verarbeitete	V;IND;SG;3;PST
Endzweck	Endzwecke	N;ACC;PL
Querflöte	Querflöte	N;ACC;SG
Abfahrt	Abfahrten	N;ACC;PL
Glasur	Glasur	N;DAT;SG
fischen	fischte	V;SBJV;SG;1;PST
bestreiten	bestreitest	V;IND;SG;2;PRS
Gurgel	Gurgel	N;ACC;FEM;SG
karjolen	karjole	V;IND;SG;1;PRS
eignen	eigneten	V;SBJV;PL;3;PST
Dränage	Dränagen	N;NOM;PL
Match	Matche	N;GEN;NEUT;PL
Kassenpatient	Kassenpatienten	N;NOM;PL
katalysieren	katalysierest	V;SBJV;SG;2;PRS
Übergriff	Übergriff	N;NOM;SG
aufkündigen	kündigte auf	V;SBJV;SG;1;PST
Reisetasche	Reisetaschen	N;GEN;FEM;PL
Extrem	Extreme	N;ACC;PL
einrosten	einzurosten	V;NFIN;LGSPEC01
läppern	läpperten	V;SBJV;PL;1;PST
Vieleck	Vielecke	N;GEN;PL
fassungslos	fassungslosen	ADJ;GEN;MASC;SG
Pest	Pest	N;NOM;SG
befinden	befindend	V.PTCP;PRS
undemokratisch	undemokratischer	ADJ;GEN;FEM;SG
legalisieren	legalisierten	V;IND;PL;1;PST
Vorderzungenvokal	Vorderzungenvokale	N;DAT;MASC;SG
ausrechnen	rechneten aus	V;SBJV;PL;1;PST
frühstücken	frühstücktet	V;IND;PL;2;PST
fettarm	fettarmen	ADJ;ACC;MASC;SG
gleichmachen	machen gleich	V;SBJV;PL;3;PRS
verhindern	verhinderten	V;IND;PL;3;PST
Beutelwolf	Beutelwölfe	N;ACC;PL
profitieren	profitiertest	V;IND;SG;2;PST
kriegsentscheidend	kriegsentscheidendem	ADJ;DAT;MASC;SG
Verletzlichkeit	Verletzlichkeit	N;GEN;FEM;SG
Kuschelkurs	Kuschelkurses	N;GEN;MASC;SG
Motorfuchsschwanz	Motorfuchsschwanz	N;DAT;MASC;SG
Pütt	Pütte	N;GEN;MASC;PL
Tank	Tank	N;DAT;MASC;SG
Pressluftbohrer	Pressluftbohrer	N;ACC;MASC;SG
Eindämmung	Eindämmungen	N;NOM;PL
patriarchalisch	patriarchalische	ADJ;NOM;PL
addieren	addierte	V;SBJV;SG;3;PST
Lichtbild	Lichtbilde	N;DAT;NEUT;SG
gemein	gemeine	ADJ;ACC;PL
erholsam	erholsamen	ADJ;GEN;MASC;SG
konsolidieren	konsolidierten	V;SBJV;PL;3;PST
wuchern	wucherten	V;SBJV;PL;1;PST
silikatreich	silikatreiche	ADJ;ACC;PL
verschmelzen	verschmolz	V;IND;SG;3;PST
Datenbankmodell	Datenbankmodelle	N;ACC;PL
Iodatom	Iodatom	N;ACC;SG
beaufsichtigen	beaufsichtiget	V;SBJV;PL;2;PRS
atypisch	atypischer	ADJ;NOM;MASC;SG
verpeilt	verpeilter	ADJ;CMPR
keifen	keifte	V;SBJV;SG;1;PST
Nürnberger	Nürnberger	N;ACC;SG
prachtvoll	prachtvolle	ADJ;ACC;FEM;SG
facebooken	facebook	V;IMP;SG;2
Donnerstagnachmittag	Donnerstagnachmittagen	N;DAT;PL
Energiegewinnung	Energiegewinnung	N;ACC;FEM;SG
Vene	Venen	N;ACC;FEM;PL
Marzipan	Marzipan	N;ACC;MASC+NEUT;SG
Eschatologie	Eschatologien	N;NOM;FEM;PL
Halseisen	Halseisen	N;NOM;NEUT;SG
transkribieren	transkribieren	V;IND;PL;3;PRS
verschleiern	verschleiertet	V;SBJV;PL;2;PST
Astronom	Astronom	N;NOM;SG
mummen	mummte	V;SBJV;SG;1;PST
Erektion	Erektion	N;DAT;SG
beerdigen	beerdigtest	V;SBJV;SG;2;PST
Sulfat	Sulfates	N;GEN;SG
zügeln	zügelest	V;SBJV;SG;2;PRS
Deich	Deiches	N;GEN;SG
südlich	südlicher	ADJ;DAT;FEM;SG
Linksverkehr	Linksverkehr	N;ACC;MASC;SG
Frivolität	Frivolitäten	N;ACC;FEM;PL
bandagieren	bandagiertet	V;SBJV;PL;2;PST
Geschwindigkeit	Geschwindigkeiten	N;DAT;PL
Maiskolben	Maiskolben	N;GEN;PL
heimkommen	heimgekommen	V.PTCP;PST
evangelisieren	evangelisiert	V;IND;SG;3;PRS
Differentialgleichung	Differentialgleichungen	N;DAT;FEM;PL
Exklusivmeldung	Exklusivmeldung	N;NOM;SG
vorbildlich	vorbildlichem	ADJ;DAT;MASC;SG
Wachtel	Wachteln	N;GEN;PL
Warteschleife	Warteschleife	N;GEN;FEM;SG
Tellurium	Tellurium	N;DAT;NEUT;SG
Kuguar	Kuguar	N;ACC;SG
kärntisch	kärntischem	ADJ;DAT;NEUT;SG
ortsunkundig	ortsunkundige	ADJ;ACC;PL
umtriebig	umtriebigen	ADJ;GEN;NEUT;SG
fleischig	fleischiger	ADJ;GEN;FEM;SG
schwerwiegend	schwerwiegendes	ADJ;ACC;NEUT;SG
jappen	jappten	V;SBJV;PL;3;PST
entwalden	entwaldet	V;IND;SG;3;PRS
Nanomotor	Nanomotors	N;GEN;MASC;SG
Gedankenspiel	Gedankenspiel	N;ACC;NEUT;SG
ausladen	lüden aus	V;SBJV;PL;1;PST
rüsten	rüsten	V;NFIN
Gaukler	Gaukler	N;ACC;MASC;SG
Hauptlinie	Hauptlinie	N;NOM;FEM;SG
denaturieren	denaturieren	V;IND;PL;1;PRS
kurbeln	kurbeln	V;NFIN
Knoblauchbrot	Knoblauchbrot	N;ACC;NEUT;SG
beschwören	beschwört	V;IMP;PL;2
Kartoffelchip	Kartoffelchips	N;GEN;SG
Überblick	Überblick	N;ACC;SG
zirkoniumhaltig	zirkoniumhaltiger	ADJ;NOM;MASC;SG
Lichtjahr	Lichtjahre	N;NOM;PL
wegfegen	weggefegt	V.PTCP;PST
Grotte	Grotte	N;NOM;FEM;SG
Triebkraft	Triebkräften	N;DAT;FEM;PL
Lebensgrundlage	Lebensgrundlagen	N;GEN;FEM;PL
Kaffeestube	Kaffeestuben	N;GEN;FEM;PL
Wattestäbchen	Wattestäbchen	N;DAT;PL
einnicken	nicken ein	V;SBJV;PL;1;PRS
lenken	lenkte	V;IND;SG;1;PST
abtropfen	tropften ab	V;SBJV;PL;3;PST
zeitsparend	zeitsparender	ADJ;CMPR
erbieten	erbiete	V;SBJV;SG;1;PRS
notleidend	notleidende	ADJ;ACC;PL
Wissenschaft	Wissenschaft	N;GEN;SG
vertheidigen	vertheidigten	V;IND;PL;1;PST
hinstellen	stelle hin	V;SBJV;SG;1;PRS
Übersetzerin	Übersetzerinnen	N;ACC;FEM;PL
Darstellerin	Darstellerin	N;ACC;FEM;SG
Diamantringeffekt	Diamantringeffekte	N;NOM;MASC;PL
Korund	Korund	N;ACC;MASC;SG
Lymphdrüse	Lymphdrüsen	N;DAT;PL
Ölteppich	Ölteppiche	N;ACC;MASC;PL
gelingen	gelingend	V.PTCP;PRS
Tartrat	Tartrats	N;GEN;SG
versagen	versage	V;SBJV;SG;3;PRS
Überzeugung	Überzeugung	N;NOM;SG
Pöbelherrschaft	Pöbelherrschaften	N;ACC;FEM;PL
Eierschale	Eierschalen	N;NOM;FEM;PL
kratzfest	kratzfeste	ADJ;NOM;PL
leidsam	leidsamer	ADJ;GEN;FEM;SG
metzeln	metzelest	V;SBJV;SG;2;PRS
Münchhausengeschichte	Münchhausengeschichten	N;ACC;FEM;PL
zuschneiden	schneide zu	V;SBJV;SG;3;PRS
angreifen	griffe an	V;SBJV;SG;1;PST
zweifeln	zweifelte	V;IND;SG;1;PST
Toupet	Toupets	N;GEN;NEUT;PL
markieren	markierte	V;SBJV;SG;3;PST
sprießen	sprießt	V;IND;SG;2;PRS
Fasan	Fasane	N;GEN;PL
überqueren	überquertest	V;SBJV;SG;2;PST
Grapefruitlöffel	Grapefruitlöffel	N;ACC;MASC;PL
fürchterlich	fürchterliche	ADJ;NOM;PL
Chloralken	Chloralkene	N;GEN;PL
Verelffachung	Verelffachungen	N;DAT;FEM;PL
Fresko	Freskos	N;GEN;NEUT;SG
Durchschnittseinkommen	Durchschnittseinkommen	N;NOM;NEUT;PL
Schläfer	Schläfer	N;NOM;MASC;PL
Gallat	Gallats	N;GEN;NEUT;SG
schwätzen	schwätzt	V;IND;SG;2;PRS
Investor	Investoren	N;DAT;PL
wichtigmachen	mache wichtig	V;IND;SG;1;PRS
Füßchen	Füßchen	N;DAT;PL
Kombinationsfeldchen	Kombinationsfeldchen	N;DAT;SG
Abrunden	Abrundens	N;GEN;NEUT;SG
Zierde	Zierde	N;ACC;FEM;SG
Kohlebürste	Kohlebürste	N;ACC;SG
betrachten	betrachtetest	V;SBJV;SG;2;PST
andocken	dockt an	V;IND;SG;3;PRS
essenziell	essenzielle	ADJ;NOM;PL
Nomade	Nomaden	N;DAT;MASC;PL
widerstandsfähig	widerstandsfähige	ADJ;NOM;FEM;SG
Katalase	Katalasen	N;ACC;PL
Zusammenbruch	Zusammenbrüche	N;GEN;PL
Sonnensegel	Sonnensegel	N;DAT;NEUT;SG
ermahnen	ermahnten	V;SBJV;PL;1;PST
Fruchtknoten	Fruchtknotens	N;GEN;SG
Giftgas	Giftgas	N;DAT;SG
schmerzempfindlich	schmerzempfindliche	ADJ;ACC;PL
tagen	tagt	V;IMP;PL;2
elend	elende	ADJ;NOM;FEM;SG
unbelebt	unbelebte	ADJ;NOM;FEM;SG
Sinn machen	machtet Sinn	V;IND;PL;2;PST
Blutrot	Blutrot	N;ACC;NEUT;SG
catholisch	catholischer	ADJ;GEN;PL
schlapp	schlappen	ADJ;GEN;NEUT;SG
entzücken	entzückten	V;SBJV;PL;3;PST
hartzen	hartzten	V;IND;PL;1;PST
niederknieen	knietet nieder	V;SBJV;PL;2;PST
Tetroxid	Tetroxid	N;NOM;SG
Feingehaltstempel	Feingehaltstempels	N;GEN;SG
Oberaufseherin	Oberaufseherinnen	N;GEN;FEM;PL
Archäologe	Archäologen	N;NOM;PL
Schneesturm	Schneestürme	N;GEN;MASC;PL
Quantenchemie	Quantenchemie	N;GEN;FEM;SG
Aula	Aulen	N;ACC;FEM;PL
bingen	bingen	V;NFIN
sündigen	sündigten	V;IND;PL;3;PST
aussenden	sandtest aus	V;IND;SG;2;PST
beatmen	beatmete	V;SBJV;SG;1;PST
aufhäufen	häufe auf	V;SBJV;SG;1;PRS
Vernebelung	Vernebelung	N;ACC;SG
kuschen	kuscht	V;IND;PL;2;PRS
Gradient	Gradienten	N;DAT;MASC;SG
Propellerflügel	Propellerflügel	N;DAT;MASC;SG
verfahren	verfahret	V;SBJV;PL;2;PRS
Genealoge	Genealogen	N;ACC;MASC;PL
Hoheit	Hoheit	N;NOM;SG
mundtot	mundtotes	ADJ;NOM;NEUT;SG
hinknien	kniest hin	V;IND;SG;2;PRS
Farn	Farne	N;ACC;MASC;PL
unmotiviert	unmotivierte	ADJ;NOM;FEM;SG
abblitzen	abgeblitzt	V.PTCP;PST
reagieren	reagierten	V;IND;PL;3;PST
Lanzenspitze	Lanzenspitze	N;GEN;FEM;SG
anpöbeln	pöbelest an	V;SBJV;SG;2;PRS
labeln	labelten	V;SBJV;PL;3;PST
Violinist	Violinist	N;NOM;SG
abnutzen	nutztest ab	V;SBJV;SG;2;PST
Automarke	Automarken	N;NOM;FEM;PL
empfehlen	empfehlen	V;NFIN
dahinschwinden	schwindet dahin	V;IMP;PL;2
überschlagen	schlüge über	V;SBJV;SG;3;PST
Isomorphismus	Isomorphismus	N;GEN;MASC;SG
grau	grauer	ADJ;NOM;MASC;SG
entstauben	entstaube	V;SBJV;SG;3;PRS
Zypresse	Zypressen	N;GEN;PL
Sentenz	Sentenzen	N;NOM;FEM;PL
Arbeitskamerad	Arbeitskameraden	N;GEN;MASC;SG
Shitstorm	Shitstorms	N;DAT;PL
Fehlschluss	Fehlschluss	N;DAT;SG
unersetzlich	unersetzlichem	ADJ;DAT;MASC;SG
Vorkosterin	Vorkosterinnen	N;NOM;PL
astrein	astreinen	ADJ;GEN;MASC;SG
heiter	heiteren	ADJ;GEN;NEUT;SG
Gesamtzahl	Gesamtzahl	N;DAT;FEM;SG
Nähmaschine	Nähmaschine	N;ACC;FEM;SG
Diadem	Diadem	N;NOM;NEUT;SG
bullig	bulligen	ADJ;GEN;MASC;SG
entsagen	entsagtet	V;SBJV;PL;2;PST
verkniffen	verkniffenes	ADJ;ACC;NEUT;SG
ausharren	harren aus	V;IND;PL;3;PRS
schauern	schauer	V;IMP;SG;2
ausmustern	musteret aus	V;SBJV;PL;2;PRS
verjubeln	verjubelnd	V.PTCP;PRS
durchsickern	sickerten durch	V;IND;PL;3;PST
handlungsunfähig	handlungsunfähigen	ADJ;GEN;NEUT;SG
pauken	pauktet	V;IND;PL;2;PST
Mietvertrag	Mietvertrag	N;ACC;MASC;SG
deklinieren	dekliniertet	V;IND;PL;2;PST
Manschette	Manschette	N;ACC;SG
Verschmäher	Verschmäher	N;DAT;MASC;SG
Frack	Frack	N;ACC;MASC;SG
ausschließen	schließt aus	V;IND;PL;2;PRS
abbiegen	bog ab	V;IND;SG;1;PST
Eintrag	Einträge	N;GEN;PL
unterschieben	schiebe unter	V;SBJV;SG;3;PRS
Grundstein	Grundsteine	N;GEN;MASC;PL
Depp	Depp	N;DAT;SG
Blattgrund	Blattgründe	N;ACC;MASC;PL
Hexan	Hexan	N;NOM;NEUT;SG
hinterherwerfen	hinterherwerfen	V;NFIN
zersplittern	zersplitterte	V;SBJV;SG;1;PST
mittelalterlich	mittelalterlichen	ADJ;GEN;MASC;SG
unmenschlich	unmenschlichen	ADJ;ACC;MASC;SG
lobbyieren	lobbyierte	V;IND;SG;1;PST
Währungsmetall	Währungsmetalle	N;GEN;PL
Doge	Dogen	N;ACC;SG
vertrauensvoll	vertrauensvolles	ADJ;NOM;NEUT;SG
korporatistisch	korporatistischer	ADJ;GEN;FEM;SG
klangvoll	am klangvollsten	ADJ;SPRL
verschränken	verschränke	V;SBJV;SG;1;PRS
schneesicher	schneesichere	ADJ;NOM;FEM;SG
Halter	Halter	N;NOM;MASC;PL
Schweif	Schweif	N;ACC;MASC;SG
umformen	formte um	V;IND;SG;3;PST
brüsk	brüsken	ADJ;DAT;PL
unsagbar	unsagbaren	ADJ;DAT;PL
risikoreich	risikoreichen	ADJ;ACC;MASC;SG
arg	argem	ADJ;DAT;MASC;SG
bleihaltig	bleihaltige	ADJ;NOM;FEM;SG
populistisch	populistischer	ADJ;GEN;PL
abschießen	schösse ab	V;SBJV;SG;1;PST
Quietscheentchen	Quietscheentchen	N;NOM;NEUT;PL
nennen	nannte	V;SBJV;SG;3;PST
gleichsetzen	setze gleich	V;IND;SG;1;PRS
fechten	fechten	V;IND;PL;1;PRS
beschlagen	beschlage	V;IND;SG;1;PRS
Luftdruck	Luftdruck	N;NOM;MASC;SG
größenwahnsinnig	größenwahnsinniger	ADJ;CMPR
Buchhändlerin	Buchhändlerin	N;GEN;FEM;SG
zurückkaufen	kaufte zurück	V;IND;SG;3;PST
Boxer	Boxers	N;GEN;MASC;SG
Blattspinat	Blattspinat	N;NOM;SG
Heidelberger	Heidelberger	N;GEN;MASC;PL
klingeln	klingel	V;IND;SG;1;PRS
enragiert	enragierten	ADJ;GEN;MASC;SG
Hydridokomplex	Hydridokomplex	N;DAT;SG
Bloch	Bloche	N;ACC;MASC;PL
kokainsüchtig	kokainsüchtiger	ADJ;NOM;MASC;SG
Lametta	Lametta	N;DAT;NEUT;SG
amtieren	amtiert	V;IMP;PL;2
Fassbombe	Fassbomben	N;NOM;FEM;PL
Arbeitsbeschaffungsprogramm	Arbeitsbeschaffungsprogrammes	N;GEN;NEUT;SG
Schwermetallion	Schwermetallionen	N;ACC;PL
Erbschaftssteuer	Erbschaftssteuern	N;ACC;FEM;PL
erfragen	erfragtet	V;SBJV;PL;2;PST
banalisieren	banalisiert	V;IND;SG;3;PRS
Gaschromatographie	Gaschromatographie	N;GEN;FEM;SG
freilassen	lasse frei	V;SBJV;SG;1;PRS
insuffizient	insuffizientem	ADJ;DAT;NEUT;SG
Ringeltaube	Ringeltaube	N;ACC;FEM;SG
monoton	monotoner	ADJ;GEN;FEM;SG
Gehege	Gehege	N;NOM;NEUT;PL
appliziren	applizirte	V;IND;SG;3;PST
bezaubernd	am bezauberndsten	ADJ;SPRL
Ariadnefaden	Ariadnefäden	N;ACC;MASC;PL
Schifffahrt	Schifffahrten	N;GEN;FEM;PL
nummerieren	nummerieren	V;SBJV;PL;3;PRS
anprangern	angeprangert	V.PTCP;PST
zerdeppern	zerdeppert	V;IMP;PL;2
untätig	untätigem	ADJ;DAT;MASC;SG
Berberlöwe	Berberlöwen	N;DAT;SG
Eruption	Eruption	N;ACC;SG
abgefuckt	abgefucktem	ADJ;DAT;NEUT;SG
Goldrute	Goldrute	N;NOM;FEM;SG
vorbeugen	beuget vor	V;SBJV;PL;2;PRS
Blaubeere	Blaubeeren	N;NOM;FEM;PL
abschwächen	schwächen ab	V;SBJV;PL;1;PRS
Monopolist	Monopolisten	N;DAT;PL
Fußballplatz	Fußballplatz	N;NOM;MASC;SG
Orangenbaum	Orangenbäume	N;GEN;MASC;PL
vorkauen	kaute vor	V;SBJV;SG;3;PST
Straßenmusikant	Straßenmusikanten	N;GEN;PL
rallen	rallte	V;SBJV;SG;3;PST
hemmungslos	hemmungsloses	ADJ;NOM;NEUT;SG
härten	härtetest	V;SBJV;SG;2;PST
Antenne	Antenne	N;GEN;FEM;SG
spannen	spannen	V;NFIN
mimetisch	mimetische	ADJ;ACC;PL
Kohle	Kohle	N;NOM;FEM;SG
Anliegen	Anliegen	N;NOM;PL
Molybdophosphat	Molybdophosphat	N;DAT;SG
lagern	lagert	V;IND;PL;2;PRS
voyeuristisch	voyeuristischer	ADJ;CMPR
Jemenitin	Jemenitin	N;NOM;SG
Zerebralparese	Zerebralparese	N;GEN;FEM;SG
Anstehen	Anstehen	N;ACC;NEUT;SG
Beseitigen	Beseitigen	N;DAT;NEUT;SG
Lesekopf	Leseköpfe	N;ACC;MASC;PL
Atmosphäre	Atmosphäre	N;NOM;SG
Molekül	Moleküle	N;ACC;NEUT;PL
Einweisung	Einweisung	N;NOM;SG
Knautschzone	Knautschzonen	N;ACC;FEM;PL
holen	holtet	V;IND;PL;2;PST
enttäuschen	enttäusche	V;IND;SG;1;PRS
Vorjahreszeitraum	Vorjahreszeitraum	N;NOM;MASC;SG
Gestaltwandler	Gestaltwandler	N;DAT;MASC;SG
Ausschluss	Ausschluss	N;ACC;SG
lind	linde	ADJ;ACC;FEM;SG
Jasager	Jasager	N;DAT;MASC;SG
behandeln	behandeln	V;SBJV;PL;3;PRS
ungenügsam	ungenügsamem	ADJ;DAT;NEUT;SG
kribbeln	kribbeln	V;IND;PL;3;PRS
kadscharisch	kadscharischen	ADJ;GEN;MASC;SG
Nichtmuttersprachlerin	Nichtmuttersprachlerin	N;ACC;SG
Schwerhörigkeit	Schwerhörigkeiten	N;GEN;FEM;PL
Monopol	Monopolen	N;DAT;PL
Ersatzfrau	Ersatzfrau	N;ACC;FEM;SG
Dole	Dole	N;NOM;SG
Fritzchen	Fritzchen	N;ACC;PL
karren	karre	V;SBJV;SG;3;PRS
kokettieren	kokettiertest	V;SBJV;SG;2;PST
zählen	zählt	V;IMP;PL;2
Parenthese	Parenthese	N;NOM;FEM;SG
spüren	spürte	V;IND;SG;1;PST
Hohlraumresonator	Hohlraumresonators	N;GEN;NEUT;SG
schreiben	schreibe	V;SBJV;SG;1;PRS
Prärie	Prärien	N;DAT;PL
wedeln	wedele	V;SBJV;SG;3;PRS
schleusen	schleuste	V;SBJV;SG;1;PST
Gaumen	Gaumen	N;GEN;MASC;PL
herbringen	brächte her	V;SBJV;SG;1;PST
Sägezahn	Sägezahnes	N;GEN;SG
umsiedeln	siedelt um	V;IND;SG;3;PRS
snöben	snöbte	V;SBJV;SG;1;PST
auswerfen	würfen aus	V;SBJV;PL;3;PST
zentrieren	zentrieren	V;NFIN
vergasen	vergasten	V;IND;PL;1;PST
verpassen	verpasstet	V;IND;PL;2;PST
Lemmagruppe	Lemmagruppe	N;ACC;FEM;SG
verantwortlich	verantwortliche	ADJ;NOM;FEM;SG
erfolgreich	erfolgreiche	ADJ;ACC;PL
stauben	staubte	V;IND;SG;1;PST
Tellerlein	Tellerlein	N;NOM;NEUT;PL
pochieren	pochiertet	V;SBJV;PL;2;PST
berufsunfähig	berufsunfähige	ADJ;ACC;FEM;SG
Katatonie	Katatonien	N;DAT;PL
anlangen	langest an	V;SBJV;SG;2;PRS
wegtreten	trete weg	V;IND;SG;1;PRS
manipulativ	manipulative	ADJ;NOM;PL
kratzfest	kratzfestes	ADJ;NOM;NEUT;SG
Gänsefuß	Gänsefuß	N;NOM;MASC;SG
muchelig	muchelige	ADJ;ACC;FEM;SG
hochheben	hoben hoch	V;IND;PL;1;PST
abwägen	wäge ab	V;IND;SG;1;PRS
wegfegen	fege weg	V;SBJV;SG;1;PRS
Labsal	Labsale	N;GEN;NEUT;PL
katapultieren	katapultiere	V;SBJV;SG;1;PRS
Rutherfordium	Rutherfordium	N;NOM;NEUT;SG
Angriffsfläche	Angriffsflächen	N;GEN;FEM;PL
fortlocken	lockest fort	V;SBJV;SG;2;PRS
bemitleiden	bemitleidest	V;IND;SG;2;PRS
Lippenlaut	Lippenlaute	N;GEN;MASC;PL
Klebestreifen	Klebestreifen	N;DAT;MASC;PL
Gefallen	Gefallen	N;GEN;MASC;PL
Hardwareentwickler	Hardwareentwickler	N;GEN;PL
Schlingel	Schlingel	N;ACC;MASC;SG
Autoklav	Autoklav	N;NOM;MASC;SG
Aufrichtigkeit	Aufrichtigkeit	N;ACC;SG
bemängeln	bemängelnd	V.PTCP;PRS
hineinblicken	blickst hinein	V;IND;SG;2;PRS
Eigenbrötlerei	Eigenbrötlereien	N;ACC;FEM;PL
Sonnencreme	Sonnencreme	N;GEN;FEM;SG
unbeschwert	unbeschwerter	ADJ;CMPR
balkanisieren	balkanisieret	V;SBJV;PL;2;PRS
abfeuern	abfeuern	V;NFIN
Tafel	Tafeln	N;NOM;FEM;PL
Frisörin	Frisörinnen	N;NOM;FEM;PL
entsenden	entsenden	V;IND;PL;3;PRS
antasten	angetastet	V.PTCP;PST
Larmoyanz	Larmoyanz	N;ACC;FEM;SG
beißen	beißt	V;IND;SG;3;PRS
umdeuten	deuteten um	V;IND;PL;1;PST
Jonglieren	Jonglieren	N;DAT;SG
umkehren	kehren um	V;IND;PL;3;PRS
national	nationalem	ADJ;DAT;NEUT;SG
Architekt	Architekt	N;NOM;MASC;SG
wegtragen	weggetragen	V.PTCP;PST
Schluss	Schlüssen	N;DAT;PL
lehnen	lehnet	V;SBJV;PL;2;PRS
habgierig	habgierige	ADJ;ACC;PL
kollabieren	kollabierten	V;SBJV;PL;1;PST
hablich	hablicher	ADJ;GEN;FEM;SG
entbinden	entbändest	V;SBJV;SG;2;PST
Schleuse	Schleuse	N;DAT;SG
Amoklauf	Amokläufe	N;ACC;PL
einenglischen	englischtest ein	V;SBJV;SG;2;PST
breiten	breitetet	V;SBJV;PL;2;PST
rotblütig	rotblütigen	ADJ;GEN;MASC;SG
Abwesenheit	Abwesenheiten	N;DAT;PL
abladen	ladest ab	V;SBJV;SG;2;PRS
Einkaufschip	Einkaufschip	N;DAT;MASC;SG
herumbewegen	bewegen herum	V;SBJV;PL;1;PRS
grau	graue	ADJ;NOM;FEM;SG
parametrisieren	parametrisierten	V;IND;PL;1;PST
schüren	schüret	V;SBJV;PL;2;PRS
auftreten	aufzutreten	V;NFIN;LGSPEC01
Photon	Photon	N;DAT;NEUT;SG
schnurren	schnurrest	V;SBJV;SG;2;PRS
desillusionierend	desillusionierende	ADJ;ACC;PL
aufopfern	aufopfernd	V.PTCP;PRS
fertigkriegen	kriegtest fertig	V;SBJV;SG;2;PST
Perfektion	Perfektion	N;GEN;FEM;SG
Nährmedium	Nährmedien	N;NOM;NEUT;PL
zoffen	zoffe	V;SBJV;SG;1;PRS
telefonieren	telefonierte	V;IND;SG;1;PST
Gamma	Gammas	N;NOM;PL
volksmäßig	volksmäßiger	ADJ;GEN;FEM;SG
Beluga	Beluga	N;DAT;FEM;SG
Gänsesäger	Gänsesäger	N;DAT;MASC;SG
Maulficker	Maulficker	N;DAT;MASC;SG
Apotheke	Apotheke	N;DAT;SG
Zahlen	Zahlen	N;DAT;NEUT;SG
verpuppen	verpupptest	V;SBJV;SG;2;PST
Unersättlichkeit	Unersättlichkeiten	N;GEN;PL
ästimieren	ästimierten	V;IND;PL;3;PST
Wegwerfbesteck	Wegwerfbesteck	N;NOM;NEUT;SG
versauen	versauten	V;SBJV;PL;1;PST
Kurzaufenthalt	Kurzaufenthalt	N;ACC;MASC;SG
verkuppeln	verkuppele	V;SBJV;SG;3;PRS
prassen	prassen	V;NFIN
dimerisieren	dimerisierest	V;SBJV;SG;2;PRS
Aprikosenstein	Aprikosenstein	N;ACC;SG
abgebrüht	abgebrühte	ADJ;ACC;FEM;SG
Eigenbeschuss	Eigenbeschusse	N;DAT;MASC;SG
Ren	Rene	N;ACC;NEUT;PL
verstauen	verstautest	V;SBJV;SG;2;PST
Empfangsgerät	Empfangsgerät	N;DAT;SG
anheimstellen	anheimstellend	V.PTCP;PRS
Silber	Silber	N;DAT;NEUT;SG
Inspiration	Inspirationen	N;DAT;FEM;PL
Cytostatikum	Cytostatikum	N;ACC;SG
banalisieren	banalisieret	V;SBJV;PL;2;PRS
Science-Fiction-Buch	Science-Fiction-Bücher	N;NOM;NEUT;PL
Dienstagabend	Dienstagabende	N;NOM;MASC;PL
glühen	glühtest	V;SBJV;SG;2;PST
Kleidermotte	Kleidermotte	N;DAT;FEM;SG
flanieren	flanierten	V;IND;PL;3;PST
feige	feigen	ADJ;ACC;MASC;SG
gechillt	gechillter	ADJ;CMPR
Kenner	Kenner	N;NOM;MASC;PL
spülen	spülten	V;SBJV;PL;1;PST
Kalbsleber	Kalbslebern	N;GEN;FEM;PL
lakonisch	lakonischen	ADJ;ACC;MASC;SG
Himmel	Himmel	N;NOM;MASC;PL
allemachen	machtest alle	V;SBJV;SG;2;PST
Tibeterin	Tibeterinnen	N;DAT;PL
bestürzen	bestürzen	V;SBJV;PL;3;PRS
heraufstufen	stuften herauf	V;SBJV;PL;1;PST
Futterzusatzstoff	Futterzusatzstoff	N;ACC;SG
verzinnen	verzinnten	V;SBJV;PL;1;PST
Kunststoffanlage	Kunststoffanlagen	N;NOM;FEM;PL
Härchen	Härchen	N;DAT;NEUT;SG
Mutlosigkeit	Mutlosigkeit	N;GEN;FEM;SG
Bräunung	Bräunung	N;DAT;FEM;SG
Schauspieler	Schauspieler	N;NOM;PL
Stellenwertsystem	Stellenwertsystems	N;GEN;NEUT;SG
Katalanin	Katalanin	N;GEN;FEM;SG
Schabbes	Schabbes	N;DAT;MASC;PL
ausverkaufen	verkauften aus	V;SBJV;PL;1;PST
ausflippen	flippt aus	V;IND;PL;2;PRS
Johannisbeere	Johannisbeere	N;ACC;FEM;SG
Walten	Walten	N;ACC;NEUT;SG
Hämocyanin	Hämocyanin	N;ACC;NEUT;SG
Klapperschlange	Klapperschlange	N;GEN;FEM;SG
Bewusstlosigkeit	Bewusstlosigkeiten	N;ACC;PL
Geigerzähler	Geigerzähler	N;ACC;MASC;PL
erbarmungslos	erbarmungsloses	ADJ;ACC;NEUT;SG
Abszess	Abszess	N;ACC;SG
spazieren gehen	gehet spazieren 	V;SBJV;PL;2;PRS
fisten	fisten	V;IND;PL;1;PRS
Standort	Standorte	N;GEN;MASC;PL
Trockenheit	Trockenheit	N;DAT;SG
veralten	veraltete	V;SBJV;SG;1;PST
unüberwindlich	unüberwindlicher	ADJ;NOM;MASC;SG
lucianisch	lucianischen	ADJ;ACC;MASC;SG
dastehen	ständen da	V;SBJV;PL;3;PST
mobil	mobilen	ADJ;GEN;MASC;SG
saften	saftetest	V;IND;SG;2;PST
Paradiesapfel	Paradiesapfel	N;ACC;MASC;SG
Brotsuppe	Brotsuppe	N;GEN;SG
ausbrüten	brüteten aus	V;IND;PL;3;PST
Wacholder	Wacholdern	N;DAT;PL
abwarten	wartete ab	V;SBJV;SG;1;PST
gehaut	gehauter	ADJ;NOM;MASC;SG
Kalorie	Kalorie	N;NOM;FEM;SG
negieren	negierst	V;IND;SG;2;PRS
backen	backen	V;NFIN
vandalieren	vandalierte	V;IND;SG;1;PST
Vogelschützer	Vogelschützer	N;NOM;MASC;PL
Thiol	Thiols	N;GEN;SG
Kugelgelenk	Kugelgelenk	N;ACC;NEUT;SG
Dolde	Dolden	N;ACC;PL
abbauen	abbauen	V;NFIN
joggen	joggen	V;IND;PL;1;PRS
gruselig	gruseliger	ADJ;GEN;FEM;SG
Gießerie	Gießerie	N;NOM;SG
mißlingen	mißlang	V;IND;SG;1;PST
Mahl	Mähler	N;ACC;NEUT;PL
angreifen	griffen an	V;IND;PL;3;PST
Abflug	Abflüge	N;GEN;PL
Leerzeichen	Leerzeichen	N;ACC;SG
praktikabel	praktikables	ADJ;ACC;NEUT;SG
herabrieseln	rieseln herab	V;SBJV;PL;3;PRS
anmachen	anmachend	V.PTCP;PRS
Römer	Römer	N;NOM;SG
Peptid	Peptide	N;NOM;NEUT;PL
Gaugraf	Gaugrafen	N;DAT;MASC;PL
ausbürgern	bürgerte aus	V;SBJV;SG;1;PST
Panzerabwehrkanone	Panzerabwehrkanone	N;DAT;FEM;SG
foutieren	foutierte	V;IND;SG;1;PST
Information	Information	N;GEN;FEM;SG
gießen	gieße	V;IND;SG;1;PRS
Flügelfenster	Flügelfenster	N;ACC;NEUT;SG
herb	herber	ADJ;NOM;MASC;SG
gottgefällig	gottgefälliger	ADJ;GEN;PL
harmonisieren	harmonisierte	V;SBJV;SG;3;PST
Meuterei	Meuterei	N;NOM;FEM;SG
diffundieren	diffundier	V;IMP;SG;2
verlassen	verlassene	ADJ;NOM;FEM;SG
Altmaterial	Altmaterialien	N;NOM;NEUT;PL
Albedo	Albedo	N;DAT;FEM;SG
Schwarzweißbild	Schwarzweißbilder	N;ACC;NEUT;PL
prächtig	prächtige	ADJ;ACC;FEM;SG
Katarrh	Katarrhs	N;GEN;SG
umhauen	haue um	V;SBJV;SG;3;PRS
Kanon	Kanons	N;GEN;MASC;SG
Übertötung	Übertötung	N;ACC;FEM;SG
Laborantin	Laborantinnen	N;DAT;FEM;PL
erschießen	erschösset	V;SBJV;PL;2;PST
Tetrahydrat	Tetrahydrat	N;DAT;NEUT;SG
Zeitplan	Zeitplan	N;DAT;SG
abarbeiten	arbeitete ab	V;IND;SG;1;PST
Feinschmeckerlokal	Feinschmeckerlokale	N;ACC;NEUT;PL
Liberianer	Liberianer	N;NOM;SG
Nanodraht	Nanodrähten	N;DAT;MASC;PL
emporheben	heben empor	V;IND;PL;1;PRS
kokett	kokettes	ADJ;ACC;NEUT;SG
predigen	predigst	V;IND;SG;2;PRS
Zisterne	Zisterne	N;NOM;FEM;SG
Arterie	Arterien	N;NOM;FEM;PL
Vizerektor	Vizerektor	N;ACC;MASC;SG
züchtigen	züchtigtest	V;IND;SG;2;PST
Einstellungsgespräch	Einstellungsgesprächen	N;DAT;NEUT;PL
Einwegbesteck	Einwegbesteck	N;ACC;NEUT;SG
Wunderwaffe	Wunderwaffen	N;ACC;FEM;PL
rauschen	rausche	V;SBJV;SG;3;PRS
Fremdkapital	Fremdkapitalen	N;DAT;NEUT;PL
hineininterpretieren	interpretiertet hinein	V;SBJV;PL;2;PST
Süßigkeit	Süßigkeiten	N;DAT;PL
Allesfresser	Allesfresser	N;ACC;PL
Fahrzeugkatalysator	Fahrzeugkatalysatoren	N;NOM;PL
elastisch	elastisches	ADJ;NOM;NEUT;SG
flügeln	flügelten	V;IND;PL;3;PST
Garage	Garage	N;GEN;SG
Extranet	Extranet	N;NOM;SG
erwidern	erwiderten	V;SBJV;PL;1;PST
Puffe	Puffe	N;NOM;FEM;SG
anwidern	widere an	V;SBJV;SG;1;PRS
Etablissement	Etablissements	N;ACC;PL
einwilligen	willigtet ein	V;IND;PL;2;PST
Friedensbruch	Friedensbruchen	N;NOM;FEM;PL
abspringen	sprängest ab	V;SBJV;SG;2;PST
Schläfer	Schläfer	N;DAT;SG
Laptop	Laptops	N;NOM;MASC+NEUT;PL
Bon	Bon	N;ACC;SG
Beweis	Beweise	N;DAT;MASC;SG
Aus	Aus	N;ACC;NEUT;SG
zuspielen	spielet zu	V;SBJV;PL;2;PRS
abregen	regtet ab	V;SBJV;PL;2;PST
Bauchspeicheldrüsenentzündung	Bauchspeicheldrüsenentzündungen	N;DAT;FEM;PL
Herdenimmunität	Herdenimmunitäten	N;NOM;FEM;PL
Monat	Monat	N;ACC;MASC;SG
hinstarren	starre hin	V;SBJV;SG;3;PRS
abfertigen	fertig ab	V;IMP;SG;2
Anonymität	Anonymität	N;NOM;FEM;SG
logieren	logieret	V;SBJV;PL;2;PRS
zusetzen	setz zu	V;IMP;SG;2
Arno	Arno	N;ACC;MASC;SG
recht haben	hat recht 	V;IND;SG;3;PRS
wundreiben	wundreibend	V.PTCP;PRS
abblättern	blättertest ab	V;IND;SG;2;PST
Weißbier	Weißbiere	N;ACC;PL
Fünfheber	Fünfheber	N;NOM;MASC;PL
wundreiben	reiben wund	V;IND;PL;3;PRS
kaudal	kaudalem	ADJ;DAT;NEUT;SG
Selektivität	Selektivität	N;ACC;SG
entschlussfreudig	entschlussfreudiges	ADJ;NOM;NEUT;SG
Thorax	Thoraxe	N;NOM;PL
ewig	ewigem	ADJ;DAT;NEUT;SG
einstehen	stehen ein	V;SBJV;PL;3;PRS
Hungersnot	Hungersnöte	N;NOM;FEM;PL
Märchen	Märchen	N;ACC;NEUT;PL
oktroyieren	oktroyiertet	V;SBJV;PL;2;PST
bedonnert	bedonnerter	ADJ;GEN;FEM;SG
christlich	christlichem	ADJ;DAT;NEUT;SG
hobeln	hobelt	V;IMP;PL;2
biegen	böge	V;SBJV;SG;3;PST
beschiessen	beschiesst	V;IND;SG;2;PRS
abtreiben	trieben ab	V;IND;PL;3;PST
Laugensalz	Laugensalzes	N;GEN;NEUT;SG
Zerfallsprodukt	Zerfallsprodukt	N;DAT;SG
Analyst	Analysten	N;NOM;PL
drängen	drängen	V;IND;PL;3;PRS
zeitaufwendig	zeitaufwendiger	ADJ;CMPR
umblicken	blicket um	V;SBJV;PL;2;PRS
Multifunktionsuhr	Multifunktionsuhr	N;ACC;SG
faszinierend	faszinierender	ADJ;GEN;PL
mitreden	reden mit	V;IND;PL;3;PRS
Hyperlink	Hyperlink	N;NOM;MASC;SG
eintippen	tippe ein	V;SBJV;SG;3;PRS
krächzen	krächzen	V;SBJV;PL;1;PRS
Myzelium	Myzelien	N;GEN;NEUT;PL
zähflüssig	zähflüssigem	ADJ;DAT;MASC;SG
portionieren	portionieren	V;SBJV;PL;3;PRS
Wüste	Wüste	N;ACC;SG
Sanitätsfahrzeug	Sanitätsfahrzeuge	N;DAT;NEUT;SG
lidschäftig	lidschäftigen	ADJ;ACC;MASC;SG
schlürfen	schlürftet	V;IND;PL;2;PST
unerwartet	unerwarteten	ADJ;ACC;MASC;SG
Affrikate	Affrikaten	N;ACC;FEM;PL
verherrlichen	verherrlich	V;IMP;SG;2
alkoholisiert	alkoholisiertes	ADJ;ACC;NEUT;SG
Sepsis	Sepsen	N;NOM;FEM;PL
Koffer	Koffers	N;GEN;SG
umschulen	schultet um	V;IND;PL;2;PST
viskos	viskosen	ADJ;GEN;MASC;SG
anklingeln	anklingelnd	V.PTCP;PRS
Lebensabschnitt	Lebensabschnitt	N;NOM;MASC;SG
arbeitsam	arbeitsamer	ADJ;GEN;FEM;SG
Rundflug	Rundflüge	N;NOM;MASC;PL
Schafhirte	Schafhirten	N;GEN;PL
schwachsinnig	schwachsinnigem	ADJ;DAT;MASC;SG
verkrampfen	verkrampfe	V;SBJV;SG;1;PRS
herannahen	nahe heran	V;SBJV;SG;3;PRS
Eiweißsynthese	Eiweißsynthese	N;ACC;FEM;SG
mildtätig	mildtätige	ADJ;ACC;FEM;SG
Azidose	Azidose	N;DAT;FEM;SG
Schlaflied	Schlafliedern	N;DAT;NEUT;PL
allgegenwärtig	allgegenwärtiger	ADJ;GEN;PL
willfahren	willfahrt	V;IND;PL;2;PRS
herunterkommen	kommen herunter	V;IND;PL;3;PRS
Menschenhand	Menschenhand	N;GEN;FEM;SG
entsagen	entsagend	V.PTCP;PRS
Gehege	Gehege	N;DAT;NEUT;SG
Vergrößerungsform	Vergrößerungsform	N;NOM;FEM;SG
knöchern	knöcherner	ADJ;CMPR
verdämmern	verdämmern	V;NFIN
Kochmesser	Kochmesser	N;GEN;NEUT;PL
Schnellspanner	Schnellspanner	N;ACC;MASC;PL
aufspüren	spürtest auf	V;IND;SG;2;PST
Kurzstreckenrakete	Kurzstreckenraketen	N;ACC;PL
schirch	schirche	ADJ;ACC;PL
verhängen	verhängen	V;NFIN
mafios	mafioser	ADJ;CMPR
Diesel	Diesel	N;DAT;MASC;SG
diskutabel	diskutabeler	ADJ;CMPR
Polyolefin	Polyolefine	N;NOM;NEUT;PL
Bolivien-Tropfenameisenwürger	Bolivien-Tropfenameisenwürger	N;NOM;SG
Zwielicht	Zwielicht	N;ACC;NEUT;SG
anekeln	ekele an	V;SBJV;SG;3;PRS
anbaggern	anbaggern	V;NFIN
Wellblech	Wellbleche	N;DAT;NEUT;SG
verpassen	verpassest	V;SBJV;SG;2;PRS
Nanomotor	Nanomotor	N;ACC;SG
erfrischen	erfrischte	V;SBJV;SG;1;PST
Creme	Creme	N;GEN;FEM;SG
Missernte	Missernte	N;NOM;FEM;SG
streben	strebtest	V;SBJV;SG;2;PST
durchschimmern	schimmertet durch	V;SBJV;PL;2;PST
anziehen	zogst an	V;IND;SG;2;PST
Frühlingszwiebel	Frühlingszwiebel	N;DAT;FEM;SG
Beryllat	Beryllat	N;DAT;NEUT;SG
widernatürlich	widernatürlichen	ADJ;ACC;MASC;SG
Clownfisch	Clownfische	N;GEN;PL
Stellungskrieg	Stellungskrieg	N;ACC;MASC;SG
vollmachen	machtest voll	V;SBJV;SG;2;PST
Kristallfeld	Kristallfeldes	N;GEN;NEUT;SG
Landstreicher	Landstreicher	N;ACC;MASC;SG
Marotte	Marotten	N;GEN;FEM;PL
letzen	letz	V;IMP;SG;2
Haftpflichtversicherung	Haftpflichtversicherungen	N;ACC;FEM;PL
schmutzig	schmutzige	ADJ;ACC;PL
flatulent	flatulenten	ADJ;DAT;PL
Doppelzimmer	Doppelzimmer	N;NOM;NEUT;PL
erquickend	erquickenden	ADJ;DAT;PL
Behüter	Behüter	N;GEN;PL
herzlich	herzlicher	ADJ;GEN;PL
transkribieren	transkribierten	V;SBJV;PL;1;PST
beytreten	trätet bey	V;SBJV;PL;2;PST
Nebelstreif	Nebelstreif	N;ACC;MASC;SG
Abdeckplatte	Abdeckplatten	N;DAT;PL
unmöglich	unmögliche	ADJ;ACC;PL
Nachkommastelle	Nachkommastellen	N;ACC;PL
medienwirksam	medienwirksamer	ADJ;CMPR
Tutorial	Tutorials	N;GEN;NEUT;SG
lästern	lästert	V;IMP;PL;2
Ammenmärchen	Ammenmärchen	N;GEN;NEUT;PL
Akzent	Akzent	N;NOM;MASC;SG
Abitur	Abitur	N;NOM;NEUT;SG
verzweifachen	verzweifachten	V;SBJV;PL;3;PST
widerstreben	widerstrebe	V;SBJV;SG;1;PRS
Genetikerin	Genetikerin	N;DAT;SG
suhlen	suhlte	V;IND;SG;3;PST
Amt	Amt	N;NOM;SG
tätowieren	tätowiert	V.PTCP;PST
Nacheile	Nacheile	N;NOM;FEM;SG
umblicken	blickten um	V;IND;PL;1;PST
konserviert	konservierte	ADJ;NOM;FEM;SG
Puppe	Puppe	N;ACC;FEM;SG
Statthalter	Statthalter	N;DAT;MASC;SG
Höschen	Höschen	N;DAT;NEUT;SG
Abladen	Abladen	N;DAT;NEUT;SG
Parasol	Parasolen	N;DAT;MASC+NEUT;PL
registrieren	registrierend	V.PTCP;PRS
Periode	Periode	N;GEN;FEM;SG
inaktivieren	inaktivierte	V;SBJV;SG;3;PST
Atombombenexplosion	Atombombenexplosionen	N;DAT;PL
Seilbahn	Seilbahnen	N;NOM;PL
Bohnensalat	Bohnensalaten	N;DAT;MASC;PL
züchten	züchten	V;IND;PL;3;PRS
Suspension	Suspension	N;DAT;SG
Bierflasche	Bierflasche	N;ACC;FEM;SG
Queen	Queen	N;ACC;FEM;SG
fodern	foderest	V;SBJV;SG;2;PRS
schimmelig	schimmeliger	ADJ;DAT;FEM;SG
Innenministerium	Innenministerien	N;DAT;NEUT;PL
Wassermolekül	Wassermolekülen	N;DAT;NEUT;PL
gehören	gehörtet	V;SBJV;PL;2;PST
unkommerziell	unkommerzielle	ADJ;NOM;FEM;SG
verwüsten	verwüstest	V;SBJV;SG;2;PRS
klonen	klonend	V.PTCP;PRS
Gärtner	Gärtnern	N;DAT;PL
Fischhändler	Fischhändler	N;DAT;SG
Pate	Paten	N;ACC;MASC;PL
abtreiben	triebe ab	V;SBJV;SG;1;PST
selbstsüchtig	selbstsüchtige	ADJ;NOM;PL
Kaskade	Kaskaden	N;NOM;FEM;PL
Buhne	Buhne	N;NOM;SG
abschirmen	schirmen ab	V;IND;PL;3;PRS
schiften	schiftete	V;SBJV;SG;3;PST
Oxidationszahl	Oxidationszahlen	N;NOM;PL
senil	senilem	ADJ;DAT;MASC;SG
Außenministerium	Außenministerium	N;NOM;NEUT;SG
Stiefbruder	Stiefbruder	N;DAT;MASC;SG
kiebig	kiebige	ADJ;ACC;FEM;SG
flink	flinker	ADJ;DAT;FEM;SG
Veranschaulichen	Veranschaulichens	N;GEN;NEUT;SG
warten	wartest	V;IND;SG;2;PRS
verdächtigen	verdächtigest	V;SBJV;SG;2;PRS
Spelz	Spelzen	N;DAT;MASC;PL
Hydroxygruppe	Hydroxygruppen	N;DAT;FEM;PL
Zwangsarbeiterin	Zwangsarbeiterin	N;GEN;SG
Arsenolipid	Arsenolipid	N;ACC;SG
heimkommen	heimkommen	V;NFIN
Untertagebau	Untertagebau	N;DAT;SG
Gebet	Gebeten	N;DAT;NEUT;PL
einquartieren	quartiere ein	V;SBJV;SG;3;PRS
spürbar	spürbarer	ADJ;CMPR
Bärenfell	Bärenfell	N;ACC;SG
Pulsader	Pulsadern	N;NOM;FEM;PL
aufraffen	aufzuraffen	V;NFIN;LGSPEC01
Stoiker	Stoiker	N;NOM;MASC;SG
Intention	Intentionen	N;DAT;PL
instrumentalisieren	instrumentalisiertest	V;IND;SG;2;PST
eintrudeln	trudelet ein	V;SBJV;PL;2;PRS
Komponente	Komponenten	N;NOM;FEM;PL
Zwillingsschwester	Zwillingsschwester	N;DAT;FEM;SG
Täufer	Täufern	N;DAT;PL
Seife	Seife	N;DAT;SG
blutleer	blutleeres	ADJ;ACC;NEUT;SG
adrett	adretten	ADJ;DAT;PL
Schmauchspur	Schmauchspur	N;NOM;FEM;SG
kleiden	kleidet	V;IMP;PL;2
belauern	belauerten	V;IND;PL;3;PST
verleugnen	verleugnete	V;SBJV;SG;1;PST
rechthaberisch	rechthaberischer	ADJ;GEN;FEM;SG
Ballkleidchen	Ballkleidchen	N;ACC;NEUT;PL
Blutbad	Blutbäder	N;ACC;NEUT;PL
Fallbeil	Fallbeile	N;GEN;PL
Sonderzeichen	Sonderzeichen	N;NOM;NEUT;SG
Sprühnebel	Sprühnebel	N;DAT;MASC;SG
Zeitüberschreitung	Zeitüberschreitung	N;DAT;SG
Ruderwettkampf	Ruderwettkampf	N;DAT;MASC;SG
verschleißen	verschleißen	V;IND;PL;3;PRS
Betonung	Betonungen	N;DAT;PL
Ehrengast	Ehrengäste	N;GEN;MASC;PL
überfahren	fahrest über	V;SBJV;SG;2;PRS
Verfassung	Verfassung	N;GEN;SG
Kinderärztin	Kinderärztin	N;GEN;FEM;SG
letzen	letzt	V;IND;PL;2;PRS
Erdkern	Erdkernes	N;GEN;MASC;SG
Prägeanstalt	Prägeanstalten	N;NOM;FEM;PL
Findung	Findungen	N;ACC;FEM;PL
Jahresbeginn	Jahresbeginn	N;ACC;MASC;SG
Schmelzpunkt	Schmelzpunkt	N;ACC;SG
Sprachkurs	Sprachkurs	N;ACC;SG
zieren	zierten	V;SBJV;PL;3;PST
Technetium	Technetium	N;ACC;SG
aufkreuzen	kreuzen auf	V;SBJV;PL;3;PRS
einschlafen	schliefen ein	V;SBJV;PL;3;PST
Quader	Quader	N;NOM;MASC;SG
sozialisieren	sozialisieren	V;IND;PL;1;PRS
Aaser	Aaser	N;DAT;MASC;SG
Vorteil	Vorteile	N;ACC;PL
denken	denkest	V;SBJV;SG;2;PRS
Phonologin	Phonologinnen	N;DAT;FEM;PL
Skalp	Skalpe	N;ACC;MASC;PL
meßen	maßen	V;IND;PL;1;PST
Pendel	Pendel	N;ACC;NEUT;PL
Straßenbild	Straßenbilder	N;ACC;PL
beseelen	beseeltet	V;SBJV;PL;2;PST
Donnerwetter	Donnerwetter	N;NOM;SG
schämen	schäme	V;SBJV;SG;1;PRS
gurgeln	gurgelten	V;SBJV;PL;1;PST
Taucheruhr	Taucheruhr	N;GEN;SG
auftürmen	türmt auf	V;IMP;PL;2
Zimtschnecke	Zimtschnecke	N;GEN;FEM;SG
aufbieten	biete auf	V;IMP;SG;2
Herkunftsbezeichnung	Herkunftsbezeichnung	N;GEN;SG
Hooligan	Hooligans	N;NOM;MASC;PL
ächten	ächten	V;SBJV;PL;1;PRS
entmineralisieren	entmineralisieren	V;SBJV;PL;1;PRS
Label	Labels	N;ACC;NEUT;PL
Flurbeleuchtung	Flurbeleuchtungen	N;NOM;PL
korrumpieren	korrumpierten	V;IND;PL;3;PST
haken	hakst	V;IND;SG;2;PRS
Staatsschutzdelikt	Staatsschutzdelikt	N;ACC;NEUT;SG
Hasenfuß	Hasenfüßen	N;DAT;PL
lidschäftig	lidschäftigem	ADJ;DAT;MASC;SG
niederbrennen	brenntest nieder	V;SBJV;SG;2;PST
Blätterwald	Blätterwälder	N;NOM;MASC;PL
Streife	Streifen	N;DAT;FEM;PL
Atmosphäre	Atmosphären	N;ACC;FEM;PL
Grafit	Grafite	N;NOM;MASC;PL
Lässigkeit	Lässigkeit	N;DAT;FEM;SG
herbeiziehen	herbeiziehen	V;NFIN
quasseln	quassele	V;SBJV;SG;1;PRS
härmen	härmtest	V;IND;SG;2;PST
Falbe	Falben	N;GEN;FEM;PL
sohlen	sohltet	V;IND;PL;2;PST
verdrehen	verdrehest	V;SBJV;SG;2;PRS
umschalten	umschaltend	V.PTCP;PRS
hätscheln	hätschelten	V;IND;PL;3;PST
Kopfsteinpflasterstraße	Kopfsteinpflasterstraße	N;DAT;FEM;SG
basal	basaler	ADJ;GEN;FEM;SG
umkämpft	umkämpfter	ADJ;GEN;PL
Heu	Heu	N;ACC;NEUT;SG
kokett	koketter	ADJ;NOM;MASC;SG
losschlagen	schlaget los	V;SBJV;PL;2;PRS
heizen	heizen	V;SBJV;PL;3;PRS
zusammenreißen	reißet zusammen	V;SBJV;PL;2;PRS
Warenmuster	Warenmuster	N;ACC;NEUT;SG
abhören	abhörend	V.PTCP;PRS
Glatteis	Glatteis	N;ACC;NEUT;SG
jaulen	jaule	V;SBJV;SG;1;PRS
fisten	gefistet	V.PTCP;PST
Transportmittel	Transportmittel	N;NOM;NEUT;PL
verlegen	verlegenen	ADJ;GEN;MASC;SG
Silbermöwe	Silbermöwe	N;GEN;FEM;SG
grässlich	grässliche	ADJ;NOM;FEM;SG
entsahnen	entsahntest	V;IND;SG;2;PST
Asso	Assos	N;NOM;MASC;PL
Ansteckung	Ansteckung	N;DAT;FEM;SG
aufkreuzen	kreuze auf	V;SBJV;SG;3;PRS
bezeigen	bezeigest	V;SBJV;SG;2;PRS
wechseln	wechseltet	V;SBJV;PL;2;PST
Igelfisch	Igelfische	N;NOM;PL
Einverständnis	Einverständnis	N;NOM;NEUT;SG
vergnügungssüchtig	vergnügungssüchtigen	ADJ;DAT;PL
Gasmaske	Gasmaske	N;ACC;FEM;SG
hintergehen	hintergingt	V;IND;PL;2;PST
öffnen	öffneten	V;IND;PL;3;PST
frohsinnig	frohsinnigen	ADJ;ACC;MASC;SG
Gerangel	Gerangels	N;GEN;NEUT;SG
lebendig	lebendigem	ADJ;DAT;NEUT;SG
kundgeben	kundgeben	V;NFIN
leckerfritzig	am leckerfritzigsten	ADJ;SPRL
Keton	Ketonen	N;DAT;PL
Fluorapatit	Fluorapatite	N;ACC;PL
Lambda	Lambdas	N;GEN;NEUT;PL
heiser	heiserer	ADJ;GEN;PL
Zeitungsverlag	Zeitungsverlage	N;ACC;MASC;PL
empathisch	empathische	ADJ;NOM;FEM;SG
schliddern	geschliddert	V.PTCP;PST
zulangen	langte zu	V;SBJV;SG;1;PST
antipathisch	antipathischen	ADJ;ACC;MASC;SG
vergnügen	vergnüge	V;SBJV;SG;3;PRS
flippig	flippigen	ADJ;GEN;NEUT;SG
prestigeträchtig	prestigeträchtiger	ADJ;GEN;PL
zusichern	sichert zu	V;IND;PL;2;PRS
herangehen	gehe heran	V;SBJV;SG;3;PRS
umgänglich	umgängliche	ADJ;ACC;FEM;SG
Staatsschutz	Staatsschutz	N;NOM;MASC;SG
gebresthaft	gebresthafte	ADJ;NOM;PL
einflößen	flößen ein	V;SBJV;PL;1;PRS
mahlen	mahlt	V;IMP;PL;2
torkeln	torkelest	V;SBJV;SG;2;PRS
Pirat	Pirat	N;NOM;SG
einspielen	spielst ein	V;IND;SG;2;PRS
stillen	still	V;IMP;SG;2
fickerig	fickerige	ADJ;NOM;FEM;SG
Sulfon	Sulfone	N;NOM;PL
Assyriologin	Assyriologinnen	N;ACC;FEM;PL
Unterschätzung	Unterschätzung	N;DAT;SG
Dezibel	Dezibel	N;NOM;NEUT;SG
kriegsmüde	kriegsmüden	ADJ;DAT;PL
Abfassen	Abfassen	N;DAT;NEUT;SG
Vormachtstellung	Vormachtstellungen	N;NOM;FEM;PL
Staffellauf	Staffellauf	N;ACC;SG
Montagabend	Montagabend	N;ACC;SG
vorgefasst	vorgefasster	ADJ;NOM;MASC;SG
Engelein	Engelein	N;NOM;NEUT;PL
Berichterstattung	Berichterstattung	N;DAT;SG
Batterie	Batterie	N;GEN;SG
verfertigen	verfertigen	V;IND;PL;3;PRS
grätig	grätigem	ADJ;DAT;NEUT;SG
sperren	sperrtet	V;IND;PL;2;PST
waschen	wüschen	V;SBJV;PL;1;PST
dolmetschen	dolmetschet	V;SBJV;PL;2;PRS
trauen	trauen	V;IND;PL;3;PRS
einblenden	blendeten ein	V;SBJV;PL;3;PST
Dünung	Dünung	N;NOM;SG
Gänger	Gängers	N;GEN;MASC;SG
beantworten	beantworteten	V;IND;PL;3;PST
Hurenkind	Hurenkinder	N;GEN;PL
Bedeutungslosigkeit	Bedeutungslosigkeit	N;DAT;FEM;SG
Dachgaube	Dachgaube	N;ACC;FEM;SG
Kreiselpumpe	Kreiselpumpen	N;NOM;FEM;PL
anvertrauen	vertrautet an	V;SBJV;PL;2;PST
Umerziehungslager	Umerziehungslagern	N;DAT;NEUT;PL
versiegen	versiegen	V;IND;PL;3;PRS
Geste	Geste	N;NOM;FEM;SG
prophezeien	prophezeiet	V;SBJV;PL;2;PRS
zerfressen	zerfraßen	V;IND;PL;1;PST
schönfärben	färbtest schön	V;SBJV;SG;2;PST
genusssüchtig	genusssüchtigen	ADJ;GEN;NEUT;SG
krakeelen	krakeelt	V;IND;PL;2;PRS
infernalisch	infernalischen	ADJ;GEN;NEUT;SG
Münzgeld	Münzgelder	N;NOM;PL
clever	clevere	ADJ;NOM;FEM;SG
Population	Populationen	N;GEN;PL
Mehrwegbesteck	Mehrwegbestecke	N;ACC;NEUT;PL
Jahresende	Jahresende	N;ACC;NEUT;SG
Garant	Garanten	N;DAT;SG
Hauptgruppennachbar	Hauptgruppennachbarn	N;DAT;MASC;PL
strauchartig	strauchartigen	ADJ;GEN;NEUT;SG
fummeln	fummelte	V;IND;SG;3;PST
verhunzen	verhunzte	V;SBJV;SG;1;PST
Lizenz	Lizenzen	N;GEN;PL
Ablehnen	Ablehnen	N;ACC;NEUT;SG
Querkopf	Querkopfes	N;GEN;MASC;SG
langstängelig	am langstängeligsten	ADJ;SPRL
dürsten	dürsten	V;SBJV;PL;3;PRS
Korvette	Korvetten	N;ACC;FEM;PL
Grundriss	Grundrisse	N;ACC;MASC;PL
Birkhuhn	Birkhühner	N;ACC;PL
abbekommen	bekommst ab	V;IND;SG;2;PRS
Körperübung	Körperübungen	N;ACC;FEM;PL
Nukleon	Nukleonen	N;DAT;PL
Wandergewerbe	Wandergewerbes	N;GEN;NEUT;SG
zerbeißen	zerbissen	V.PTCP;PST
friedvoll	friedvollem	ADJ;DAT;NEUT;SG
Quacksalber	Quacksalber	N;ACC;MASC;SG
luzid	am luzidesten	ADJ;SPRL
Wegge	Wegges	N;GEN;MASC;SG
Heliumkern	Heliumkernen	N;DAT;MASC;PL
Anstrengung	Anstrengung	N;GEN;SG
Rotte	Rotten	N;ACC;PL
trotten	getrottet	V.PTCP;PST
Lebensmittelhandlung	Lebensmittelhandlungen	N;NOM;PL
abblenden	blendete ab	V;SBJV;SG;3;PST
Hoheit	Hoheit	N;DAT;SG
freipressen	presst frei	V;IND;SG;3;PRS
Bärenfellmütze	Bärenfellmütze	N;NOM;FEM;SG
zeihen	zeih	V;IMP;SG;2
Horizont	Horizont	N;NOM;MASC;SG
Schauplatz	Schauplatz	N;NOM;SG
köcheln	köchelest	V;SBJV;SG;2;PRS
überwiegen	überwogst	V;IND;SG;2;PST
verunzieren	verunzierest	V;SBJV;SG;2;PRS
Dichtungsmaterial	Dichtungsmaterial	N;ACC;NEUT;SG
munter	munterem	ADJ;DAT;MASC;SG
zeihen	geziehen	V.PTCP;PST
entledigen	entledigten	V;SBJV;PL;3;PST
widersprüchlich	widersprüchlichem	ADJ;DAT;MASC;SG
Kante	Kante	N;GEN;SG
Genugtuung	Genugtuung	N;GEN;FEM;SG
Gaunersprache	Gaunersprachen	N;DAT;PL
Krüglein	Krüglein	N;NOM;NEUT;PL
aussuchen	suchte aus	V;IND;SG;1;PST
Blechteil	Blechteile	N;NOM;PL
euroskeptisch	euroskeptischer	ADJ;GEN;PL
anstauen	stauten an	V;IND;PL;1;PST
Orgelmetall	Orgelmetalle	N;NOM;NEUT;PL
Hakenkreuz	Hakenkreuze	N;NOM;PL
künstlich	künstlicher	ADJ;GEN;FEM;SG
verlachen	verlachte	V;IND;SG;1;PST
Gebresten	Gebrestens	N;GEN;NEUT;SG
Krug	Krug	N;NOM;MASC;SG
Nanojoule	Nanojoule	N;ACC;NEUT;PL
einbrennen	brennst ein	V;IND;SG;2;PRS
schließen	schließt 	V;IND;PL;2;PRS
angucken	guckte an	V;SBJV;SG;3;PST
Mesoarchaikum	Mesoarchaikums	N;GEN;SG
Seuche	Seuche	N;DAT;FEM;SG
ausbessern	besserten an	V;SBJV;PL;3;PST
Schulwart	Schulwarte	N;ACC;MASC;PL
abstempeln	stempeltest ab	V;IND;SG;2;PST
Attaché	Attachés	N;NOM;PL
Himmelsschreiberin	Himmelsschreiberin	N;DAT;SG
Sage	Sage	N;ACC;SG
deppert	depperten	ADJ;GEN;NEUT;SG
galvanisieren	galvanisieren	V;IND;PL;1;PRS
malmen	malmtest	V;IND;SG;2;PST
Schützenfest	Schützenfeste	N;GEN;NEUT;PL
verbunden	verbundene	ADJ;NOM;PL
Rohr	Rohren	N;DAT;PL
Buchstabenkurzwort	Buchstabenkurzwörtern	N;DAT;NEUT;PL
verarbeiten	verarbeitet	V;IND;PL;2;PRS
Deckel	Deckel	N;NOM;MASC;PL
Krebsarzt	Krebsärzte	N;NOM;PL
Käfterchen	Käfterchen	N;GEN;NEUT;PL
Abberufung	Abberufungen	N;GEN;PL
Sturm	Sturm	N;DAT;SG
merken	merkend	V.PTCP;PRS
ächten	ächtete	V;IND;SG;1;PST
Pläsier	Pläsier	N;DAT;NEUT;SG
Trauring	Trauring	N;NOM;SG
schnörkellos	schnörkelloses	ADJ;ACC;NEUT;SG
Nanokristall	Nanokristall	N;ACC;MASC;SG
hinkriegen	hinzukriegen	V;NFIN;LGSPEC01
Veröffentlichen	Veröffentlichen	N;NOM;NEUT;SG
assyrisch	assyrisches	ADJ;NOM;NEUT;SG
Safran	Safrane	N;ACC;MASC;PL
gestresst	gestresstem	ADJ;DAT;NEUT;SG
finster	finsteres	ADJ;ACC;NEUT;SG
Hellblau	Hellblau(s)	N;NOM;NEUT;PL
Kamikaze	Kamikaze	N;ACC;MASC;PL
neuartig	neuartige	ADJ;ACC;FEM;SG
Ordensschwester	Ordensschwestern	N;ACC;FEM;PL
hineingehen	gehe hinein	V;SBJV;SG;1;PRS
Elfer	Elfer	N;ACC;MASC;PL
lässig	lässiger	ADJ;GEN;PL
aufprägen	prägen auf	V;SBJV;PL;1;PRS
basieren	basierest	V;SBJV;SG;2;PRS
Fachjargon	Fachjargons	N;NOM;PL
abmeiern	meierten ab	V;SBJV;PL;1;PST
geifern	geifert	V;IND;SG;3;PRS
Demokrat	Demokraten	N;DAT;MASC;PL
Chloroform	Chloroforms	N;GEN;SG
Podiumsgespräch	Podiumsgespräche	N;ACC;PL
Slowakisch	Slowakischs	N;GEN;SG
Schöpflöffel	Schöpflöffel	N;NOM;MASC;SG
Bärendienst	Bärendienst	N;ACC;SG
Aluminium	Aluminiums	N;GEN;NEUT;SG
Gefängnis	Gefängnis	N;ACC;NEUT;SG
anschwellen	schwellen an	V;SBJV;PL;1;PRS
wohlbestallt	wohlbestallten	ADJ;DAT;PL
supplieren	suppliere	V;IND;SG;1;PRS
innewohnen	wohntest inne	V;IND;SG;2;PST
unislamisch	am unislamischsten	ADJ;SPRL
vorbeifahren	führe vorbei	V;SBJV;SG;3;PST
auslaufsicher	auslaufsicheren	ADJ;GEN;NEUT;SG
Knopf	Knöpfe	N;GEN;PL
Penthouse	Penthouses	N;NOM;NEUT;PL
Milchfieber	Milchfieber	N;ACC;NEUT;PL
Brieffreundin	Brieffreundin	N;DAT;FEM;SG
Schwinglaut	Schwinglaute	N;GEN;MASC;PL
Pfarrerin	Pfarrerin	N;GEN;FEM;SG
Erscheinung	Erscheinung	N;ACC;SG
umlegen	legten um	V;SBJV;PL;3;PST
Orientierung	Orientierung	N;DAT;SG
Warenmuster	Warenmustern	N;DAT;NEUT;PL
strauchen	strauche	V;IND;SG;1;PRS
Entnazifizierung	Entnazifizierung	N;GEN;SG
gedeihen	gedieh	V;IND;SG;3;PST
Stachelgurke	Stachelgurke	N;DAT;SG
rollig	rollige	ADJ;NOM;PL
losprügeln	prügel los	V;IMP;SG;2
zerreiben	zerriebest	V;SBJV;SG;2;PST
Comeback	Comebacks	N;DAT;NEUT;PL
bahnen	bahntest	V;SBJV;SG;2;PST
Halogenid	Halogenid	N;NOM;SG
freveln	frevelt	V;IMP;PL;2
Aufzeichnung	Aufzeichnung	N;NOM;SG
abblasen	bliesest ab	V;IND;SG;2;PST
haaren	haarten	V;IND;PL;3;PST
betucht	am betuchtesten	ADJ;SPRL
Rötung	Rötung	N;ACC;FEM;SG
versehen	versaht	V;IND;PL;2;PST
Berliner	Berliner	N;ACC;MASC;SG
begehen	beginget	V;SBJV;PL;2;PST
anstauen	stautet an	V;SBJV;PL;2;PST
versechsfachen	versechsfachtet	V;SBJV;PL;2;PST
Einbürgerung	Einbürgerung	N;ACC;FEM;SG
Firmenname	Firmennamen	N;DAT;SG
aufwischen	wische auf	V;SBJV;SG;1;PRS
Bioladen	Bioläden	N;NOM;MASC;PL
zulangen	lange zu	V;IND;SG;1;PRS
neumodig	neumodigen	ADJ;ACC;MASC;SG
Pyrosulfit	Pyrosulfite	N;ACC;PL
Schnürchen	Schnürchen	N;NOM;NEUT;PL
Antimuster	Antimustern	N;DAT;PL
abnehmen	nahmen ab	V;IND;PL;3;PST
blondieren	blondierend	V.PTCP;PRS
leisten	leistete	V;SBJV;SG;1;PST
halsen	hals	V;IMP;SG;2
Nordlicht	Nordlichter	N;NOM;NEUT;PL
Telefonat	Telefonates	N;GEN;SG
Wurt	Wurt	N;NOM;SG
Stiftungsurkunde	Stiftungsurkunde	N;GEN;FEM;SG
Menschwerdung	Menschwerdungen	N;GEN;FEM;PL
Allotria	Allotrias	N;GEN;NEUT;SG
unterjochen	unterjoche	V;SBJV;SG;3;PRS
üblich	üblichen	ADJ;DAT;PL
herausreden	redet heraus	V;IND;PL;2;PRS
Literatur	Literaturen	N;NOM;FEM;PL
blöd	blödem	ADJ;DAT;NEUT;SG
verzeichnen	verzeichne	V;SBJV;SG;1;PRS
Blindschleiche	Blindschleichen	N;NOM;FEM;PL
Erzherzogshütchen	Erzherzogshütchen	N;ACC;PL
begegnen	begegne	V;SBJV;SG;1;PRS
Prior	Prior	N;DAT;MASC;SG
ertüchtigen	ertüchtigt	V;IND;PL;2;PRS
kindgerecht	am kindgerechtesten	ADJ;SPRL
kaduk	kaduken	ADJ;GEN;NEUT;SG
Heiler	Heiler	N;DAT;MASC;SG
Nomokratiechen	Nomokratiechen	N;DAT;SG
bestreuen	bestreuten	V;SBJV;PL;3;PST
reanimieren	reanimierten	V;SBJV;PL;3;PST
Studentenblume	Studentenblume	N;NOM;SG
koexistieren	koexistiertest	V;SBJV;SG;2;PST
Männerfreundschaft	Männerfreundschaft	N;NOM;SG
Hupe	Hupe	N;NOM;SG
Autobahn	Autobahnen	N;GEN;FEM;PL
Meter	Meter	N;GEN;PL
vergöttern	vergöttern	V;IND;PL;3;PRS
Anlaufen	Anlaufen	N;NOM;NEUT;SG
Frühzündung	Frühzündung	N;DAT;FEM;SG
verbreiten	verbreiten	V;SBJV;PL;3;PRS
dealen	dealend	V.PTCP;PRS
Ankönnen	Ankönnen	N;ACC;NEUT;SG
Bärlauch	Bärlauch	N;NOM;SG
Mittellinie	Mittellinien	N;DAT;FEM;PL
verfahren	verfährst	V;IND;SG;2;PRS
Anzeigegerät	Anzeigegerät	N;ACC;SG
erschrecken	erschreck	V;IMP;SG;2
Gouache	Gouachen	N;GEN;FEM;PL
Madrigal	Madrigale	N;NOM;PL
Zinnerz	Zinnerzen	N;DAT;NEUT;PL
rumsen	rumsest	V;SBJV;SG;2;PRS
fundamental	fundamentalen	ADJ;GEN;NEUT;SG
verwittern	verwitterte	V;IND;SG;1;PST
Stöckel	Stöckel	N;ACC;NEUT;SG
wieselig	wieseligen	ADJ;DAT;PL
niederlegen	lege nieder	V;SBJV;SG;1;PRS
degagiert	degagiertem	ADJ;DAT;MASC;SG
missgönnen	missgönnen	V;SBJV;PL;1;PRS
Volatilität	Volatilität	N;ACC;SG
Atemluft	Atemluft	N;GEN;FEM;SG
Steg	Steges	N;GEN;SG
klüngeln	klüngelte	V;IND;SG;3;PST
wegfahren	fahren weg	V;IND;PL;3;PRS
Sichel	Sicheln	N;DAT;FEM;PL
Rind	Rind	N;NOM;SG
erfüllen	erfüllt	V;IND;PL;2;PRS
auftauchen	tauch auf	V;IMP;SG;2
skrofulös	skrofulösen	ADJ;GEN;NEUT;SG
Großbuchstabe	Großbuchstaben	N;ACC;MASC;SG
Ligandenaustausch	Ligandenaustausch	N;DAT;SG
Versenden	Versendens	N;GEN;NEUT;SG
Feuerwehrschlauch	Feuerwehrschlauche	N;DAT;MASC;SG
verharmlosen	verharmlosen	V;SBJV;PL;3;PRS
Crevette	Crevetten	N;GEN;PL
Amphibol	Amphibole	N;GEN;MASC;PL
Nanosatellit	Nanosatelliten	N;ACC;MASC;SG
untauglich	untaugliche	ADJ;ACC;FEM;SG
wiedersehen	sehen wieder	V;SBJV;PL;1;PRS
Externistin	Externistinnen	N;ACC;FEM;PL
Brutreaktor	Brutreaktoren	N;NOM;PL
Tangotänzer	Tangotänzer	N;GEN;MASC;PL
Tribromid	Tribromid	N;ACC;SG
fromm	frommes	ADJ;NOM;NEUT;SG
Hehler	Hehler	N;ACC;SG
Elektrophil	Elektrophil	N;ACC;NEUT;SG
kalorienreich	kalorienreichem	ADJ;DAT;MASC;SG
Herrscher	Herrschern	N;DAT;MASC;PL
Frachtschiff	Frachtschiffen	N;DAT;PL
Verbandsgemeinde	Verbandsgemeinden	N;GEN;FEM;PL
Oregano	Oregano	N;DAT;MASC;SG
metabolisieren	metabolisierst	V;IND;SG;2;PRS
kontaktieren	kontaktierten	V;IND;PL;3;PST
krumpelig	krumpelige	ADJ;NOM;PL
Schaufensterpuppe	Schaufensterpuppe	N;NOM;FEM;SG
Rüsche	Rüsche	N;DAT;SG
Lager	Lager	N;NOM;NEUT;PL
vertrauen	vertraut	V;IND;SG;3;PRS
irrig	irrigen	ADJ;GEN;MASC;SG
Impressionist	Impressionisten	N;ACC;SG
Eigentor	Eigentore	N;GEN;PL
Halbwertszeit	Halbwertszeiten	N;NOM;PL
hydrolysieren	hydrolysieren	V;SBJV;PL;1;PRS
Kloake	Kloake	N;NOM;FEM;SG
systematisieren	systematisieren	V;NFIN
Strukturprotein	Strukturprotein	N;DAT;NEUT;SG
hammermäßig	hammermäßige	ADJ;NOM;PL
Schwanzwort	Schwanzwörter	N;GEN;NEUT;PL
chillen	chillten	V;SBJV;PL;1;PST
Geschwader	Geschwadern	N;DAT;NEUT;PL
anklingeln	anklingeln	V;NFIN
Geste	Geste	N;DAT;FEM;SG
Abalienation	Abalienationen	N;NOM;PL
erkranken	erkrankten	V;IND;PL;3;PST
Wäsche	Wäschen	N;NOM;PL
Widerspiel	Widerspiele	N;DAT;NEUT;SG
xenophobisch	xenophobischen	ADJ;GEN;NEUT;SG
Rennerin	Rennerinnen	N;ACC;FEM;PL
lästern	gelästert	V.PTCP;PST
desiderabel	desiderabeles	ADJ;ACC;NEUT;SG
Haarwaschmittel	Haarwaschmittels	N;GEN;NEUT;SG
Bistro	Bistros	N;GEN;PL
mitgeben	gäbet mit	V;SBJV;PL;2;PST
Putzmann	Putzmanne	N;DAT;MASC;SG
Gesamtjahr	Gesamtjahren	N;DAT;NEUT;PL
krampfen	krampfte	V;IND;SG;1;PST
haltlos	haltlose	ADJ;ACC;FEM;SG
Springpferd	Springpferden	N;DAT;NEUT;PL
ahistorisch	ahistorischem	ADJ;DAT;MASC;SG
philiströs	philiströsen	ADJ;ACC;MASC;SG
Sprichwort	Sprichwörter	N;GEN;NEUT;PL
bereisen	bereiste	V;SBJV;SG;3;PST
entfallen	entfallen	V;SBJV;PL;3;PRS
verpetzen	verpetzt	V;IMP;PL;2
Petersfisch	Petersfische	N;GEN;PL
anlaufen	laufen an	V;SBJV;PL;1;PRS
spreizen	spreizte	V;IND;SG;1;PST
hinzufügen	fügte hinzu	V;SBJV;SG;1;PST
Kerzchen	Kerzchen	N;ACC;NEUT;PL
Rotgültigerz	Rotgültigerze	N;GEN;PL
Eselsbrücke	Eselsbrücken	N;GEN;FEM;PL
hochherzig	hochherzigem	ADJ;DAT;MASC;SG
Kernthema	Kernthemen	N;DAT;NEUT;PL
Golddistel	Golddistel	N;DAT;FEM;SG
bezweifeln	bezweifeltest	V;IND;SG;2;PST
beglaubigen	beglaubigtet	V;IND;PL;2;PST
stereoselektiv	stereoselektivem	ADJ;DAT;MASC;SG
abklingen	abzuklingen	V;NFIN;LGSPEC01
Sortiment	Sortimente	N;NOM;NEUT;PL
Ostmark	Ostmark	N;GEN;FEM;SG
hinabklettern	kletter hinab	V;IMP;SG;2
Botschafterin	Botschafterinnen	N;DAT;FEM;PL
aufraffen	rafft auf	V;IND;SG;3;PRS
Vielweiberei	Vielweiberei	N;DAT;FEM;SG
tatterig	tatterigen	ADJ;GEN;MASC;SG
Judendeutsch	Judendeutsch	N;DAT;NEUT;SG
Erlös	Erlöse	N;NOM;PL
Zins	Zinsen	N;DAT;MASC;PL
missbilligen	missbilligtest	V;IND;SG;2;PST
apollinisch	apollinischen	ADJ;ACC;MASC;SG
Elfenbeinküste	Elfenbeinküste	N;DAT;SG
beschaffen	beschaffet	V;SBJV;PL;2;PRS
Benediktiner	Benediktiners	N;GEN;MASC;SG
Bundeskanzlerin	Bundeskanzlerin	N;NOM;FEM;SG
Luftpolsterfolie	Luftpolsterfolie	N;GEN;SG
zanken	zankest	V;SBJV;SG;2;PRS
selbstmörderisch	am selbstmörderischsten	ADJ;SPRL
Schnepfe	Schnepfe	N;DAT;SG
enterben	enterbe	V;SBJV;SG;3;PRS
grenzwertig	grenzwertige	ADJ;NOM;FEM;SG
Herbstgrasmilbe	Herbstgrasmilbe	N;NOM;FEM;SG
After	After	N;GEN;MASC;PL
Wahnsinn	Wahnsinn	N;ACC;SG
engherzig	engherziges	ADJ;ACC;NEUT;SG
Willenskraft	Willenskräfte	N;GEN;FEM;PL
getreu	getreue	ADJ;ACC;PL
aufklären	kläre auf	V;IND;SG;1;PRS
gigantisch	gigantischem	ADJ;DAT;NEUT;SG
sackartig	sackartiger	ADJ;CMPR
Abschwung	Abschwung	N;NOM;MASC;SG
Mikrokristall	Mikrokristall	N;NOM;MASC;SG
Turbine	Turbine	N;NOM;FEM;SG
faulen	faule	V;SBJV;SG;1;PRS
Krake	Kraken	N;GEN;MASC+FEM;PL
zurichten	richtest zu	V;IND;SG;2;PRS
zuwarten	wartetet zu	V;SBJV;PL;2;PST
umarbeiten	umarbeite	V;IMP;SG;2
destruktiv	destruktiver	ADJ;NOM;MASC;SG
vorhersehen	sehet vorher	V;SBJV;PL;2;PRS
schönfärben	färbte schön	V;SBJV;SG;3;PST
aufbegehren	begehren auf	V;IND;PL;3;PRS
Anthropologin	Anthropologin	N;GEN;FEM;SG
vorsagen	sagtest vor	V;SBJV;SG;2;PST
Höllenlärm	Höllenlärmes	N;GEN;MASC;SG
mythisch	am mythischsten	ADJ;SPRL
ermahnen	ermahne	V;SBJV;SG;3;PRS
Teetasse	Teetassen	N;GEN;FEM;PL
Schrein	Schreines	N;GEN;MASC;SG
Abbauort	Abbauorten	N;DAT;MASC;PL
erschlaffen	erschlaffest	V;SBJV;SG;2;PRS
entspringen	entspringen	V;IND;PL;3;PRS
Faustschlag	Faustschlage	N;DAT;MASC;SG
umpflanzen	umpflanzest	V;SBJV;SG;2;PRS
haltmachen	macht halt	V;IMP;PL;2
dementieren	dementieren	V;SBJV;PL;1;PRS
weithergeholt	weithergeholtem	ADJ;DAT;NEUT;SG
Scherbrett	Scherbrettes	N;GEN;NEUT;SG
benötigen	benötigtest	V;IND;SG;2;PST
Oberlippe	Oberlippe	N;ACC;FEM;SG
Zentralnervensystem	Zentralnervensystem	N;NOM;SG
schnippisch	schnippische	ADJ;ACC;PL
Zauberkunststückchen	Zauberkunststückchen	N;ACC;NEUT;PL
umrühren	umrührend	V.PTCP;PRS
Abtrennung	Abtrennung	N;ACC;SG
Zwiebelfisch	Zwiebelfische	N;ACC;MASC;PL
entbinden	entbände	V;SBJV;SG;3;PST
Merseburgerin	Merseburgerinnen	N;ACC;MASC;PL
kommen	kam	V;IND;SG;1;PST
zähmen	zähme	V;SBJV;SG;1;PRS
killen	kill	V;IMP;SG;2
sekkant	sekkanten	ADJ;DAT;PL
Autogramm	Autogramme	N;GEN;PL
sträuben	gesträubt	V.PTCP;PST
beschließen	beschließe 	V;IND;SG;1;PRS
Gefangensein-Syndrom	Gefangensein-Syndrom	N;DAT;SG
verschmelzen	verschmolzen	V;IND;PL;1;PST
Hausaltar	Hausaltäre	N;ACC;MASC;PL
Schweinchen	Schweinchen	N;ACC;PL
lohnenswert	lohnenswerten	ADJ;GEN;NEUT;SG
Karausche	Karausche	N;ACC;FEM;SG
Basalt	Basalte	N;GEN;MASC;PL
eigentlich	eigentlichen	ADJ;DAT;PL
Wäscher	Wäscher	N;GEN;MASC;PL
glattzüngig	glattzüngiger	ADJ;DAT;FEM;SG
Hirntod	Hirntode	N;DAT;MASC;SG
Verwelken	Verwelken	N;DAT;NEUT;SG
Thüringer	Thüringer	N;ACC;SG
Blasenentzündung	Blasenentzündung	N;GEN;SG
Polysilan	Polysilan	N;ACC;NEUT;SG
Abgas	Abgase	N;GEN;NEUT;PL
Zyklus	Zyklus	N;NOM;MASC;SG
verjuden	verjudete	V;SBJV;SG;3;PST
Botschafter	Botschafter	N;GEN;PL
Maschinenfabrik	Maschinenfabriken	N;ACC;PL
Frühschoppen	Frühschoppen	N;DAT;SG
Teilchen	Teilchen	N;NOM;SG
Weltfrieden	Weltfrieden	N;DAT;SG
unterminieren	unterminierten	V;IND;PL;1;PST
schiefern	schiefert	V;IMP;PL;2
verzeichnen	verzeichnend	V.PTCP;PRS
spazieren	spazierend	V.PTCP;PRS
anbrennen	anbrennend	V.PTCP;PRS
schwanken	schwanket	V;SBJV;PL;2;PRS
empfehlen	empfahlen	V;IND;PL;1;PST
zügeln	zügelten	V;IND;PL;3;PST
Braut	Bräute	N;GEN;PL
Marke	Marke	N;DAT;SG
ambivalent	ambivalenten	ADJ;GEN;NEUT;SG
evasiv	evasiven	ADJ;ACC;MASC;SG
Höslein	Höslein	N;DAT;NEUT;SG
Teewärmer	Teewärmer	N;ACC;MASC;PL
rausfliegen	fliegen raus	V;IND;PL;3;PRS
Halit	Haliten	N;DAT;MASC;PL
durchziehen	durchziehen	V;IND;PL;1;PRS
schärfen	schärf	V;IMP;SG;2
todesmutig	todesmutigem	ADJ;DAT;NEUT;SG
Siphon	Siphons	N;NOM;MASC+NEUT;PL
frustrieren	frustrierte	V;SBJV;SG;1;PST
keck	kecke	ADJ;NOM;FEM;SG
Auszeichnung	Auszeichnungen	N;DAT;FEM;PL
Latz	Latze	N;GEN;MASC;PL
verwanzen	verwanzten	V;SBJV;PL;3;PST
stürzen	gestürzt	V.PTCP;PST
Seiltänzer	Seiltänzers	N;GEN;MASC;SG
Biest	Biester	N;NOM;PL
abregen	abregend	V.PTCP;PRS
Nachname	Nachnamen	N;ACC;SG
mitgeben	gebt mit	V;IND;PL;2;PRS
umsatteln	satteln um	V;SBJV;PL;3;PRS
schneesicher	schneesicheren	ADJ;GEN;MASC;SG
dünnhäutig	dünnhäutigen	ADJ;ACC;MASC;SG
Beförderung	Beförderung	N;ACC;FEM;SG
bekreuzen	bekreuzten	V;IND;PL;3;PST
Fäulnis	Fäulnis	N;NOM;FEM;SG
bezeichnen	bezeichnet	V;IND;SG;3;PRS
Frakturschrift	Frakturschrift	N;DAT;FEM;SG
beachten	beachte	V;IND;SG;1;PRS
Härtung	Härtungen	N;NOM;PL
umpflanzen	umpflanzet	V;SBJV;PL;2;PRS
Iraner	Iraners	N;GEN;SG
entenartig	entenartigem	ADJ;DAT;NEUT;SG
Matrose	Matrosen	N;ACC;MASC;SG
tiefstapeln	tiefstapelnd	V.PTCP;PRS
Grundriss	Grundriss	N;ACC;MASC;SG
Häcksler	Häckslers	N;GEN;MASC;SG
Intuition	Intuitionen	N;NOM;PL
altpersisch	altpersischer	ADJ;DAT;FEM;SG
Tide	Tiden	N;GEN;FEM;PL
auswachsen	wüchsen aus	V;SBJV;PL;1;PST
Vorständin	Vorständinnen	N;GEN;FEM;PL
Röhre	Röhre	N;GEN;SG
schützen	schützte	V;SBJV;SG;3;PST
Dualsystem	Dualsystems	N;GEN;NEUT;SG
Bigotterie	Bigotterie	N;DAT;FEM;SG
Bonapartemöwe	Bonapartemöwen	N;NOM;PL
nebelig	nebeligen	ADJ;DAT;PL
bilderreich	am bilderreichsten	ADJ;SPRL
knoten	knote	V;SBJV;SG;3;PRS
Anhalt	Anhalte	N;DAT;MASC;SG
Mehrfachvererbung	Mehrfachvererbung	N;DAT;SG
verbittern	verbitterst	V;IND;SG;2;PRS
treideln	treideln	V;IND;PL;1;PRS
gruselig	gruselige	ADJ;ACC;PL
Schierling	Schierlings	N;GEN;MASC;SG
Rückmeldung	Rückmeldung	N;GEN;SG
Etikett	Etikette	N;NOM;PL
Gummibaum	Gummibaum	N;DAT;SG
nordöstlich	nordöstlichen	ADJ;GEN;MASC;SG
Exzellenz	Exzellenzen	N;NOM;PL
einsehbar	einsehbarer	ADJ;DAT;FEM;SG
möppern	möpper	V;IND;SG;1;PRS
wütend	wütende	ADJ;ACC;FEM;SG
versteinern	versteinerten	V;SBJV;PL;1;PST
Nordpol	Nordpol	N;ACC;MASC;SG
Beinfreiheit	Beinfreiheit	N;GEN;FEM;SG
knüpfen	knüpfte	V;SBJV;SG;3;PST
peitschen	peitschtet	V;SBJV;PL;2;PST
beobachten	beobachtetet	V;IND;PL;2;PST
Vernarren	Vernarrens	N;GEN;NEUT;SG
Pfirsich	Pfirsich	N;ACC;SG
Auswertung	Auswertung	N;ACC;SG
Mastdarmakrobat	Mastdarmakrobaten	N;DAT;PL
Kloster	Klöster	N;GEN;NEUT;PL
skoptisch	skoptischem	ADJ;DAT;NEUT;SG
Bimetall	Bimetalle	N;NOM;PL
Minutenzeiger	Minutenzeiger	N;DAT;MASC;SG
docken	docken	V;NFIN
verprassen	verprassen	V;NFIN
Geschwister	Geschwister	N;NOM;NEUT;PL
Iodat	Iodat	N;ACC;SG
schlürfen	schlürfte	V;IND;SG;1;PST
Tatsachenbeschöniger	Tatsachenbeschönigern	N;DAT;MASC;PL
Stuck	Stuck	N;ACC;MASC;SG
vereinbaren	vereinbart	V;IND;PL;2;PRS
beaufsichtigen	beaufsichtige	V;IND;SG;1;PRS
Petschaft	Petschaft	N;NOM;SG
Fusion	Fusion	N;GEN;FEM;SG
submissiv	submissiver	ADJ;NOM;MASC;SG
Fluorohydrid	Fluorohydride	N;GEN;PL
Azidose	Azidose	N;DAT;SG
wundern	wunder	V;IMP;SG;2
ernüchtern	ernüchtertet	V;SBJV;PL;2;PST
flügeln	flügelte	V;SBJV;SG;1;PST
Vorzug	Vorzüge	N;GEN;PL
Automatisierungstechnik	Automatisierungstechnik	N;GEN;FEM;SG
übermögen	übermögen	V;SBJV;PL;1;PRS
formbar	formbares	ADJ;ACC;NEUT;SG
Sparschwein	Sparschweine	N;ACC;PL
fantastisch	fantastischer	ADJ;CMPR
färben	färbet	V;SBJV;PL;2;PRS
Brandzeichen	Brandzeichen	N;ACC;SG
repressiv	repressive	ADJ;NOM;FEM;SG
gefallen	gefalle	V;SBJV;SG;1;PRS
Mäzen	Mäzene	N;GEN;MASC;PL
Veste	Vesten	N;DAT;PL
misogyn	misogyner	ADJ;NOM;MASC;SG
Zuckerhut	Zuckerhutes	N;GEN;MASC;SG
Lüge	Lüge	N;GEN;FEM;SG
Atlas	Atlanten	N;DAT;MASC;SG
abschnallen	schnallten ab	V;SBJV;PL;3;PST
Köder	Köder	N;ACC;MASC;SG
Gasbeleuchtung	Gasbeleuchtung	N;NOM;FEM;SG
Türkin	Türkin	N;DAT;SG
funkeln	funkelte	V;IND;SG;3;PST
haarartig	haarartige	ADJ;ACC;PL
Geschäftssinn	Geschäftssinn	N;ACC;MASC;SG
erhärten	härteten	V;SBJV;PL;1;PST
Wandergewerbe	Wandergewerbe	N;ACC;NEUT;PL
dreschen	drischt	V;IND;SG;3;PRS
verdämmern	verdämmerest	V;SBJV;SG;2;PRS
kunstfertig	kunstfertige	ADJ;NOM;FEM;SG
umtreiben	trieben um	V;IND;PL;1;PST
welk	welken	ADJ;DAT;PL
Geschäftstätigkeit	Geschäftstätigkeit	N;DAT;SG
Schwager	Schwager	N;DAT;SG
stückeln	stückelten	V;IND;PL;1;PST
putzen	putztest	V;IND;SG;2;PST
Sepiolith	Sepiolith	N;ACC;MASC;SG
Elementarteilchen	Elementarteilchen	N;GEN;PL
hinfahren	führest hin	V;SBJV;SG;2;PST
Kulturlandschaft	Kulturlandschaft	N;ACC;FEM;SG
Flotte	Flotte	N;NOM;FEM;SG
Servilität	Servilität	N;ACC;FEM;SG
abschirmen	schirmte ab	V;IND;SG;3;PST
völkisch	völkische	ADJ;ACC;PL
achtbar	achtbaren	ADJ;ACC;MASC;SG
Wasserstoffion	Wasserstoffion	N;ACC;NEUT;SG
Arbeitsbereich	Arbeitsbereiche	N;ACC;MASC;PL
ranghoch	ranghohes	ADJ;ACC;NEUT;SG
Crashkurs	Crashkurs	N;NOM;MASC;SG
Stieglitz	Stieglitzes	N;GEN;SG
ersuchen	ersuchen	V;NFIN
Vertrauensperson	Vertrauensperson	N;ACC;SG
verknöchert	verknöcherter	ADJ;GEN;FEM;SG
Musikinstrument	Musikinstrument	N;DAT;SG
Kelter	Kelter	N;GEN;MASC;SG
anstehen	ständen an	V;SBJV;PL;1;PST
Borosilikatglas	Borosilikatglas	N;NOM;SG
abhold	abholde	ADJ;NOM;FEM;SG
Hahnrei	Hahnreie	N;NOM;MASC;PL
Unreife	Unreife	N;DAT;FEM;SG
Saxophonist	Saxophonisten	N;GEN;MASC;SG
umkristallisieren	umkristallisierend	V.PTCP;PRS
Blender	Blender	N;NOM;PL
genialisch	genialischen	ADJ;DAT;PL
Verbundwerkstoff	Verbundwerkstoff	N;ACC;SG
löchrig	löchrigen	ADJ;DAT;PL
beglücken	beglücktet	V;SBJV;PL;2;PST
Anissamen	Anissamens	N;GEN;MASC;SG
Cappuccino	Cappuccinos	N;GEN;MASC;PL
Gemisch	Gemische	N;GEN;PL
religiös	religiöser	ADJ;GEN;PL
Nachtsichtgerät	Nachtsichtgerät	N;ACC;NEUT;SG
weiten	weitete	V;IND;SG;1;PST
Strafe	Strafe	N;ACC;FEM;SG
Gouverneur	Gouverneurs	N;GEN;MASC;SG
Entrundung	Entrundungen	N;DAT;FEM;PL
verfeinden	verfeindete	V;IND;SG;1;PST
Quelle	Quellen	N;ACC;PL
formen	formten	V;IND;PL;3;PST
chimärisch	chimärische	ADJ;ACC;FEM;SG
Bankett	Bankettes	N;GEN;SG
Dithiolan	Dithiolane	N;NOM;NEUT;PL
Aufklärung	Aufklärungen	N;NOM;FEM;PL
Golfplatz	Golfplatzes	N;GEN;SG
Wiederfinden	Wiederfinden	N;DAT;NEUT;SG
Siderit	Siderit	N;NOM;SG
chatten	chatten	V;NFIN
