undertint	undertint	N;SG
mizzy	mizzy	N;SG
quixotry	quixotry	N;SG
biofilter	biofilter	N;SG
jettage	jettage	N;SG
evapotranspire	evapotranspiring	V;V.PTCP;PRS
rillette	rillette	N;SG
airt	airted	V;PST
carboxyglutamate	carboxyglutamates	N;PL
apolytikion	apolytikion	N;SG
palaeovegetational	palaeovegetational	ADJ
dedicand	dedicands	N;PL
dolichosaurid	dolichosaurid	N;SG
shorefront	shorefront	N;SG
thermocouple	thermocouples	N;PL
eupulmonate	eupulmonate	N;SG
chare	chares	V;PRS;3;SG
prerun	prerun	V;NFIN
gayism	gayism	N;SG
passionlessness	passionlessness	N;SG
wivern	wivern	N;SG
venosity	venosity	N;SG
teston	testons	N;PL
carbynic	carbynic	ADJ
limn	limn	V;NFIN
obdurance	obdurance	N;SG
chromanol	chromanol	N;SG
spyism	spyism	N;SG
contrivition	contrivition	N;SG
epiphanal	epiphanal	ADJ
kazi	kazis	N;PL
coumaric	coumaric	ADJ
disfigurer	disfigurers	N;PL
dimed	dimed	ADJ
mamma	mammae	N;PL
rescale	rescaled	V;PST
custodee	custodees	N;PL
revolving	revolving	N;SG
bipedicular	bipedicular	ADJ
dentinal	dentinal	ADJ
gastroenteric	gastroenteric	ADJ
enhearten	enheartening	V;V.PTCP;PRS
callrate	callrate	N;SG
coquette	coquette	N;SG
Croatness	Croatness	N;SG
CSI	CSI	N;SG
sportfish	sportfish	N;SG
skiboarding	skiboarding	N;SG
crinkums	crinkums	N;SG
CARIN	CARIN	N;SG
phosphoantigen	phosphoantigen	N;SG
guardian	guardian	N;SG
line	lined	V;PST
undistinct	undistinct	ADJ
unassociate	unassociated	V;V.PTCP;PST
thymolsulphonephthalein	thymolsulphonephthalein	N;SG
carbazochrome	carbazochrome	N;SG
blotching	blotchings	N;PL
stop-over	stop-over	N;SG
tissue	tissue	V;NFIN
stulm	stulm	N;SG
biotherapist	biotherapists	N;PL
fuster	fuster	V;NFIN
clobber	clobbers	V;PRS;3;SG
marmorean	marmorean	ADJ
proinflammationary	proinflammationary	ADJ
broodchamber	broodchambers	N;PL
hula	hulaed	V;PST
doodle	doodled	V;V.PTCP;PST
multiday	multiday	ADJ
pseudospikelet	pseudospikelet	N;SG
doable	doable	ADJ
iontophoretic	iontophoretic	ADJ
rally	rallies	N;PL
preteriteness	preteriteness	N;SG
microtremor	microtremor	N;SG
teek	countable	N;PL
spec.	spec.	N;SG
preadmission	preadmission	ADJ
thank	thank	V;NFIN
pancreatectomy	pancreatectomies	N;PL
radioplay	radioplays	N;PL
ctenosauriscid	ctenosauriscid	N;SG
photobacterial	photobacterial	ADJ
quarantinist	quarantinists	N;PL
check-taker	check-taker	N;SG
quasispin	quasispin	N;SG
barcoder	barcoders	N;PL
hackbuss	hackbusses	N;PL
dado	dadoes	V;PRS;3;SG
neurodisease	neurodisease	N;SG
structural	structural	ADJ
sapelli	sapelli	N;SG
unbaptise	unbaptise	V;NFIN
sassabye	sassabye	N;SG
tachyzoite	tachyzoite	N;SG
nemegtosaurid	nemegtosaurids	N;PL
janken	janken	N;SG
sing	sings	V;PRS;3;SG
nice	niced	V;V.PTCP;PST
impounding	impounding	N;SG
multicausality	multicausality	N;SG
rouleur	rouleur	N;SG
blodge	blodged	V;PST
epithelize	epithelizing	V;V.PTCP;PRS
lactolation	lactolations	N;PL
monopeptide	monopeptide	N;SG
postosmicated	postosmicated	ADJ
reweigh	reweighed	V;V.PTCP;PST
bi	bis	N;PL
prefacer	prefacer	N;SG
overcut	overcutting	V;V.PTCP;PRS
nut	nut	N;SG
deranger	derangers	N;PL
isobacteriochlorin	isobacteriochlorins	N;PL
neckdown	neckdowns	N;PL
hydrangea	hydrangeas	N;PL
misproceeding	misproceeding	N;SG
productisation	productisation	N;SG
disinfectant	disinfectants	N;PL
ex-ante	ex-ante	ADJ
mundificant	mundificant	N;SG
Gaysoc	Gaysoc	N;SG
acetimeter	acetimeter	N;SG
tryall	tryalls	N;PL
unreliable	unreliable	ADJ
dafadar	dafadar	N;SG
unfuck	unfucked	V;V.PTCP;PST
resynch	resynch	V;NFIN
slub	slubs	V;PRS;3;SG
verapamil	verapamil	N;SG
benchpress	benchpress	N;SG
athenium	athenium	N;SG
puckout	puckout	N;SG
solidaristic	solidaristic	ADJ
castell	castell	N;SG
corban	corban	N;SG
photoset	photoset	V;NFIN
lock-pick	lock-pick	N;SG
unhasp	unhasped	V;V.PTCP;PST
NINJA	NINJA	ADJ
sad-iron	sad-iron	V;NFIN
bethak	bethaks	N;PL
fauch	fauch	N;SG
crossregulate	crossregulated	V;PST
salangid	salangids	N;PL
bemercy	bemercies	V;PRS;3;SG
approximate	approximate	V;NFIN
p.o.'ed	p.o.'ed	ADJ
ziplock	ziplock	N;SG
hydrophilite	hydrophilite	N;SG
great-pox	great-pox	N;SG
underfoot	underfoot	N;SG
projectized	projectized	ADJ
demythologise	demythologised	V;V.PTCP;PST
depolymerization	depolymerization	N;SG
aloo	aloo	N;SG
butt	butts	V;PRS;3;SG
reapologize	reapologize	V;NFIN
countersue	countersued	V;V.PTCP;PST
ocnophil	ocnophil	N;SG
maquette	maquette	N;SG
roofline	rooflines	N;PL
concertlike	concertlike	ADJ
tireling	tireling	ADJ
Junt.	Junt.	ADJ
a few fries short of a Happy Meal	a few fries short of a Happy Meal	ADJ
wag	wags	N;PL
peroxydation	peroxydations	N;PL
Wiktionary:Sandbox/Template:new en adj	Wiktionary:Sandbox/Template:new en adj	ADJ
bovrilize	bovrilized	V;V.PTCP;PST
reeve	reeved	V;V.PTCP;PST
cobaltoan	cobaltoan	ADJ
candida	candidas	N;PL
sponsorship	sponsorship	N;SG
hose	hosed	V;PST
inflector	inflector	N;SG
optoelectronics	optoelectronics	N;SG
factioneer	factioneer	N;SG
poculent	poculents	N;PL
velodrome	velodromes	N;PL
deafener	deafener	N;SG
pre-drink	pre-drink	V;NFIN
offer	offer	N;SG
rurality	rurality	N;SG
oxidate	oxidate	N;SG
butyroin	butyroin	N;SG
bereave	bereaves	V;PRS;3;SG
unthrone	unthroning	V;V.PTCP;PRS
tellinacean	tellinacean	N;SG
tray-table	tray-table	N;SG
quasireversibility	quasireversibility	N;SG
inordinateness	inordinateness	N;SG
arthroereisis	arthroereisis	N;SG
automodify	automodify	V;NFIN
tender-heartedness	tender-heartedness	N;SG
rescriptive	rescriptive	ADJ
vallicepobufagin	vallicepobufagin	N;SG
yrast	yrast	N;SG
oaktree	oaktree	N;SG
chive	chived	V;PST
celebritihood	celebritihood	N;SG
autocook	autocook	N;SG
triumphal	triumphals	N;PL
buzz-bomb	buzz-bombing	V;V.PTCP;PRS
upslope	upslopes	N;PL
leukosis	leukosis	N;SG
allegorizing	allegorizing	N;SG
smoocher	smoocher	N;SG
nosegrind	nosegrinded	V;PST
brick-red	brick-red	ADJ
compellatory	compellatory	ADJ
electroneutralize	electroneutralizing	V;V.PTCP;PRS
docosahexaenoic	docosahexaenoic	ADJ
rebear	rebears	V;PRS;3;SG
plebeianize	plebeianizing	V;V.PTCP;PRS
hoplologist	hoplologists	N;PL
provocateuse	provocateuses	N;PL
discretise	discretised	V;PST
Karata	Karata	N;SG
zenithward	zenithward	ADJ
nitroformazan	nitroformazan	N;SG
defaecate	defaecated	V;PST
flag	flags	V;PRS;3;SG
vetter	vetter	N;SG
playshed	playshed	N;SG
leucojum	leucojums	N;PL
heavy-set	heavy-set	ADJ
buttfuck	buttfucks	N;PL
immunobullous	immunobullous	ADJ
trihydroxyanthraquinone	trihydroxyanthraquinone	N;SG
xenoturbellid	xenoturbellids	N;PL
nonextinct	nonextinct	ADJ
pissery	pissery	N;SG
backshift	backshift	V;NFIN
hoof	hoofed	V;PST
e-thesis	e-thesis	N;SG
unsleeping	unsleeping	ADJ
raffle	raffled	V;PST
eicosameric	eicosameric	ADJ
intendant	intendant	N;SG
scribble	scribbles	V;PRS;3;SG
procreant	procreant	N;SG
siphonopid	siphonopids	N;PL
coimmunolabel	coimmunolabel	V;NFIN
globalizer	globalizers	N;PL
monopthong	monopthongs	N;PL
pericardioperitoneal	pericardioperitoneal	ADJ
nonwinterized	nonwinterized	ADJ
hosanna	hosanna	V;NFIN
brace	bracing	V;V.PTCP;PRS
fruitivore	fruitivore	N;SG
newspaperish	newspaperish	ADJ
reexpansion	reexpansion	N;SG
anophelicide	anophelicide	N;SG
BBQ'd	BBQ'd	ADJ
orbitoid	orbitoid	N;SG
calamondin	calamondin	N;SG
horridsome	horridsome	ADJ
dumben	dumbens	V;PRS;3;SG
empusellous	empusellous	ADJ
sparsify	sparsified	V;PST
geobiochemistry	geobiochemistry	N;SG
henophidian	henophidians	N;PL
totalness	totalness	N;SG
telecommunicate	telecommunicates	V;PRS;3;SG
geoforensics	geoforensics	N;SG
majoun	majoun	N;SG
ikarugamycin	ikarugamycin	N;SG
Sisyphism	Sisyphism	N;SG
precis	precis	V;NFIN
stilbite	stilbite	N;SG
ragdoll	ragdolls	V;PRS;3;SG
verticle	verticle	N;SG
transistorise	transistorised	V;PST
stelocyttarous	stelocyttarous	ADJ
vesuvine	vesuvine	N;SG
phantasize	phantasize	V;NFIN
CMYK	CMYK	N;SG
quadripinnate	quadripinnate	ADJ
scumbagginess	scumbagginess	N;SG
venome	venomes	N;PL
hookbill	hookbills	N;PL
neuromyopathic	neuromyopathic	ADJ
hunkey	hunkey	N;SG
despumate	despumating	V;V.PTCP;PRS
edder	edder	V;NFIN
timesis	timesis	N;SG
ossia	ossias	N;PL
pseudosugar	pseudosugars	N;PL
yawper	yawper	N;SG
tittyfuck	tittyfucked	V;V.PTCP;PST
nightingale	nightingale	N;SG
bounce	bounces	V;PRS;3;SG
aristocratical	aristocratical	ADJ
pommie	pommies	N;PL
sanctimonial	sanctimonial	ADJ
nonfeeding	nonfeeding	ADJ
drouge	drouge	N;SG
overshow	overshown	V;V.PTCP;PST
preclusion	preclusion	N;SG
chlorophthalmid	chlorophthalmids	N;PL
laughlessness	laughlessness	N;SG
Joan-of-Arcian	Joan-of-Arcian	ADJ
boogieboard	boogieboard	V;NFIN
flamer	flamers	N;PL
togethering	togethering	N;SG
sarge	sarged	V;V.PTCP;PST
snotrag	snotrag	N;SG
sauce	sauces	V;PRS;3;SG
logicise	logicising	V;V.PTCP;PRS
tecidual	tecidual	ADJ
remention	rementioning	V;V.PTCP;PRS
ambulancewoman	ambulancewoman	N;SG
meteoropathological	meteoropathological	ADJ
R99	R99	N;SG
regularise	regularising	V;V.PTCP;PRS
multiagent	multiagent	ADJ
double-pole	double-pole	ADJ
denitrogenate	denitrogenate	V;NFIN
ad hominem	ad hominem	ADJ
whig	whigged	V;V.PTCP;PST
demurral	demurrals	N;PL
dihydrocytosine	dihydrocytosine	N;SG
chaw	chawing	V;V.PTCP;PRS
stoney	stoney	ADJ
tacolike	tacolike	ADJ
schav	schav	N;SG
elt	elting	V;V.PTCP;PRS
crayon	crayons	V;PRS;3;SG
talked about	talked about	ADJ
Darbyite	Darbyite	N;SG
decreolise	decreolising	V;V.PTCP;PRS
okanoganite	okanoganite	N;SG
upfill	upfilled	V;PST
stylemog	stylemogged	V;PST
overindustrialize	overindustrialized	V;PST
preillumination	preillumination	N;SG
strapon	strapon	N;SG
thrombophylactic	thrombophylactic	ADJ
prædiction	prædiction	N;SG
polynomiograph	polynomiographs	N;PL
duty-free	duty-free	N;SG
Banach	Banach	ADJ
immunoblot	immunoblot	N;SG
loss	loss	N;SG
cardioventricle	cardioventricles	N;PL
bass	basses	V;PRS;3;SG
writhing	writhing	N;SG
xylorimbist	xylorimbist	N;SG
hotmelt	hotmelts	N;PL
cytoreduce	cytoreduce	V;NFIN
anthracothere	anthracothere	N;SG
dubu	dubu	N;SG
dismember	dismembers	V;PRS;3;SG
restable	restabled	V;PST
superfund	superfunding	V;V.PTCP;PRS
kilobase	kilobases	N;PL
leprophobia	leprophobia	N;SG
dysthymiac	dysthymiac	ADJ
drumble	drumble	V;NFIN
racquets	racquets	N;SG
accumbant	accumbant	ADJ
one-horse	one-horse	ADJ
unfog	unfogging	V;V.PTCP;PRS
militation	militation	N;SG
cake-pop	cake-pop	N;SG
stronghand	stronghand	N;SG
resentence	resentenced	V;V.PTCP;PST
gainchare	gainchares	N;PL
mycoplasmal	mycoplasmal	ADJ
sully	sullying	V;V.PTCP;PRS
actinogranuloma	actinogranuloma	N;SG
rack	racked	V;PST
residual	residual	ADJ
exocellobiohydrolase	exocellobiohydrolase	N;SG
eriocarpin	eriocarpin	N;SG
parsnip	parsnip	N;SG
nonseminoma	nonseminoma	N;SG
shaftmound	shaftmounds	N;PL
pisher	pisher	N;SG
sapphirine	sapphirine	N;SG
Japonism	Japonism	N;SG
campylobacterium	campylobacterium	N;SG
veta	veta	N;SG
inferent	inferent	ADJ
chlorphenesin	chlorphenesin	N;SG
macrocontextual	macrocontextual	ADJ
whittling	whittling	N;SG
bottletree	bottletrees	N;PL
forefront	forefronting	V;V.PTCP;PRS
emoji	emoji	N;SG
nonfamiliarity	nonfamiliarity	N;SG
tetramerid	tetramerid	N;SG
bare knuckle	bare knuckle	ADJ
transformant	transformant	N;SG
bedkey	bedkeys	N;PL
thermomorphogenic	thermomorphogenic	ADJ
tissy	tissy	N;SG
phosphohistone	phosphohistone	N;SG
