microphthalmic	microphthalmic	ADJ
predeclaration	predeclaration	N;SG
eq'n	eq'ns	N;PL
cryocentrifugation	cryocentrifugation	N;SG
deramp	deramp	N;SG
surrender	surrender	N;SG
aheylite	aheylite	N;SG
ennobling	ennoblings	N;PL
mysis	mysis	N;SG
credential	credentialed	V;V.PTCP;PST
favour	favoured	V;V.PTCP;PST
angiometry	angiometry	N;SG
rebukeful	rebukeful	ADJ
plastiglomerate	plastiglomerate	N;SG
forthput	forthputting	V;V.PTCP;PRS
grace	graced	V;PST
slush	slushed	V;PST
addicting	addicting	ADJ
smallware	smallware	N;SG
anticorona	anticoronas	N;PL
Thulean	Thulean	ADJ
magnetokinesis	magnetokinesis	N;SG
enquere	enqueres	V;PRS;3;SG
fractalize	fractalize	V;NFIN
metallome	metallome	N;SG
immunolabel	immunolabeled	V;V.PTCP;PST
brewup	brewup	N;SG
multiformness	multiformness	N;SG
spathilla	spathilla	N;SG
provection	provection	N;SG
lamoxirene	lamoxirene	N;SG
dearomatise	dearomatise	V;NFIN
plantling	plantlings	N;PL
antijitter	antijitter	ADJ
reshipping	reshipping	N;SG
recrumple	recrumple	V;NFIN
limit	limited	V;PST
befit	befitting	V;V.PTCP;PRS
dildoe	dildoe	N;SG
doliolid	doliolid	N;SG
poetrylessness	poetrylessness	N;SG
underspeak	uncountable	N;PL
right-drag	right-drags	V;PRS;3;SG
heroicise	heroicising	V;V.PTCP;PRS
prospre	prospring	V;V.PTCP;PRS
bagmaker	bagmaker	N;SG
catnap	catnaps	N;PL
enthesopathy	enthesopathy	N;SG
enchant	enchanted	V;V.PTCP;PST
superspeed	superspeed	ADJ
hermitization	hermitization	N;SG
kheddah	kheddah	N;SG
galactosyltransferase	galactosyltransferase	N;SG
maritimale	maritimale	ADJ
warmongerer	warmongerers	N;PL
duodenocystostomy	duodenocystostomy	N;SG
aganaine	aganaines	N;PL
ryanoid	ryanoids	N;PL
laninamivir	laninamivir	N;SG
norisoboldine	norisoboldine	N;SG
rouse	rousing	V;V.PTCP;PRS
iconic	iconic	ADJ
herpetism	herpetism	N;SG
consecute	consecute	V;NFIN
spondylitic	spondylitic	ADJ
spacedive	spacedives	N;PL
pryokinesis	pryokinesis	N;SG
fumarium	fumarium	N;SG
tailgut	tailgut	N;SG
genome	genome	N;SG
cumshaw	cumshawing	V;V.PTCP;PRS
GBS	GBS	N;SG
aya	aya	N;SG
gidji	gidji	N;SG
incavation	incavations	N;PL
ecolabeling	ecolabeling	N;SG
physciaceous	physciaceous	ADJ
costimulate	costimulated	V;V.PTCP;PST
ketoarginine	ketoarginine	N;SG
inheritableness	inheritableness	N;SG
autoplast	autoplast	N;SG
wist	wisted	V;V.PTCP;PST
pseudostutter	pseudostutter	V;NFIN
blowtorch	blowtorching	V;V.PTCP;PRS
coagent	coagent	N;SG
overmaturity	overmaturity	N;SG
bohío	bohío	N;SG
physioecological	physioecological	ADJ
semielliptical	semielliptical	ADJ
quick-fire	quick-fire	ADJ
tetrakionion	tetrakionion	N;SG
parametric	parametric	N;SG
mont	mont	N;SG
abider	abider	N;SG
hitchrail	hitchrail	N;SG
mercheen	mercheens	N;PL
underresourced	underresourced	ADJ
atheophobic	atheophobic	ADJ
Sephardic	Sephardic	ADJ
madroño	madroño	N;SG
genengineering	genengineering	N;SG
sissyish	sissyish	ADJ
alternat	alternat	N;SG
obsolesce	obsolesced	V;PST
undecanol	undecanols	N;PL
goo	gooed	V;V.PTCP;PST
rivet	riveted	V;V.PTCP;PST
interpunct	interpuncts	N;PL
redeploy	redeploy	V;NFIN
strict-sense stationary	strict-sense stationary	ADJ
reglucosylate	reglucosylating	V;V.PTCP;PRS
problematology	problematology	N;SG
unpoisonous	unpoisonous	ADJ
surtaxable	surtaxable	ADJ
PSAP	PSAP	N;SG
mindist	mindists	N;PL
nonarchival	nonarchival	ADJ
scamper	scampering	V;V.PTCP;PRS
welfarist	welfarists	N;PL
besmall	besmall	V;NFIN
WPC	WPC	N;SG
enedione	enediones	N;PL
swim-in	swim-in	N;SG
supplant	supplanted	V;PST
jowled	jowled	ADJ
bedload	bedload	N;SG
hydroperoxide	hydroperoxide	N;SG
outendure	outendured	V;PST
circularise	circularised	V;V.PTCP;PST
breadfruit	breadfruits	N;PL
decentralizable	decentralizable	ADJ
pornosexuality	pornosexuality	N;SG
mudhif	mudhifs	N;PL
vinyard	vinyard	N;SG
persistable	persistable	ADJ
adhocracy	adhocracies	N;PL
spirene	spirene	N;SG
destabilization	destabilization	N;SG
hummerite	hummerite	N;SG
anticholinesterasic	anticholinesterasic	ADJ
nonmucoid	nonmucoid	ADJ
aris	arises	N;PL
regravel	regravels	V;PRS;3;SG
metallometallation	metallometallation	N;SG
likeworthy	likeworthy	ADJ
acierate	acierated	V;PST
bladelessness	bladelessness	N;SG
erne	erne	N;SG
SLDRAM	SLDRAM	N;SG
pygophile	pygophiles	N;PL
aldobiuronic	aldobiuronic	ADJ
preinduce	preinduces	V;PRS;3;SG
prebait	prebaited	V;V.PTCP;PST
backwardsness	backwardsness	N;SG
haptenylate	haptenylated	V;V.PTCP;PST
hedera	hedera	N;SG
holocentrid	holocentrids	N;PL
puefellow	puefellow	N;SG
conciliable	conciliable	N;SG
caulking	caulking	N;SG
popemobile	popemobile	N;SG
wavetable	wavetable	N;SG
live	live	ADJ
floater	floaters	N;PL
cluck	clucked	V;V.PTCP;PST
semiradical	semiradical	ADJ
automorphism	automorphisms	N;PL
overbought	overbought	ADJ
Karmathian	Karmathian	N;SG
exprobate	exprobating	V;V.PTCP;PRS
odorscape	odorscape	N;SG
goujonette	goujonette	N;SG
Montenegrian	Montenegrian	ADJ
midnightly	midnightly	ADJ
destage	destaging	V;V.PTCP;PRS
discharging	discharging	N;SG
conciliable	conciliables	N;PL
superstate	superstate	N;SG
doublecheck	doublechecks	V;PRS;3;SG
cinaciguat	cinaciguat	N;SG
milling	milling	N;SG
parallel	parallel	ADJ
thoughtlet	thoughtlets	N;PL
goto	gotos	N;PL
zeriba	zeriba	N;SG
sportsplex	sportsplex	N;SG
histodialysis	histodialysis	N;SG
plantaflexor	plantaflexors	N;PL
visitorial	visitorial	ADJ
garcinone	garcinone	N;SG
pane	paned	V;PST
haematolin	haematolin	N;SG
replete	repletes	V;PRS;3;SG
geoprobe	geoprobes	N;PL
dusthole	dusthole	N;SG
scytheman	scytheman	N;SG
backside	backsides	N;PL
centigramme	centigramme	N;SG
fireset	fireset	N;SG
surfle	surfle	V;NFIN
prespill	prespill	ADJ
hexylthiofos	hexylthiofos	N;SG
coder	coders	N;PL
yogasana	yogasana	N;SG
tease	teases	N;PL
boast	boast	V;NFIN
circumjacent	circumjacent	ADJ
showerset	showersets	N;PL
elfinwood	elfinwood	N;SG
subclassify	subclassifies	V;PRS;3;SG
melanoprotein	melanoproteins	N;PL
multivariable	multivariable	ADJ
reexchange	reexchanged	V;PST
informalize	informalizes	V;PRS;3;SG
aflibercept	aflibercept	N;SG
tremor	tremors	N;PL
cooingly	cooingly	ADJ
psychoanalyse	psychoanalysing	V;V.PTCP;PRS
multiplex	multiplexes	V;PRS;3;SG
geolocational	geolocational	ADJ
nontradable	nontradable	ADJ
tolerative	tolerative	ADJ
wheft	whefts	N;PL
phenylpropene	phenylpropenes	N;PL
clisospirid	clisospirids	N;PL
planetality	planetalities	N;PL
tramp	tramped	V;V.PTCP;PST
mesmeriser	mesmeriser	N;SG
systemicity	systemicities	N;PL
ATV	ATV	N;SG
confirming	confirmings	N;PL
azokeratin	azokeratin	N;SG
cytorrhysis	cytorrhysis	N;SG
capripox	capripox	N;SG
737	737s	N;PL
meshy	meshy	ADJ
rigol	rigols	N;PL
loveseat	loveseat	N;SG
ventralisation	ventralisations	N;PL
volta	volta	N;SG
uncorroborated	uncorroborated	ADJ
noncritical	noncritical	ADJ
nondangerous	nondangerous	ADJ
RLE	RLE	N;SG
omnibus	omnibusing	V;V.PTCP;PRS
reendowment	reendowment	N;SG
asystematic	asystematic	ADJ
antiaggregant	antiaggregants	N;PL
nilprogression	nilprogression	N;SG
Bicolana	Bicolana	N;SG
augur	augur	V;NFIN
fettle	fettles	V;PRS;3;SG
sundawn	sundawn	N;SG
paranthracene	paranthracene	N;SG
strainmeter	strainmeters	N;PL
panchayat	panchayat	N;SG
malloc	malloced	V;V.PTCP;PST
noreasterner	noreasterners	N;PL
premacular	premacular	ADJ
codling	codling	N;SG
northwester	northwesters	N;PL
semilogical	semilogical	ADJ
modulate	modulated	V;V.PTCP;PST
MChem	MChem	N;SG
catfish	catfish	N;SG
supercompress	supercompresses	V;PRS;3;SG
fortyeightmo	fortyeightmo	N;SG
blackify	blackify	V;NFIN
unstingy	unstingy	ADJ
sloosh	slooshing	V;V.PTCP;PRS
avalanche	avalanched	V;PST
enablement	enablement	N;SG
tagma	tagma	N;SG
objectional	objectional	ADJ
bumble	bumble	V;NFIN
pregeometry	pregeometry	N;SG
velvetbean	velvetbeans	N;PL
nusach	nusach	N;SG
jelly	jelly	V;NFIN
undisintegrated	undisintegrated	ADJ
reinvigorate	reinvigorated	V;PST
man	manning	V;V.PTCP;PRS
damsel	damsels	N;PL
angry as a wet hen	angry as a wet hen	ADJ
brabantite	brabantite	N;SG
beeve	beeve	N;SG
slowplay	slowplaying	V;V.PTCP;PRS
rabdology	rabdology	N;SG
leag	leag	N;SG
methoxyl	methoxyl	N;SG
fat-free	fat-free	ADJ
tetrabrachion	tetrabrachions	N;PL
nothosauroid	nothosauroid	N;SG
syncopate	syncopates	V;PRS;3;SG
junglism	junglism	N;SG
optimise	optimises	V;PRS;3;SG
riksdaler	riksdalers	N;PL
hyphenate	hyphenating	V;V.PTCP;PRS
rehome	rehomes	V;PRS;3;SG
extinguish	extinguishing	V;V.PTCP;PRS
accidentology	accidentology	N;SG
pareiasaurian	pareiasaurian	N;SG
concreate	concreating	V;V.PTCP;PRS
dicone	dicones	N;PL
toilet	toilet	V;NFIN
sharke	sharke	N;SG
portacrib	portacribs	N;PL
philhellene	philhellenes	N;PL
samarid	samarid	N;SG
1st	1st	ADJ
capillitium	capillitium	N;SG
chirostyloid	chirostyloids	N;PL
intrageniculate	intrageniculate	ADJ
gook	gooks	N;PL
transgene	transgene	N;SG
nimbyish	nimbyish	ADJ
metroplasty	metroplasty	N;SG
iodochlorhydroxyquin	iodochlorhydroxyquin	N;SG
diavolume	diavolume	N;SG
desant	desant	N;SG
tapeline	tapeline	N;SG
osteoarthrosic	osteoarthrosic	ADJ
mailo	mailos	N;PL
timeclock	timeclocks	N;PL
deurbanize	deurbanizing	V;V.PTCP;PRS
curarise	curarise	V;NFIN
libristomate	libristomate	ADJ
xeriscape	xeriscaped	V;PST
intermingle	intermingled	V;V.PTCP;PST
raunge	raunges	N;PL
common	commoning	V;V.PTCP;PRS
authourise	authourised	V;PST
criophorous	criophorous	ADJ
cowboy	cowboyed	V;V.PTCP;PST
dispossess	dispossessing	V;V.PTCP;PRS
trake	trakes	N;PL
decedent	decedents	N;PL
VOR	VOR	N;SG
unnerve	unnerves	V;PRS;3;SG
cede	cede	V;NFIN
aphroditiform	aphroditiform	N;SG
calyptostase	calyptostases	N;PL
repellent	repellents	N;PL
diphosphocane	diphosphocane	N;SG
dilacerate	dilacerating	V;V.PTCP;PRS
minitower	minitower	N;SG
Ethiopianize	Ethiopianizes	V;PRS;3;SG
spectator	spectators	N;PL
reafference	reafference	N;SG
unblanching	unblanching	ADJ
photoconductor	photoconductors	N;PL
mega-ship	mega-ship	N;SG
acrembolic	acrembolic	ADJ
ipsative	ipsative	ADJ
subvert	subverted	V;PST
aketon	aketon	N;SG
combatant	combatants	N;PL
holepunch	holepunches	N;PL
foodmonger	foodmonger	N;SG
sinfonia	sinfonia	N;SG
cyberchondriac	cyberchondriac	N;SG
haplochromin	haplochromins	N;PL
limnetic	limnetic	ADJ
refoldable	refoldable	ADJ
Catholicism	Catholicism	N;SG
yellowtail	yellowtail	N;SG
notostylopid	notostylopid	N;SG
dieselize	dieselized	V;V.PTCP;PST
pharmacochaperone	pharmacochaperone	N;SG
tropiduchid	tropiduchids	N;PL
namaskar	namaskar	N;SG
jumper	jumper	V;NFIN
styliferous	styliferous	ADJ
poetaz	poetaz	ADJ
fand	fand	V;NFIN
directrix	directrix	N;SG
agathodemon	agathodemons	N;PL
scopelarchid	scopelarchids	N;PL
undermilk	undermilks	V;PRS;3;SG
Neo-Kantian	Neo-Kantian	ADJ
mainmast	mainmasts	N;PL
opinionate	opinionated	V;PST
towpath	towpaths	N;PL
deattribute	deattributes	V;PRS;3;SG
matraite	matraite	N;SG
birchbark	birchbark	N;SG
unbending	unbending	N;SG
pirameter	pirameter	N;SG
youngsome	youngsome	ADJ
tabu	tabu	N;SG
near	nears	N;PL
macrocephalus	macrocephalus	N;SG
historiograph	historiograph	N;SG
vernalin	vernalin	N;SG
unprison	unprisoned	V;PST
brigand	brigand	N;SG
simworld	simworld	N;SG
nonoffensive	nonoffensive	ADJ
reprover	reprover	N;SG
calotype	calotypes	N;PL
