diphosphoinositide	diphosphoinositides	N;PL
nonlighted	nonlighted	ADJ
mesoteloblast	mesoteloblast	N;SG
headkerchief	headkerchiefs	N;PL
refrozen	refrozen	ADJ
Sozi	Sozi	N;SG
frill	frilled	V;V.PTCP;PST
maccaron	maccarons	N;PL
postembolisation	postembolisation	ADJ
photopharmacological	photopharmacological	ADJ
nonintelligent	nonintelligent	ADJ
halurgite	halurgite	N;SG
pricked	pricked	ADJ
chubsucker	chubsucker	N;SG
impallid	impallids	V;PRS;3;SG
bevonium	bevonium	N;SG
grandmultipara	grandmultipara	N;SG
occlude	occludes	V;PRS;3;SG
soundable	soundable	ADJ
physicianship	physicianship	N;SG
conchospore	conchospore	N;SG
safe	safe	ADJ
distantial	distantial	ADJ
transvalvular	transvalvular	ADJ
wont	wonted	V;V.PTCP;PST
subboard	subboard	N;SG
supergaiter	supergaiter	N;SG
brownify	brownifying	V;V.PTCP;PRS
nonsloping	nonsloping	ADJ
brack	brack	N;SG
antiphosphorylated	antiphosphorylated	ADJ
exflagellate	exflagellated	V;PST
Baalist	Baalist	N;SG
phosphate	phosphated	V;PST
argillaceous	argillaceous	ADJ
multiply	multiplies	V;PRS;3;SG
anticipant	anticipant	ADJ
scoptophilic	scoptophilic	ADJ
eizel	eizel	N;SG
pagophilic	pagophilic	ADJ
chorditis	chorditis	N;SG
miscaption	miscaptioned	V;V.PTCP;PST
inflected	inflected	ADJ
unlatinized	unlatinized	ADJ
foredesign	foredesigned	V;V.PTCP;PST
stylosome	stylosome	N;SG
blattinine	blattinine	ADJ
fexinidazole	fexinidazole	N;SG
spadroon	spadroon	N;SG
twoc	twocced	V;V.PTCP;PST
pupinid	pupinid	N;SG
extradite	extradited	V;PST
bikelock	bikelocks	N;PL
ultrared	ultrared	N;SG
joyport	joyport	N;SG
prerelease	prereleased	V;PST
AFOLU	AFOLU	N;SG
phosphoribosyltransferase	phosphoribosyltransferase	N;SG
fantasiser	fantasiser	N;SG
caoutchouc	caoutchouc	N;SG
orthosilicate	orthosilicate	N;SG
toothlet	toothlets	N;PL
corronach	corronach	N;SG
knoll	knolls	V;PRS;3;SG
dragqueen	dragqueens	N;PL
oograph	oographs	N;PL
glasshole	glasshole	N;SG
carcinophorid	carcinophorids	N;PL
elliptocytic	elliptocytic	ADJ
fuzzer	fuzzers	N;PL
solicitory	solicitory	ADJ
anicom	anicom	N;SG
refunctionalize	refunctionalizes	V;PRS;3;SG
lysogenesis	lysogenesis	N;SG
zebub	zebub	N;SG
subdistrict	subdistricted	V;PST
Brazilianness	Brazilianness	N;SG
paideia	paideia	N;SG
Old Prussian	Old Prussian	ADJ
intersplice	interspliced	V;PST
cordage	cordage	N;SG
payline	payline	N;SG
displume	displumes	V;PRS;3;SG
quintessence	quintessenced	V;PST
proud-stomached	proud-stomached	ADJ
ternstroemiaceous	ternstroemiaceous	ADJ
savorsome	savorsome	ADJ
mesal	mesal	ADJ
super-note	super-note	N;SG
single-breasted	single-breasted	ADJ
sheepishness	sheepishness	N;SG
readthrough	readthroughs	N;PL
Lankan	Lankan	ADJ
staircase	staircase	V;NFIN
cannaigre	cannaigre	N;SG
stakeswinner	stakeswinners	N;PL
desighn	desighns	V;PRS;3;SG
forwaked	forwaked	ADJ
smoothtongue	smoothtongue	N;SG
beidellite	beidellite	N;SG
morland	morlands	N;PL
oncogenome	oncogenome	N;SG
endocrocin	endocrocin	N;SG
oligosynthetic	oligosynthetic	ADJ
Rangoonese	Rangoonese	N;SG
philatelic	philatelic	ADJ
diarrhœa	diarrhœa	N;SG
multifamilial	multifamilial	ADJ
waterbird	waterbirds	N;PL
foussa	foussas	N;PL
outpeep	outpeeps	V;PRS;3;SG
inaesthetic	inaesthetic	ADJ
overgroup	overgroup	N;SG
reconfirmation	reconfirmations	N;PL
monobiotinylated	monobiotinylated	ADJ
radioopacity	radioopacity	N;SG
tailable	tailable	ADJ
Aventine	Aventine	ADJ
watergrass	watergrass	N;SG
non-recurring	non-recurring	ADJ
spinebuster	spinebusters	N;PL
superuniversal	superuniversal	ADJ
kipsy	kipsy	V;NFIN
cadmia	cadmia	N;SG
clunch	clunch	V;NFIN
dister	disters	V;PRS;3;SG
roncador	roncador	N;SG
metric	metrics	N;PL
metastable	metastable	N;SG
kalendarial	kalendarial	ADJ
stomp	stomping	V;V.PTCP;PRS
fairyland	fairyland	ADJ
decorrelate	decorrelate	V;NFIN
campylophage	campylophages	N;PL
collateralize	collateralizing	V;V.PTCP;PRS
fouth	fouth	N;SG
weeping	weeping	N;SG
homododecamer	homododecamers	N;PL
preachify	preachify	V;NFIN
nonsoapy	nonsoapy	ADJ
hæmatologist	hæmatologist	N;SG
polyethersulfone	polyethersulfone	N;SG
coadsorb	coadsorbed	V;V.PTCP;PST
enseal	enseals	V;PRS;3;SG
ferruginize	ferruginized	V;PST
overtriage	overtriaged	V;V.PTCP;PST
roflurane	roflurane	N;SG
xenoencyclopedia	xenoencyclopedias	N;PL
conclusible	conclusible	ADJ
spartina	spartina	N;SG
sensitize	sensitized	V;V.PTCP;PST
unbaffled	unbaffled	ADJ
hyalomere	hyalomeres	N;PL
desminopathy	desminopathies	N;PL
orthographer	orthographer	N;SG
judeophobia	judeophobia	N;SG
unnaturalistic	unnaturalistic	ADJ
cordebeck	cordebecks	N;PL
plasminergic	plasminergic	ADJ
crystalliferous	crystalliferous	ADJ
catlore	catlore	N;SG
fengabine	fengabine	N;SG
receptorome	receptorome	N;SG
Bushism	Bushism	N;SG
tetracarbene	tetracarbene	N;SG
iniencephalic	iniencephalic	ADJ
knowleche	knowleched	V;V.PTCP;PST
wibbly	wibblier	ADJ;CMPR
mericarp	mericarps	N;PL
dominionistic	dominionistic	ADJ
legitimist	legitimists	N;PL
gerund-participle	gerund-participle	N;SG
mealer	mealer	N;SG
impressed	impressed	ADJ
Borromean	Borromean	ADJ
zzz	zzz	V;NFIN
RDM	RDM	V;NFIN
ground-man	ground-man	N;SG
desulfate	desulfates	V;PRS;3;SG
waveguide	waveguides	N;PL
mediatorial	mediatorial	ADJ
ongo	ongoes	V;PRS;3;SG
milkiness	milkiness	N;SG
micromechanical	micromechanical	N;SG
tetrahydropyrrole	tetrahydropyrrole	N;SG
southeasterly	southeasterly	ADJ
manaclelike	manaclelike	ADJ
lintel	lintels	N;PL
hijab	hijab	N;SG
atisane	atisane	N;SG
maltreater	maltreaters	N;PL
Sidonian	Sidonian	N;SG
result	resulted	V;PST
multigraph	multigraph	N;SG
anillin	anillin	N;SG
mischallenge	mischallenge	N;SG
Bolshevization	Bolshevization	N;SG
jammy	jammies	N;PL
scalma	scalma	N;SG
constitute	constitutes	N;PL
foldaway	foldaway	ADJ
heavenliness	heavenliness	N;SG
stethography	stethography	N;SG
divulse	divulsed	V;V.PTCP;PST
furin	furin	N;SG
pyrgology	pyrgology	N;SG
balanophoraceous	balanophoraceous	ADJ
kilodisintegration	kilodisintegration	N;SG
cabastine	cabastine	N;SG
sectarian	sectarians	N;PL
preovipositional	preovipositional	ADJ
registry	registry	N;SG
motherness	motherness	N;SG
unexoticized	unexoticized	ADJ
antimoniate	antimoniates	N;PL
pentaoxide	pentaoxide	N;SG
pharid	pharids	N;PL
montero	montero	N;SG
consumer	consumer	N;SG
galacturonosidase	galacturonosidases	N;PL
whitephobia	whitephobia	N;SG
inkle	inkled	V;PST
resolder	resoldered	V;V.PTCP;PST
shunt	shunt	V;NFIN
paraphobia	paraphobia	N;SG
rout	routs	V;PRS;3;SG
ziggurat	ziggurat	N;SG
revortexed	revortexed	ADJ
khalifat	khalifat	N;SG
favourless	favourless	ADJ
epignathus	epignathus	N;SG
polysulfone	polysulfone	N;SG
cholinomimetic	cholinomimetic	ADJ
un-ruin	un-ruin	V;NFIN
nonagglutinability	nonagglutinability	N;SG
heteroagglomerate	heteroagglomerates	N;PL
ingrave	ingraved	V;V.PTCP;PST
gristliness	gristliness	N;SG
reticence	reticencing	V;V.PTCP;PRS
diphenylmethyl	diphenylmethyl	N;SG
canakin	canakin	N;SG
gaultite	gaultite	N;SG
Novachord	Novachord	N;SG
Sufitic	Sufitic	ADJ
outdrag	outdrags	V;PRS;3;SG
expanse	expanse	N;SG
mossbunker	mossbunkers	N;PL
enfetter	enfettered	V;V.PTCP;PST
gulasch	gulasch	N;SG
requarantine	requarantining	V;V.PTCP;PRS
counter-rampant	counter-rampant	ADJ
whoo	whoos	V;PRS;3;SG
waterski	waterskis	V;PRS;3;SG
upperpart	upperparts	N;PL
gutturize	gutturize	V;NFIN
aurocephalous	aurocephalous	ADJ
incongruitous	incongruitous	ADJ
1080	1080	N;SG
betide	betides	V;PRS;3;SG
attach	attaches	V;PRS;3;SG
rehabilitationism	rehabilitationism	N;SG
isocitric	isocitric	ADJ
incudomalleolar	incudomalleolar	ADJ
Anabaptism	Anabaptism	N;SG
invexed	invexed	ADJ
cinematograph	cinematograph	V;NFIN
light-weight	light-weight	ADJ
dipsomania	dipsomania	N;SG
perineotomy	perineotomy	N;SG
coverslide	coverslides	N;PL
superplant	superplant	N;SG
fromagerie	fromagerie	N;SG
movable	movable	ADJ
plumaged	plumaged	ADJ
cheesology	cheesology	N;SG
alanate	alanate	N;SG
chitinization	chitinization	N;SG
asitia	asitia	N;SG
fure	fured	V;PST
pelmet	pelmets	N;PL
sandeel	sandeel	N;SG
smalahove	smalahove	N;SG
ecofanatic	ecofanatics	N;PL
sacralize	sacralized	V;V.PTCP;PST
relentment	relentment	N;SG
lakou	lakou	N;SG
prickwood	prickwood	N;SG
Felliniesque	Felliniesque	ADJ
monomer	monomers	N;PL
lost to the world	lost to the world	ADJ
eliminate	eliminated	V;PST
nubilate	nubilated	V;PST
nonrubber	nonrubber	ADJ
WSI	WSI	N;SG
towrope	towropes	N;PL
nanorefrigerator	nanorefrigerator	N;SG
integral	integral	N;SG
promulge	promulged	V;V.PTCP;PST
univerbate	univerbate	V;NFIN
cookhouse	cookhouse	N;SG
law	law	V;NFIN
thiopyridine	thiopyridine	N;SG
skiddy	skiddy	ADJ
skidmark	skidmark	N;SG
metapneumonia	metapneumonia	N;SG
kestral	kestral	N;SG
dismounter	dismounter	N;SG
cospecialize	cospecialized	V;PST
scrimshank	scrimshanked	V;PST
travunioid	travunioids	N;PL
lithesome	lithesome	ADJ
folliculid	folliculids	N;PL
carboreduction	carboreduction	N;SG
properad	properads	N;PL
attitudinise	attitudinising	V;V.PTCP;PRS
hydramine	hydramine	N;SG
metolazone	metolazone	N;SG
bloodynoun	bloodynouns	N;PL
trod	trodded	V;V.PTCP;PST
dopaminomimetic	dopaminomimetic	ADJ
telefax	telefaxed	V;PST
fluoromethyl	fluoromethyl	N;SG
fuckworthy	fuckworthy	ADJ
salicional	salicionals	N;PL
nonvacuolar	nonvacuolar	ADJ
proposee	proposee	N;SG
shameproof	shameproof	ADJ
CTF	CTF	N;SG
unwrap	unwrapped	V;PST
lark's-heel	lark's-heel	N;SG
upslant	upslant	V;NFIN
circar	circar	N;SG
iodonitrotetrazolium	iodonitrotetrazolium	N;SG
yeastful	yeastful	ADJ
Assyriological	Assyriological	ADJ
idioblast	idioblast	N;SG
nicotiflorin	nicotiflorin	N;SG
thigmotherm	thigmotherms	N;PL
oligospermous	oligospermous	ADJ
athermality	athermality	N;SG
vitiate	vitiates	V;PRS;3;SG
carameliser	carameliser	N;SG
yakky	yakkiest	ADJ;SPRL
maniple	maniples	N;PL
Burmeseness	Burmeseness	N;SG
azone	azones	N;PL
choose	chosen	V;V.PTCP;PST
unsquared	unsquared	ADJ
swill	swilled	V;PST
prewire	prewiring	V;V.PTCP;PRS
shut	shutting	V;V.PTCP;PRS
parlorista	parlorista	N;SG
ceratomorph	ceratomorphs	N;PL
innermostness	innermostness	N;SG
chummo	chummos	N;PL
substance	substance	N;SG
miserableness	miserableness	N;SG
neife	neifes	N;PL
hereditarian	hereditarian	ADJ
phal	phal	N;SG
proof-reader	proof-reader	N;SG
bard	barding	V;V.PTCP;PRS
inconclusive	inconclusive	ADJ
padella	padellas	N;PL
organometal	organometal	N;SG
decomplexify	decomplexify	V;NFIN
yot	yotted	V;V.PTCP;PST
goodnesse	goodnesse	N;SG
multisection	multisection	ADJ
toponomics	toponomics	N;SG
Eurotort	Eurotort	N;SG
attractor	attractors	N;PL
postfrontal	postfrontals	N;PL
scalp	scalping	V;V.PTCP;PRS
maintainer	maintainers	N;PL
BOH	BOH	N;SG
despumate	despumating	V;V.PTCP;PRS
cancerophobia	cancerophobia	N;SG
upvalue	upvalue	N;SG
photoenlarger	photoenlarger	N;SG
holophytic	holophytic	ADJ
Jewdom	Jewdom	N;SG
bicipital	bicipital	ADJ
mash	mash	V;NFIN
sorgo	sorgo	N;SG
nonprecedential	nonprecedential	ADJ
armie	armie	N;SG
godsent	godsent	ADJ
priapus	priapus	N;SG
hound	hounding	V;V.PTCP;PRS
cystogastrostomy	cystogastrostomies	N;PL
albarium	albarium	N;SG
tabulate	tabulate	ADJ
declassification	declassification	N;SG
infound	infounds	V;PRS;3;SG
polyglactin	polyglactin	N;SG
epicalyx	epicalyx	N;SG
subterrestrial	subterrestrial	N;SG
impulsive	impulsive	N;SG
robocar	robocars	N;PL
zonobiome	zonobiome	N;SG
galopin	galopin	N;SG
prompt	prompted	V;V.PTCP;PST
sa/vol	sa/vol	N;SG
assart	assarts	V;PRS;3;SG
nonidealogue	nonidealogue	N;SG
topaquinone	topaquinone	N;SG
jaffa	jaffas	N;PL
earywig	earywig	N;SG
truncated	truncated	ADJ
categoria	categoria	N;SG
bodyship	bodyship	N;SG
aryepiglottic	aryepiglottic	ADJ
rejolt	rejolts	V;PRS;3;SG
holelike	holelike	ADJ
scout	scouted	V;V.PTCP;PST
discal	discal	ADJ
unfelled	unfelled	ADJ
cryptolectal	cryptolectal	ADJ
nonwheeled	nonwheeled	ADJ
testone	testones	N;PL
sunne	sunnes	N;PL
pooty	pooty	ADJ
glucoseptanoside	glucoseptanosides	N;PL
soft	softer	ADJ;CMPR
deifier	deifiers	N;PL
galactosaemic	galactosaemic	ADJ
plackard	plackarded	V;V.PTCP;PST
valent	valent	ADJ
cabasset	cabasset	N;SG
unmet	unmet	ADJ
unloved	unloved	ADJ
unknit	unknitted	V;V.PTCP;PST
neldazosin	neldazosin	N;SG
perisarcal	perisarcal	ADJ
parenthesise	parenthesise	V;NFIN
darb	darb	N;SG
eavesdrip	eavesdrip	N;SG
ghostly	ghostliest	ADJ;SPRL
Tadzhik	Tadzhik	ADJ
shariatize	shariatized	V;PST
hypermyelinated	hypermyelinated	ADJ
apotheosize	apotheosizes	V;PRS;3;SG
videostroboscope	videostroboscope	N;SG
abscondee	abscondees	N;PL
nanostructural	nanostructural	ADJ
peribolus	peribolus	N;SG
feu	feu	V;NFIN
transvest	transvested	V;V.PTCP;PST
phosphorous	phosphorous	N;SG
infest	infest	N;SG
decondense	decondensed	V;PST
sw.	sw.	ADJ
$deity	$deities	N;PL
bide	bided	V;PST
individualise	individualise	V;NFIN
reshare	reshared	V;V.PTCP;PST
linguo-palatal	linguo-palatal	N;SG
mishope	mishoping	V;V.PTCP;PRS
hommock	hommocks	N;PL
polypile	polypiled	V;V.PTCP;PST
cyberstructure	cyberstructure	N;SG
furanocoumarin	furanocoumarin	N;SG
terraform	terraform	V;NFIN
mercurial	mercurial	ADJ
photoglow	photoglows	N;PL
balconet	balconet	N;SG
lacunose	lacunose	ADJ
timmiaceous	timmiaceous	ADJ
flamekeeper	flamekeeper	N;SG
balsamous	balsamous	ADJ
disentrailed	disentrailed	ADJ
leechee	leechees	N;PL
Onondagan	Onondagan	N;SG
pliant	pliant	ADJ
hunkerism	hunkerism	N;SG
Sunnize	Sunnized	V;V.PTCP;PST
electrocardioscope	electrocardioscopes	N;PL
ratu	ratu	N;SG
spoofed	spoofed	ADJ
gearksutite	gearksutite	N;SG
lecture	lectures	V;PRS;3;SG
prepone	preponed	V;PST
galactoglucan	galactoglucan	N;SG
seroconvert	seroconverted	V;PST
pteropodid	pteropodids	N;PL
radiotellurium	radiotellurium	N;SG
shieldsmith	shieldsmith	N;SG
spiderwort	spiderworts	N;PL
swallower	swallower	N;SG
zooregion	zooregions	N;PL
facelift	facelifting	V;V.PTCP;PRS
welcome	welcome	V;NFIN
faerylike	faerylike	ADJ
lead-free	lead-free	ADJ
protoeruboside	protoeruboside	N;SG
rightsholder	rightsholders	N;PL
postviable	postviable	ADJ
radiopharmaceutical	radiopharmaceuticals	N;PL
electrocompetent	electrocompetent	ADJ
Uzbekness	Uzbekness	N;SG
superradiant	superradiant	ADJ
unpunishableness	unpunishableness	ADJ
stour	stouring	V;V.PTCP;PRS
Batavian	Batavian	ADJ
eddoe	eddoes	N;PL
arcid	arcid	N;SG
tuberactinomycin	tuberactinomycin	N;SG
premial	premial	ADJ
librettistics	librettistics	N;SG
noseclip	noseclip	N;SG
zygogenesis	zygogenesis	N;SG
zorse	zorses	N;PL
lonko	lonkos	N;PL
coproducer	coproducer	N;SG
subisotype	subisotype	N;SG
unautomatable	unautomatable	ADJ
bufezolac	bufezolac	N;SG
phonate	phonates	V;PRS;3;SG
nobody	nobody	N;SG
unstagey	unstagey	ADJ
disfellowshipment	disfellowshipments	N;PL
autoinjected	autoinjected	ADJ
supraloral	supraloral	N;SG
adrenomimetic	adrenomimetic	ADJ
intersexualization	intersexualization	N;SG
peshmerga	peshmerga	N;SG
entitle	entitled	V;PST
anammox	anammox	N;SG
norgestimate	norgestimate	N;SG
sault	sault	N;SG
injoint	injoints	V;PRS;3;SG
TGV	TGV	N;SG
misland	mislanded	V;PST
ungirdle	ungirdle	V;NFIN
outroot	outrooted	V;V.PTCP;PST
electroantennograph	electroantennographs	N;PL
dragonling	dragonlings	N;PL
Ubaidian	Ubaidian	ADJ
lubeluzole	lubeluzole	N;SG
sexfight	sexfight	V;NFIN
cowling	cowling	N;SG
homotypy	homotypy	N;SG
socio-economic	socio-economic	ADJ
blunge	blunges	V;PRS;3;SG
thiazoloquinolone	thiazoloquinolones	N;PL
homoiophone	homoiophone	N;SG
folkred	folkred	N;SG
tsilaisite	tsilaisite	N;SG
garefowl	garefowl	N;SG
bunionette	bunionettes	N;PL
granfalloon	granfalloon	N;SG
radioman	radioman	N;SG
cancrid	cancrids	N;PL
hernandulcin	hernandulcin	N;SG
orinasal	orinasal	ADJ
bitterness	bitterness	N;SG
chachachá	chachachás	N;PL
dicyanoaurate	dicyanoaurate	N;SG
photocarcinogenesis	photocarcinogenesis	N;SG
dagbreker	dagbrekers	N;PL
mutafacient	mutafacient	ADJ
robomb	robomb	N;SG
demihypercube	demihypercube	N;SG
stereoisomerism	stereoisomerism	N;SG
legger	leggers	N;PL
chlorproethazine	chlorproethazine	N;SG
southie	southies	N;PL
shopboard	shopboards	N;PL
isomer	isomers	N;PL
enediol	enediols	N;PL
kluge	kluge	N;SG
mase	mased	V;V.PTCP;PST
Hobbesian	Hobbesian	ADJ
metapuzzle	metapuzzles	N;PL
thinspo	thinspo	N;SG
LF	LF	N;SG
barebum	barebum	ADJ
phenome	phenome	N;SG
toroid	toroid	N;SG
iofetamine	iofetamine	N;SG
naveless	naveless	ADJ
karyomegalic	karyomegalic	ADJ
tentering	tentering	N;SG
scavage	scavaged	V;PST
misproduce	misproducing	V;V.PTCP;PRS
polyleucine	polyleucine	N;SG
gawkling	gawkling	N;SG
rubboardist	rubboardists	N;PL
dualize	dualizing	V;V.PTCP;PRS
counterrotate	counterrotated	V;PST
F♭	F♭	N;SG
unmutilated	unmutilated	ADJ
moiety	moieties	N;PL
lefthander	lefthanders	N;PL
comasterid	comasterid	N;SG
lkna	lknas	N;PL
semimeasure	semimeasures	N;PL
antileukoprotease	antileukoprotease	N;SG
pathside	pathside	ADJ
thumbmark	thumbmark	N;SG
Aufgabe	Aufgabe	N;SG
twiddle	twiddled	V;PST
acinous	acinous	ADJ
telemark	telemarks	V;PRS;3;SG
A-list	A-list	ADJ
misunderstander	misunderstander	N;SG
bootlike	bootlike	ADJ
scarlatinous	scarlatinous	ADJ
hippocaust	hippocaust	N;SG
garrot	garroting	V;V.PTCP;PRS
sommelier	sommelier	V;NFIN
studentized	studentized	ADJ
dandarid	dandarids	N;PL
brickscape	brickscapes	N;PL
confederate	confederated	V;V.PTCP;PST
lacune	lacune	N;SG
maskil	maskil	N;SG
full-size	full-size	ADJ
DBS	DBS	N;SG
antisense	antisenses	N;PL
trioctanoyl	trioctanoyl	N;SG
epicentral	epicentral	ADJ
counsel	counsel	N;SG
reactionary	reactionary	ADJ
hearer	hearers	N;PL
shapen	shapen	ADJ
hypertonus	hypertonus	N;SG
thermofluid	thermofluid	ADJ
leach	leaches	N;PL
depublish	depublish	V;NFIN
bridoon	bridoons	N;PL
quoter	quoters	N;PL
phlogogenous	phlogogenous	ADJ
valuational	valuational	ADJ
anear	anearing	V;V.PTCP;PRS
recorderist	recorderists	N;PL
tolloid	tolloids	N;PL
quester	quester	N;SG
over-educated	over-educated	ADJ
nonrectangular	nonrectangular	ADJ
macrophytobenthic	macrophytobenthic	ADJ
isoprostane	isoprostane	N;SG
chinovnik	chinovniks	N;PL
jharal	jharals	N;PL
birthdaye	birthdayes	N;PL
swan	swanned	V;V.PTCP;PST
factionalise	factionalised	V;PST
J-rock	J-rock	N;SG
reshave	reshaves	V;PRS;3;SG
rudge	rudges	N;PL
metametabolome	metametabolome	N;SG
kinamycin	kinamycin	N;SG
microbrachid	microbrachids	N;PL
syringaresinol	syringaresinol	N;SG
thiazovivin	thiazovivin	N;SG
squawl	squawls	V;PRS;3;SG
lansoprazole	lansoprazole	N;SG
necktie	neckties	N;PL
formiminotetrahydrofolate	formiminotetrahydrofolate	N;SG
pianet	pianets	N;PL
acme	acme	N;SG
yarpie	yarpies	N;PL
primordial	primordial	N;SG
emballage	emballages	N;PL
supermandatory	supermandatory	ADJ
backpacker	backpackers	N;PL
pinnatilobate	pinnatilobate	ADJ
cumberworld	cumberworld	N;SG
erythrophile	erythrophile	N;SG
kandite	kandites	N;PL
superwide	superwides	N;PL
sipahsalar	sipahsalar	N;SG
Trappist	Trappist	ADJ
single	single	ADJ
symphyomyrtle	symphyomyrtle	N;SG
barcalounger	barcalounger	N;SG
forlat	forleet	V;PST
tetracarbonate	tetracarbonates	N;PL
nepaline	nepaline	N;SG
unpopulated	unpopulated	ADJ
pathopoiesis	pathopoiesis	N;SG
refrain	refrain	N;SG
transparietal	transparietal	ADJ
uniplex	uniplex	ADJ
metabolimeter	metabolimeters	N;PL
whish	whish	ADJ
unpermeabilised	unpermeabilised	ADJ
scuntion	scuntions	N;PL
multicentric	multicentric	ADJ
stander	standers	N;PL
pluriarticular	pluriarticular	ADJ
centrifugate	centrifugate	N;SG
inurnment	inurnment	N;SG
sulphine	sulphines	N;PL
immunometry	immunometry	N;SG
goff	uncountable	N;PL
vicenary	vicenary	ADJ
cephalism	cephalisms	N;PL
right-back	right-back	N;SG
Bolognian	Bolognian	ADJ
monobasic	monobasic	ADJ
tetralemmatic	tetralemmatic	ADJ
pawkiness	pawkinesses	N;PL
brivla	brivla	N;SG
coördinate	coördinated	V;V.PTCP;PST
striker	striker	N;SG
pong	ponged	V;V.PTCP;PST
stomachic	stomachic	N;SG
mepartricin	mepartricin	N;SG
de-ethnicization	de-ethnicization	N;SG
sark	sark	N;SG
oxathiirane	oxathiirane	N;SG
overtriage	overtriaging	V;V.PTCP;PRS
barrel	barreled	V;PST
unary	unaries	N;PL
lusk	lusked	V;PST
complete	complete	N;SG
Ponzi	Ponzi	ADJ
standby	standbys	V;PRS;3;SG
forhare	forhare	V;NFIN
genethliac	genethliac	ADJ
esocid	esocid	N;SG
notetaking	notetaking	N;SG
demineraliser	demineralisers	N;PL
jargonize	jargonizes	V;PRS;3;SG
exteroception	exteroception	N;SG
underinsurance	underinsurance	N;SG
reticuloendotheliosis	reticuloendotheliosis	N;SG
condensery	condenseries	N;PL
tichel	tichel	N;SG
troglodytical	troglodytical	ADJ
gaolless	gaolless	ADJ
promiseful	promiseful	ADJ
repine	repined	V;PST
propugnacle	propugnacle	N;SG
cutlass	cutlass	N;SG
acridocarpoid	acridocarpoids	N;PL
ferhoodle	ferhoodled	V;V.PTCP;PST
bruhaha	bruhaha	N;SG
cablecast	cablecast	V;NFIN
homeochaotic	homeochaotic	ADJ
legislative	legislative	ADJ
inawe	inawe	V;NFIN
outstubborn	outstubborn	V;NFIN
filtrable	filtrable	ADJ
slack	slacking	V;V.PTCP;PRS
self-appointed	self-appointed	ADJ
carbyne	carbynes	N;PL
microperthite	microperthites	N;PL
TNB	TNB	N;SG
empyrean	empyrean	ADJ
shakedown	shakedowns	N;PL
superoleophobic	superoleophobic	ADJ
beerwort	beerworts	N;PL
loafing	loafing	N;SG
herbiferous	herbiferous	ADJ
band	bands	V;PRS;3;SG
mesemb	mesemb	N;SG
get	getting	V;V.PTCP;PRS
red-back	red-back	N;SG
ULCC	ULCC	N;SG
monocondylar	monocondylar	ADJ
intradirective	intradirective	ADJ
staphylotoxin	staphylotoxins	N;PL
squall	squall	N;SG
counterbond	counterbonds	N;PL
enterprising	enterprising	ADJ
ouzeri	ouzeris	N;PL
temporalize	temporalizes	V;PRS;3;SG
intrapatellar	intrapatellar	ADJ
derp	derp	N;SG
immediateness	immediateness	N;SG
color-coordinate	color-coordinating	V;V.PTCP;PRS
manumit	manumitted	V;PST
limpdick	limpdicks	N;PL
utopianist	utopianist	N;SG
quink	quinks	N;PL
transactivate	transactivating	V;V.PTCP;PRS
misjoin	misjoin	V;NFIN
socklet	socklet	N;SG
unscannable	unscannable	ADJ
retrocaval	retrocaval	ADJ
genospecies	genospecies	N;SG
beclam	beclamming	V;V.PTCP;PRS
trisul	trisul	N;SG
rhodoxanthin	rhodoxanthin	N;SG
rebat	rebatted	V;PST
e-basket	e-basket	N;SG
jughead	jughead	N;SG
acidothermophilic	acidothermophilic	ADJ
Trifluvien	Trifluvien	ADJ
hunted	hunted	ADJ
swellish	swellish	ADJ
kingmaking	kingmaking	N;SG
tanah	tanah	N;SG
hoopskirt	hoopskirt	N;SG
degradable	degradable	N;SG
catslide	catslides	N;PL
heroize	heroize	V;NFIN
pincushion	pincushioning	V;V.PTCP;PRS
esteemed	esteemed	ADJ
suit	suit	V;NFIN
amlodipine	amlodipine	N;SG
boddle	boddles	N;PL
squush	squush	N;SG
spiro-annulated	spiro-annulated	ADJ
æquilibrium	æquilibrium	N;SG
tepeelike	tepeelike	ADJ
behierite	behierite	N;SG
cutcha	cutcha	N;SG
eudiometrical	eudiometrical	ADJ
schoolteacherish	schoolteacherish	ADJ
appletini	appletini	N;SG
paleodistributional	paleodistributional	ADJ
misallot	misallotting	V;V.PTCP;PRS
counterbalancing	counterbalancing	N;SG
traumatic	traumatic	N;SG
plough	ploughs	N;PL
prelabral	prelabral	ADJ
intellectualoid	intellectualoid	N;SG
asepticise	asepticised	V;PST
oxadiazepine	oxadiazepine	N;SG
plotter	plottered	V;PST
spillikin	spillikins	N;PL
Adrianopolitan	Adrianopolitan	ADJ
diindium	diindium	N;SG
tallent	tallents	N;PL
Monegasque	Monegasque	N;SG
overlitigate	overlitigating	V;V.PTCP;PRS
zonampanel	zonampanel	N;SG
ylond	ylonds	N;PL
abduce	abduces	V;PRS;3;SG
antipsychiatrist	antipsychiatrists	N;PL
muzzling	muzzlings	N;PL
ISRC	ISRC	N;SG
sideburn	sideburn	N;SG
overbrand	overbranded	V;V.PTCP;PST
trypanolysis	trypanolysis	N;SG
overseam	overseamed	V;PST
microthromboembolism	microthromboembolisms	N;PL
abisetaoshi	abisetaoshi	N;SG
authigenic	authigenic	ADJ
janissary	janissary	N;SG
archæology	archæology	N;SG
neopine	neopine	N;SG
isobar	isobar	N;SG
leeboard	leeboards	N;PL
phosphoret	phosphorets	N;PL
Friendsy	Friendsy	ADJ
augur	augured	V;PST
crystallisable	crystallisable	ADJ
harumph	harumph	N;SG
bedance	bedanced	V;PST
humppa	humppa	N;SG
REBT	REBT	N;SG
neofunctionalize	neofunctionalized	V;V.PTCP;PST
bimetallist	bimetallist	ADJ
languet	languets	N;PL
virialize	virializes	V;PRS;3;SG
nanostructured	nanostructured	ADJ
cookielike	cookielike	ADJ
refollow	refollow	V;NFIN
parroket	parrokets	N;PL
Ibadhism	Ibadhism	N;SG
losing	losing	ADJ
harrow	harrows	V;PRS;3;SG
cusp	cusps	V;PRS;3;SG
pantless	pantless	ADJ
monoquark	monoquarks	N;PL
headmold	headmold	N;SG
completability	completability	N;SG
bab	bab	V;NFIN
nearcation	nearcation	N;SG
aculeate	aculeate	N;SG
gustable	gustable	ADJ
glucometer	glucometers	N;PL
hydroxystanozolol	hydroxystanozolol	N;SG
inosculate	inosculates	V;PRS;3;SG
water-loving	water-loving	ADJ
scard	scard	N;SG
polysomnographer	polysomnographers	N;PL
reorchestrator	reorchestrators	N;PL
diformazan	diformazan	N;SG
squirrelproof	squirrelproof	ADJ
expropriatory	expropriatory	ADJ
astroturfer	astroturfer	N;SG
rephrasing	rephrasing	N;SG
mesonychian	mesonychian	N;SG
bratticing	bratticings	N;PL
behenchod	behenchods	N;PL
semisweetness	semisweetness	N;SG
neurosonographic	neurosonographic	ADJ
ultrasimplify	ultrasimplifies	V;PRS;3;SG
fatherlessness	fatherlessness	N;SG
brickfilm	brickfilmed	V;PST
scout	scouts	V;PRS;3;SG
declutter	decluttered	V;PST
preregnant	preregnant	N;SG
alkanamide	alkanamide	N;SG
gabionade	gabionades	N;PL
superfix	superfixing	V;V.PTCP;PRS
untrace	untracing	V;V.PTCP;PRS
collaborativeness	collaborativeness	N;SG
strub	strubs	V;PRS;3;SG
mitochondrial	mitochondrial	ADJ
remarry	remarrying	V;V.PTCP;PRS
respectlessness	respectlessness	N;SG
XIIIth	XIIIth	ADJ
dunikin	dunikins	N;PL
minibrowser	minibrowser	N;SG
agible	agible	ADJ
milksoppery	milksoppery	N;SG
multiramified	multiramified	ADJ
tityra	tityra	N;SG
asynartete	asynartete	N;SG
googly	googlier	ADJ;CMPR
scribable	scribable	ADJ
unmanacle	unmanacled	V;PST
overweather	overweathering	V;V.PTCP;PRS
green-sickness	green-sickness	N;SG
poohbah	poohbah	N;SG
reticulothalamocortical	reticulothalamocortical	ADJ
resculpt	resculpt	V;NFIN
missionee	missionee	N;SG
Vehmic	Vehmic	ADJ
climatic	climatic	ADJ
dribblesome	dribblesome	ADJ
outmigrate	outmigrating	V;V.PTCP;PRS
chukker	chukkers	N;PL
colourcast	colourcast	N;SG
skry	skrying	V;V.PTCP;PRS
birdlime	birdlime	N;SG
milkpan	milkpans	N;PL
psychoanalyser	psychoanalyser	N;SG
emplunge	emplunged	V;V.PTCP;PST
barocline	barocline	ADJ
undercalculation	undercalculation	N;SG
photoinject	photoinject	V;NFIN
Godsakes	Godsakes	N;SG
jambok	jamboks	N;PL
bedust	bedusted	V;PST
Arctalian	Arctalian	ADJ
synsystematic	synsystematic	ADJ
harmomegathy	harmomegathy	N;SG
Pancyprian	Pancyprian	ADJ
strowl	strowl	N;SG
inlard	inlard	V;NFIN
unisonance	unisonance	N;SG
aminol	aminol	N;SG
mistpouffer	mistpouffers	N;PL
ratskin	ratskin	N;SG
wildcraft	wildcrafts	V;PRS;3;SG
shack	shack	V;NFIN
Transkeian	Transkeian	N;SG
supernebular	supernebular	ADJ
endocystic	endocystic	ADJ
exhibitioner	exhibitioner	N;SG
emendate	emendated	V;PST
meaty	meaty	ADJ
hydrochore	hydrochore	N;SG
ungod	ungod	N;SG
nonobjective	nonobjectives	N;PL
scutch	scutching	V;V.PTCP;PRS
broadsheet	broadsheet	N;SG
subfeature	subfeatures	N;PL
thalassemydid	thalassemydids	N;PL
thrombocytemia	thrombocytemia	N;SG
goof	goofed	V;PST
nerinellid	nerinellids	N;PL
diethylthioxanthone	diethylthioxanthone	N;SG
clinda	clinda	N;SG
tavern-cut	tavern-cut	ADJ
goldenberry	goldenberries	N;PL
backread	backread	V;PST
hasp	hasped	V;V.PTCP;PST
hypersoft	hypersofts	N;PL
Peorian	Peorian	N;SG
farcinous	farcinous	ADJ
relativization	relativization	N;SG
petabecquerel	petabecquerels	N;PL
winterproof	winterproofs	V;PRS;3;SG
seismite	seismite	N;SG
starey	starier	ADJ;CMPR
inosinic	inosinic	ADJ
unvigilant	unvigilant	ADJ
adelphophage	adelphophage	N;SG
unrebukable	unrebukable	ADJ
constrict	constricting	V;V.PTCP;PRS
abirritate	abirritating	V;V.PTCP;PRS
bierkeller	bierkeller	N;SG
stenogastrine	stenogastrines	N;PL
radicel	radicels	N;PL
nodulize	nodulized	V;V.PTCP;PST
hypochondriac	hypochondriac	N;SG
yawniness	yawniness	N;SG
institutionality	institutionality	N;SG
impartable	impartable	ADJ
osculatory	osculatory	ADJ
howel	howelled	V;V.PTCP;PST
lingualization	lingualization	N;SG
blowen	blowens	N;PL
upstream	upstreaming	V;V.PTCP;PRS
micrograft	micrografting	V;V.PTCP;PRS
ionoscopid	ionoscopid	N;SG
caviar	caviar	N;SG
aphantasiac	aphantasiac	N;SG
electronystagmographical	electronystagmographical	ADJ
underbark	underbark	N;SG
intersong	intersong	ADJ
smartmodem	smartmodems	N;PL
glint	glint	N;SG
zee	zeeing	V;V.PTCP;PRS
electrotype	electrotype	V;NFIN
overjudge	overjudge	N;SG
intermission	intermission	N;SG
Corkonian	Corkonian	N;SG
encharge	encharging	V;V.PTCP;PRS
euryarchaeon	euryarchaeons	N;PL
nanotracer	nanotracers	N;PL
jabronie	jabronie	N;SG
unevacuated	unevacuated	ADJ
isomeride	isomerides	N;PL
conferencee	conferencees	N;PL
differentness	differentness	N;SG
kebab	kebabs	V;PRS;3;SG
tablea	tablea	N;SG
gammacism	gammacism	N;SG
cuck	cucks	N;PL
genderquake	genderquake	N;SG
glee-beam	glee-beam	N;SG
flatten	flattened	V;V.PTCP;PST
cuspal	cuspal	ADJ
coit	coit	N;SG
baghouse	baghouse	N;SG
baby-sitting	baby-sitting	N;SG
excyclotorsion	excyclotorsion	N;SG
smeller	smellers	N;PL
misedit	misedit	V;NFIN
ausktribosphenid	ausktribosphenids	N;PL
unphilosophise	unphilosophised	V;PST
ultrahuman	ultrahuman	ADJ
yartseit	yartseits	N;PL
class-based	class-based	ADJ
listen	listened	V;PST
implicative	implicative	ADJ
tetratricopeptide	tetratricopeptide	N;SG
roundoff	roundoff	N;SG
styliferous	styliferous	ADJ
grayhead	grayheads	N;PL
untabify	untabifying	V;V.PTCP;PRS
adventure	adventuring	V;V.PTCP;PRS
empyrean	empyreans	N;PL
cyclodimerize	cyclodimerized	V;V.PTCP;PST
paleoaeolian	paleoaeolian	ADJ
scholasticize	scholasticized	V;PST
isoventiloquinone	isoventiloquinone	N;SG
glaze	glazed	V;PST
wandmaker	wandmaker	N;SG
disoxygenate	disoxygenated	V;PST
backflow	backflow	N;SG
garbage	garbaging	V;V.PTCP;PRS
molcajete	molcajete	N;SG
bushwalker	bushwalkers	N;PL
daphnin	daphnin	N;SG
try-scorer	try-scorer	N;SG
biofiltration	biofiltration	N;SG
commix	commixed	V;PST
Catalanize	Catalanized	V;PST
adulticide	adulticide	N;SG
enfringe	enfringes	V;PRS;3;SG
attitude	attituding	V;V.PTCP;PRS
cicerone	cicerone	V;NFIN
multiday	multiday	ADJ
despeed	despeed	V;NFIN
invigilate	invigilate	V;NFIN
anteroloph	anterolophs	N;PL
antineuroinflammatory	antineuroinflammatory	ADJ
chowter	chowtering	V;V.PTCP;PRS
tardface	tardface	N;SG
indeterminateness	indeterminateness	N;SG
munite	munited	V;V.PTCP;PST
œnochoe	œnochoe	N;SG
blouze	blouzes	N;PL
electrical	electricals	N;PL
pilgrim	pilgrims	V;PRS;3;SG
hypolith	hypoliths	N;PL
applicator	applicator	N;SG
sexfight	sexfights	V;PRS;3;SG
pink	pinkest	ADJ;SPRL
levelize	levelizes	V;PRS;3;SG
analphabetic	analphabetic	N;SG
muzzle	muzzle	V;NFIN
swaggy	swaggy	ADJ
leady	leady	ADJ
titrimeter	titrimeter	N;SG
discovenant	discovenant	V;NFIN
undecasulfide	undecasulfide	N;SG
nyctibiid	nyctibiid	N;SG
octadiene	octadienes	N;PL
postulate	postulate	N;SG
recoverable	recoverables	N;PL
Spinaltapian	Spinaltapian	ADJ
confuddle	confuddle	N;SG
melomys	melomys	N;SG
trueborn	trueborn	N;SG
brachyodont	brachyodont	ADJ
caseamembrin	caseamembrins	N;PL
brevetcy	brevetcies	N;PL
nonpresentist	nonpresentist	ADJ
draughtman	draughtman	N;SG
scramasax	scramasaxes	N;PL
minidisk	minidisk	N;SG
myofibroblastoma	myofibroblastoma	N;SG
porotype	porotypes	N;PL
up to snuff	up to snuff	ADJ
shrimp	shrimp	N;SG
sternovertebral	sternovertebral	ADJ
cane	caning	V;V.PTCP;PRS
potion	potions	N;PL
bubal	bubals	N;PL
mamoncillo	mamoncillos	N;PL
overdensity	overdensity	N;SG
lentitude	lentitude	N;SG
essentialist	essentialists	N;PL
counter-rally	counter-rally	N;SG
kindergartner	kindergartners	N;PL
deviatory	deviatory	ADJ
antimisting	antimisting	ADJ
jazznik	jazznik	N;SG
remuscularize	remuscularized	V;PST
upsitting	upsittings	N;PL
artoindonesianin	artoindonesianin	N;SG
bitruncation	bitruncation	N;SG
Dostoyevskyan	Dostoyevskyan	ADJ
fucosylation	fucosylation	N;SG
sociorobotics	sociorobotics	N;SG
threesomeness	threesomeness	N;SG
periannular	periannular	ADJ
saturniine	saturniine	N;SG
connotation	connotation	N;SG
shadelessness	shadelessness	N;SG
agglomerant	agglomerant	ADJ
apsis	apsis	N;SG
incorporeal	incorporeal	ADJ
megadestruction	megadestruction	N;SG
cowardness	cowardness	N;SG
decisiveness	decisiveness	N;SG
telefuture	telefutures	N;PL
radiodense	radiodense	ADJ
battell	battell	N;SG
bilirubinoid	bilirubinoid	N;SG
ectocuneiform	ectocuneiform	N;SG
kickstart	kickstart	N;SG
proscillaridin	proscillaridin	N;SG
nurl	nurl	V;NFIN
spatter	spatter	N;SG
scatterometric	scatterometric	ADJ
embryotoxicity	embryotoxicities	N;PL
screenwrite	screenwrites	V;PRS;3;SG
hyperoliid	hyperoliid	N;SG
bromoarene	bromoarenes	N;PL
half-caf	half-caf	ADJ
homotopical	homotopical	ADJ
plagiarizer	plagiarizer	N;SG
polystelic	polystelic	ADJ
edematization	edematization	N;SG
foremove	foremove	V;NFIN
uprouse	uprousing	V;V.PTCP;PRS
immunostain	immunostained	V;V.PTCP;PST
iterative	iteratives	N;PL
Ivorian	Ivorian	N;SG
hormetic	hormetic	ADJ
close	closed	V;V.PTCP;PST
geoenvironment	geoenvironment	N;SG
PCP	PCP	N;SG
linyphiid	linyphiids	N;PL
salmonburger	salmonburgers	N;PL
overstare	overstared	V;V.PTCP;PST
effect	effects	V;PRS;3;SG
candlewax	candlewax	N;SG
hemiabdomen	hemiabdomen	N;SG
reconcatenate	reconcatenate	V;NFIN
caross	carosses	N;PL
mixmatch	mixmatching	V;V.PTCP;PRS
fine and dandy	fine and dandy	ADJ
dephlogisticate	dephlogisticating	V;V.PTCP;PRS
she-mullet	she-mullet	N;SG
peakflowmeter	peakflowmeter	N;SG
bone-crunching	bone-crunching	ADJ
gatoring	gatorings	N;PL
furless	furless	ADJ
periculous	periculous	ADJ
forburst	forbursts	V;PRS;3;SG
copay	copays	V;PRS;3;SG
antirad	antirads	N;PL
right-on	right-on	ADJ
pittancer	pittancer	N;SG
diaphragmic	diaphragmic	ADJ
crabspider	crabspiders	N;PL
Spenserism	Spenserism	N;SG
diisopropylamino	diisopropylaminos	N;PL
standardbred	standardbreds	N;PL
glucoevatromonoside	glucoevatromonoside	N;SG
dyer	dyers	N;PL
homopolyriboadenine	homopolyriboadenine	N;SG
irredundance	irredundances	N;PL
sporophyte	sporophytes	N;PL
jaconine	jaconine	N;SG
confabulatory	confabulatory	ADJ
misanalyze	misanalyzing	V;V.PTCP;PRS
tuscor	tuscor	N;SG
shiksa	shiksas	N;PL
stardrive	stardrive	N;SG
makuuchi-kaku	makuuchi-kaku	N;SG
populizer	populizers	N;PL
equicrural	equicrural	ADJ
Iranianisation	Iranianisation	N;SG
relate	relate	V;NFIN
redecorator	redecorator	N;SG
cream-fruit	cream-fruit	N;SG
penitentiary	penitentiaries	N;PL
tirtha	tirtha	N;SG
insurrectionism	insurrectionism	N;SG
unhair	unhairing	V;V.PTCP;PRS
despatch	despatched	V;V.PTCP;PST
demitazza	demitazzas	N;PL
mormaer	mormaer	N;SG
unconcealment	unconcealment	N;SG
principle	principles	V;PRS;3;SG
humanize	humanized	V;V.PTCP;PST
kirtan	kirtans	N;PL
matching	better	ADJ;CMPR
hysterocolposigmoidectomy	hysterocolposigmoidectomies	N;PL
neurovesicle	neurovesicle	N;SG
rebbachisaurid	rebbachisaurids	N;PL
degenitalize	degenitalizing	V;V.PTCP;PRS
quitter	quitter	V;NFIN
nonpoints	nonpoints	ADJ
fahlore	fahlore	N;SG
bitline	bitlines	N;PL
sipper	sipper	N;SG
nongeminated	nongeminated	ADJ
uchiage	uchiage	N;SG
imbound	imbounds	V;PRS;3;SG
maximization	maximization	N;SG
expressionist	expressionist	N;SG
jackal	jackals	V;PRS;3;SG
probabiliorist	probabiliorists	N;PL
crawlspace	crawlspace	N;SG
gasteropodous	gasteropodous	ADJ
fibroidlike	fibroidlike	ADJ
Sophenian	Sophenian	N;SG
glomerulonephrosis	glomerulonephrosis	N;SG
overstrictness	overstrictness	N;SG
paramilitarize	paramilitarizes	V;PRS;3;SG
obelisk	obelisk	N;SG
kiki	kikis	V;PRS;3;SG
proletarianize	proletarianized	V;V.PTCP;PST
violent	violenting	V;V.PTCP;PRS
cloggy	cloggier	ADJ;CMPR
jejunocolostomy	jejunocolostomies	N;PL
relic	relic	N;SG
brickfielder	brickfielders	N;PL
succour	succour	V;NFIN
biogenealogical	biogenealogical	ADJ
reproject	reprojecting	V;V.PTCP;PRS
axing	axing	N;SG
syllogise	syllogised	V;V.PTCP;PST
sumset	sumset	N;SG
elkhound	elkhound	N;SG
HEVC	HEVC	N;SG
shit	uncountable	N;PL
bargainee	bargainee	N;SG
ispaghul	ispaghul	N;SG
ancillary	ancillary	N;SG
anti-circumcisionist	anti-circumcisionist	N;SG
borky	borky	ADJ
petunioside	petunioside	N;SG
biosource	biosources	N;PL
papulation	papulation	N;SG
regional	regionals	N;PL
lectisternium	lectisternium	N;SG
equispace	equispacing	V;V.PTCP;PRS
zygnemataceous	zygnemataceous	ADJ
doenjang	doenjang	N;SG
antipathist	antipathist	N;SG
redtail	redtails	N;PL
ram	ram	V;NFIN
varicella	varicella	N;SG
unfry	unfried	V;PST
arsoline	arsoline	N;SG
Mohole	Mohole	N;SG
carbamidomethylation	carbamidomethylation	N;SG
subtopic	subtopic	N;SG
Italianize	Italianized	V;V.PTCP;PST
handcart	handcarts	N;PL
heterosubstituted	heterosubstituted	ADJ
moistening	moistenings	N;PL
embroglio	embroglios	N;PL
on-line	on-line	ADJ
absolver	absolver	N;SG
postmedication	postmedication	ADJ
anti-Shiite	anti-Shiite	ADJ
waiverer	waiverer	N;SG
Britpick	Britpicked	V;V.PTCP;PST
chilihead	chiliheads	N;PL
tibicen	tibicen	N;SG
tone	tone	N;SG
nanocavity	nanocavities	N;PL
platyconic	platyconic	ADJ
violinmaker	violinmakers	N;PL
watermelon	watermelon	N;SG
antling	antlings	N;PL
telefrag	telefragged	V;PST
recapper	recapper	N;SG
leptomonad	leptomonad	N;SG
yofortierite	yofortierite	N;SG
baklava-like	baklava-like	ADJ
tribromomethyl	tribromomethyl	N;SG
noncrop	noncrops	N;PL
qafila	qafila	N;SG
antirestenotic	antirestenotic	ADJ
subjectivize	subjectivized	V;V.PTCP;PST
christophene	christophenes	N;PL
Novocastrian	Novocastrian	N;SG
blossoming	blossoming	N;SG
ungenerate	ungenerating	V;V.PTCP;PRS
pentamolybdate	pentamolybdates	N;PL
Albanologist	Albanologist	N;SG
birr	birrs	N;PL
automobile	automobiled	V;V.PTCP;PST
undean	undean	V;NFIN
counterpicket	counterpickets	N;PL
schismatic	schismatic	N;SG
folkboat	folkboat	N;SG
entropion	entropion	N;SG
enfamish	enfamishing	V;V.PTCP;PRS
garnishee	garnisheeing	V;V.PTCP;PRS
anemofrigid	anemofrigid	ADJ
dimethacrylate	dimethacrylate	N;SG
antiseize	antiseize	N;SG
arrish	arrish	N;SG
wold	wolds	N;PL
preotic	preotic	ADJ
eunuchoid	eunuchoids	N;PL
BGM	BGM	N;SG
dimming	dimming	N;SG
tipteerer	tipteerers	N;PL
snurging	snurging	N;SG
sleepyhead	sleepyheads	N;PL
myek	myek	V;NFIN
posteroventrolateral	posteroventrolateral	ADJ
ribolyse	ribolyses	V;PRS;3;SG
fornim	fornim	V;NFIN
Europewide	Europewide	ADJ
mimetical	mimetical	ADJ
authenticatable	authenticatable	ADJ
alienize	alienized	V;PST
hance	hancing	V;V.PTCP;PRS
ramoon-tree	ramoon-tree	N;SG
metaplay	metaplay	N;SG
microcity	microcity	N;SG
spoonbilled	spoonbilled	ADJ
nonmineralizing	nonmineralizing	ADJ
dipositronium	dipositronium	N;SG
swaip	swaips	V;PRS;3;SG
rhamphorhynchid	rhamphorhynchids	N;PL
fission	fission	V;NFIN
toxicovigilance	toxicovigilance	N;SG
anacusic	anacusic	ADJ
trawlwire	trawlwire	N;SG
diallist	diallist	N;SG
decagramme	decagramme	N;SG
estetrol	estetrol	N;SG
exomorphological	exomorphological	ADJ
dispauperise	dispauperised	V;V.PTCP;PST
mitogenome	mitogenome	N;SG
somnogram	somnogram	N;SG
trachiniform	trachiniforms	N;PL
gammoid	gammoids	N;PL
hyperkaliaemia	hyperkaliaemia	N;SG
borickite	borickite	N;SG
derivate	derivating	V;V.PTCP;PRS
bloodshot	bloodshot	ADJ
tact	tacts	V;PRS;3;SG
denitrate	denitrated	V;PST
serononresponder	serononresponder	N;SG
correlate	correlated	V;PST
rework	reworks	V;PRS;3;SG
etwee	etwees	N;PL
vorton	vorton	N;SG
capade	capade	N;SG
blackride	blackrides	N;PL
flapjack	flapjack	N;SG
subratio	subratios	N;PL
manumise	manumised	V;PST
diminazen	diminazen	N;SG
poutsome	poutsome	ADJ
orichalceous	orichalceous	ADJ
nix	uncountable	N;PL
TU	TU	N;SG
gippo	gippo	N;SG
biorthonormal	biorthonormal	ADJ
duckpin	duckpins	N;PL
oxononenal	oxononenal	N;SG
macroverse	macroverses	N;PL
biomicroscopy	biomicroscopy	N;SG
vantage	vantage	V;NFIN
shrimpery	shrimperies	N;PL
tucum	tucum	N;SG
guarantee	guarantees	V;PRS;3;SG
waycism	waycism	N;SG
choroisotherm	choroisotherms	N;PL
myorhythmia	myorhythmia	N;SG
enter	enters	V;PRS;3;SG
administer	administer	V;NFIN
nonovarian	nonovarian	ADJ
smoulder	smouldering	V;V.PTCP;PRS
tokolytic	tokolytic	N;SG
heteronucleophile	heteronucleophile	N;SG
enantiospecific	enantiospecific	ADJ
imiclopazine	imiclopazine	N;SG
wait-a-bit	wait-a-bit	N;SG
actinobacteriophage	actinobacteriophages	N;PL
skatemobile	skatemobile	N;SG
forthrist	forthrists	V;PRS;3;SG
humbug	humbugged	V;V.PTCP;PST
dry-gulch	dry-gulched	V;V.PTCP;PST
snow-blow	snow-blowed	V;V.PTCP;PST
slab	slabbed	V;PST
idoliser	idolisers	N;PL
expiscate	expiscated	V;PST
gether	gether	V;NFIN
microscabrate	microscabrate	ADJ
lallation	lallation	N;SG
Hamawi	Hamawi	N;SG
fermium	fermium	N;SG
sarcomagenesis	sarcomagenesis	N;SG
excede	exceded	V;PST
semitropical	semitropical	ADJ
bracingness	bracingness	N;SG
unobscure	unobscured	V;PST
brick	brick	ADJ
duckly	duckly	ADJ
enviability	enviability	N;SG
surcharger	surcharger	N;SG
phthirapterist	phthirapterists	N;PL
subalgebraic	subalgebraic	ADJ
pigswill	pigswill	N;SG
precogitate	precogitates	V;PRS;3;SG
religionism	religionism	N;SG
unbuild	unbuilds	V;PRS;3;SG
uttermore	uttermore	ADJ
parascholzite	parascholzite	N;SG
geeky	geeky	ADJ
born	bornt	V;V.PTCP;PST
crémaillère	crémaillère	N;SG
welfare	welfared	V;V.PTCP;PST
autodispenser	autodispensers	N;PL
Tagalog	Tagalog	ADJ
palmitoleate	palmitoleate	N;SG
MD5-summed	MD5-summed	ADJ
biconstituent	biconstituent	ADJ
ladder	laddered	V;V.PTCP;PST
trennel	trennels	N;PL
nonspatiotemporal	nonspatiotemporal	ADJ
suffusive	suffusive	ADJ
janegirl	janegirls	N;PL
unfeudalise	unfeudalised	V;PST
bk	bks	N;PL
precast	precast	V;NFIN
infrahilar	infrahilar	ADJ
bisiliac	bisiliac	ADJ
telluret	telluret	N;SG
re-addicting	re-addicting	ADJ
macrophage	macrophages	N;PL
louring	louring	N;SG
minecar	minecars	N;PL
pleuraspidotheriid	pleuraspidotheriid	N;SG
elasticity	elasticity	N;SG
plagiotropic	plagiotropic	ADJ
brickmould	brickmould	N;SG
matrass	matrasses	N;PL
polychoir	polychoir	ADJ
moot-hall	moot-hall	N;SG
lordhood	lordhood	N;SG
subword	subwords	N;PL
betulate	betulates	N;PL
sowm	sowms	V;PRS;3;SG
moocah	moocah	N;SG
præsent	præsent	N;SG
shovelfish	shovelfish	N;SG
air-drop	air-droped	V;V.PTCP;PST
pyramidist	pyramidist	N;SG
geocoris	geocoris	N;SG
postenvenomation	postenvenomation	ADJ
dictyate	dictyate	N;SG
eastie	easties	N;PL
hatch	hatch	N;SG
stellite	stellite	N;SG
jellygraph	jellygraphed	V;PST
sploit	sploits	N;PL
cunnilinguate	cunnilinguate	V;NFIN
potentacy	potentacy	N;SG
Paschal	Paschal	ADJ
florosenine	florosenine	N;SG
dibs	dibsing	V;V.PTCP;PRS
smilet	smilet	N;SG
hijaab	hijaabs	N;PL
gollar	gollar	V;NFIN
covener	coveners	N;PL
unheal	unheal	V;NFIN
Hitlerian	Hitlerian	ADJ
syntaxless	syntaxless	ADJ
noncanceled	noncanceled	ADJ
Moslemize	Moslemized	V;V.PTCP;PST
immixture	immixtures	N;PL
afterbrain	afterbrain	N;SG
metrization	metrizations	N;PL
tweet-worthy	tweet-worthy	ADJ
oligo	oligo	N;SG
samplist	samplist	N;SG
het	countable	N;PL
spade	spade	V;NFIN
primp	primped	V;V.PTCP;PST
outcrop	outcrop	V;NFIN
nodopathy	nodopathies	N;PL
rubidium-strontium	rubidium-strontium	N;SG
strimmer	strimmer	N;SG
ramixotidine	ramixotidine	N;SG
parentation	parentation	N;SG
global	global	ADJ
kotenage	kotenage	N;SG
trilobitologist	trilobitologists	N;PL
mufflered	mufflered	ADJ
bacteriography	bacteriography	N;SG
prophesize	prophesizes	V;PRS;3;SG
chemautotrophic	chemautotrophic	ADJ
biverbal	biverbal	ADJ
cichlid	cichlids	N;PL
mouzhik	mouzhiks	N;PL
blowjob	blowjobs	N;PL
dihedral	dihedral	ADJ
dorayaki	dorayaki	N;SG
depreciation	depreciation	N;SG
prototype	prototype	V;NFIN
degausser	degausser	N;SG
nonwearable	nonwearable	ADJ
Euroskeptical	Euroskeptical	ADJ
somnambulize	somnambulizing	V;V.PTCP;PRS
pharyngoconjunctival	pharyngoconjunctival	ADJ
facultize	facultized	V;PST
shrowd	shrowds	V;PRS;3;SG
lance	lance	N;SG
gastriloquist	gastriloquists	N;PL
valinamide	valinamides	N;PL
furlougher	furlougher	N;SG
Kanak	Kanak	N;SG
bonus	bonused	V;PST
buttonwood	buttonwoods	N;PL
bepuddle	bepuddling	V;V.PTCP;PRS
Rebecca	Rebecca	N;SG
expulse	expulses	V;PRS;3;SG
whatsis	whatsises	N;PL
paniphal	paniphals	N;PL
bioevent	bioevent	N;SG
comitial	comitial	ADJ
conrotary	conrotary	ADJ
mallecho	mallecho	N;SG
selenoperoxidase	selenoperoxidases	N;PL
cuckoo-dove	cuckoo-dove	N;SG
Glauconian	Glauconian	ADJ
hamburg	hamburgs	N;PL
foreshoot	foreshot	V;V.PTCP;PST
graphophobia	graphophobia	N;SG
blizzicane	blizzicane	N;SG
infaring	infaring	N;SG
nulliporous	nulliporous	ADJ
eventualise	eventualising	V;V.PTCP;PRS
bayonetted	bayonetted	ADJ
aporphine	aporphine	N;SG
uncuddled	uncuddled	ADJ
buko	buko	N;SG
recup	recups	V;PRS;3;SG
suprascapulary	suprascapulary	ADJ
Mithraic	Mithraic	ADJ
renate	renate	ADJ
scrubless	scrubless	ADJ
descendency	descendency	N;SG
trypanophobia	trypanophobia	N;SG
faradizer	faradizer	N;SG
hiccough	hiccoughs	N;PL
equipartition	equipartitioned	V;V.PTCP;PST
schooltide	schooltide	N;SG
photoreaction	photoreactions	N;PL
guanidinium	guanidinium	N;SG
plightless	plightless	ADJ
punning	punnings	N;PL
Qwerty	Qwerty	ADJ
