fildear	fildeasteis	V;IND;PST;PFV;2;PL;INFM
sobresaturar	sobresaturarán	V;IND;FUT;3;PL
interioridad	interioridades	N;FEM;PL
platicar	platicasen	V;SBJV;PST;3;PL
rastafari	rastafari	N;MASC+FEM;SG
apegar	apegáramos	V;SBJV;PST;LGSPEC1;1;PL
afanarse	nos afanaremos	V;IND;FUT;1;PL
sicoanalizar	sicoanalizarnos	V;ACC;PRO;1;PL
entoldar	entoldase	V;SBJV;PST;LGSPEC2;2;SG;FORM
cumplir	no cumplamos	V;NEG;IMP;1;PL
partir	partía	V;IND;PST;IPFV;2;SG;FORM
nueva	nuevas	N;FEM;PL
profugar	profugo	V;IND;PRS;1;SG
descompilación	descompilaciones	N;FEM;PL
criptodivisa	criptodivisa	N;FEM;SG
expropiar	expropie	V;SBJV;PRS;2;SG;FORM
embazar	embazamos	V;IND;PST;PFV;1;PL
luchar	lúchales	V;IMP;INFM;2;SG;DAT;PRO;3;PL
carcomer	carcómanos	V;IMP;FORM;2;SG;ACC;PRO;1;PL
acerar	acerásemos	V;SBJV;PST;LGSPEC2;1;PL
propalar	propálelas	V;IMP;FORM;2;SG;ACC;PRO;3;PL
esencializar	esencialícenla	V;IMP;FORM;2;PL;ACC;PRO;3;SG
vituperio	vituperios	N;MASC;PL
embrutecimiento	embrutecimientos	N;MASC;PL
noquear	noqueé	V;IND;PST;PFV;1;SG
subalquilar	subalquilan	V;IND;PRS;3;PL
aciemar	aciemaran	V;SBJV;PST;LGSPEC1;3;PL
somorgujar	somorgujare	V;SBJV;FUT;2;SG;FORM
falsear	falseadnos	V;IMP;INFM;2;PL;ACC;PRO;1;PL
repelar	repelare	V;SBJV;FUT;3;SG
interceder	intercédanlas	V;IMP;FORM;2;PL;ACC;PRO;3;PL
desquitar	desquitarme	V;DAT;PRO;1;SG
deschavar	deschavadla	V;IMP;INFM;2;PL;ACC;PRO;3;SG
cranear	cranea	V;IND;PRS;2;SG;FORM
rasmillar	rasmillabas	V;IND;PST;IPFV;2;SG;INFM
frijolar	frijolar	N;MASC;SG
neocolonizar	neocolonizaba	V;IND;PST;IPFV;1;SG
bajar	bajen	V;SBJV;PRS;3;PL
fildear	fildeará	V;IND;FUT;3;SG
mampostear	mamposteáis	V;IND;PRS;2;PL;INFM
frangir	fránjannos	V;IMP;FORM;2;PL;ACC;PRO;1;PL
frecuentar	frecuentad	V;POS;IMP;2;PL;INFM
preparar	preparásemos	V;SBJV;PST;1;PL
chamarilear	chamarilearíamos	V;COND;1;PL
entrecortar	entrecortará	V;IND;FUT;3;SG
certificar	no certifique	V;NEG;IMP;2;SG;FORM
sustraer	sustráelas	V;IMP;INFM;2;SG;ACC;PRO;3;PL
apartamento	apartamento	N;MASC;SG
colear	coleamos	V;IND;PST;PFV;1;PL
rociar	rocíe	V;SBJV;PRS;1;SG
despolvar	no despolven	V;NEG;IMP;3;PL
controlar	controladles	V;IMP;INFM;2;PL;DAT;PRO;3;PL
cifrar	cifraría	V;COND;1;SG
taquear	taqueare	V;SBJV;FUT;2;SG;FORM
magnetopausa	magnetopausa	N;FEM;SG
disonar	disonará	V;IND;FUT;2;SG;FORM
aficionar	aficionas	V;IND;PRS;2;SG;INFM
ironizar	ironizarías	V;COND;2;SG;INFM
rasguear	rasgueaba	V;IND;PST;IPFV;2;SG;FORM
nublar	nublaras	V;SBJV;PST;LGSPEC1;2;SG;INFM
desautorizar	desautorizaba	V;IND;PST;IPFV;1;SG
corresponsabilizar	no corresponsabilice	V;NEG;IMP;3;SG
entrujar	entrujo	V;IND;PRS;1;SG
hortaliza	hortalizas	N;FEM;PL
celulasa	celulasas	N;FEM;PL
copilotar	copilotándolas	V;V.CVB;PRS;ACC;PRO;3;PL
preguntarse	os preguntaseis	V;SBJV;PST;2;PL;INFM
enllavar	enllava	V;IND;PRS;2;SG;FORM
cirrótico	cirróticas	ADJ;FEM;PL
excluir	excluyas	V;SBJV;PRS;2;SG;INFM
cuchichear	cuchicheadas	V;V.PTCP;PST;FEM;PL
hociquear	hociqueados	V;V.PTCP;PST;MASC;PL
logar	logamos	V;IND;PRS;1;PL
enviciar	envícienme	V;IMP;FORM;2;PL;DAT;PRO;1;SG
carrillón	carrillones	N;MASC;PL
celebrar	celebrabais	V;IND;PST;IPFV;2;PL;INFM
desensillar	desensillándonos	V;V.CVB;PRS;DAT;PRO;1;PL
traumar	traumáremos	V;SBJV;FUT;1;PL
humanizar	no humanice	V;NEG;IMP;2;SG;FORM
chisporrotear	chisporroteó	V;IND;PST;PFV;2;SG;FORM
aptar	aptabais	V;IND;PST;IPFV;2;PL;INFM
limonense	limonense	N;MASC+FEM;SG
okupar	okupad	V;POS;IMP;2;PL;INFM
humillación	humillación	N;FEM;SG
entrampar	entrampabas	V;IND;PST;IPFV;2;SG;INFM
perquirir	perquiera	V;POS;IMP;2;SG;FORM
yantar	yantase	V;SBJV;PST;3;SG
empellar	empéllela	V;IMP;FORM;2;SG;ACC;PRO;3;SG
dilatar	dilaten	V;POS;IMP;2;PL;FORM
disfrazar	disfrazo	V;IND;PRS;1;SG
rebasar	rebasa	V;IND;PRS;2;SG;FORM
sofrenar	sofrenara	V;SBJV;PST;LGSPEC1;1;SG
entablar	entablemos	V;POS;IMP;1;PL
sorprender	sorprendieron	V;IND;PST;PFV;3;PL
maquetar	maquetamos	V;IND;PRS;1;PL
giroelongar	giroelónguenos	V;IMP;FORM;2;SG;DAT;PRO;1;PL
remontar	remonten	V;POS;IMP;3;PL
receloso	recelosa	ADJ;FEM;SG
chicoleo	chicoleo	N;MASC;SG
carear	careándote	V;V.CVB;PRS;DAT;PRO;2;SG
copilotar	copilotado	V;V.PTCP;PST;MASC;SG
presupuestar	presupuestarte	V;DAT;PRO;2;SG
precalentar	precalentare	V;SBJV;FUT;1;SG
cabaret	cabaret	N;MASC;SG
enmicar	enmicaréis	V;IND;FUT;2;PL;INFM
acotejar	acotejáis	V;IND;PRS;2;PL;INFM
desleír	desliéremos	V;SBJV;FUT;1;PL
aunar	aunaré	V;IND;FUT;1;SG
matraquear	matraqueemos	V;SBJV;PRS;1;PL
ignorar	ignorará	V;IND;FUT;2;SG;FORM
palet	palet	N;MASC;SG
decuplar	no decuplemos	V;NEG;IMP;1;PL
casablanqués	casablanquesas	ADJ;FEM;PL
precompilar	precompilémonos	V;IMP;1;PL;ACC;PRO;1;PL
ahuciar	ahúciate	V;IMP;INFM;2;SG;ACC;PRO;2;SG
aplaudir	aplaudís	V;IND;PRS;2;PL;INFM
sobrevenir	sobrevéngalas	V;IMP;FORM;2;SG;ACC;PRO;3;PL
descalificar	descalificareis	V;SBJV;FUT;2;PL;INFM
cartografiar	cartografiándote	V;V.CVB;PRS;DAT;PRO;2;SG
dovelar	no dovele	V;NEG;IMP;2;SG;FORM
visitar	visitémoste	V;IMP;1;PL;ACC;PRO;2;SG
fagocitar	fagocitarais	V;SBJV;PST;LGSPEC1;2;PL;INFM
expirar	no expiremos	V;NEG;IMP;1;PL
guarnecer	guarneciesen	V;SBJV;PST;3;PL
torturar	tortúrame	V;IMP;INFM;2;SG;DAT;PRO;1;SG
culminar	culmináremos	V;SBJV;FUT;1;PL
amenizar	amenizara	V;SBJV;PST;LGSPEC1;1;SG
relatar	relatándote	V;V.CVB;PRS;DAT;PRO;2;SG
trasportar	trasportadas	V;V.PTCP;PST;FEM;PL
prolongar	prolongaran	V;SBJV;PST;LGSPEC1;3;PL
nacho	nacho	N;MASC;SG
recubrir	recubriré	V;IND;FUT;1;SG
libertar	libertándoos	V;V.CVB;PRS;DAT;PRO;2;PL
implicar	implícame	V;IMP;INFM;2;SG;ACC;PRO;1;SG
escabiar	escabiémoste	V;IMP;1;PL;DAT;PRO;2;SG
galguear	galgueen	V;POS;IMP;3;PL
demudar	demúdelas	V;IMP;FORM;2;SG;ACC;PRO;3;PL
obsequiar	obsequiamos	V;IND;PST;PFV;1;PL
engrasar	engrasaos	V;IMP;INFM;2;PL;DAT;PRO;2;PL
democratizar	democratízales	V;IMP;INFM;2;SG;DAT;PRO;3;PL
arreglar	arreglémoste	V;IMP;1;PL;DAT;PRO;2;SG
incrustar	incrusten	V;POS;IMP;2;PL;FORM
tascar	tascáramos	V;SBJV;PST;LGSPEC1;1;PL
rasar	rasándome	V;V.CVB;PRS;ACC;PRO;1;SG
draftear	drafteaseis	V;SBJV;PST;LGSPEC2;2;PL;INFM
aliviar	alíviale	V;IMP;INFM;2;SG;DAT;PRO;3;SG
autodirigir	autodirigíamos	V;IND;PST;IPFV;1;PL
mendocino	mendocinas	N;FEM;PL
apesarar	apesarare	V;SBJV;FUT;2;SG;FORM
laborar	laborare	V;SBJV;FUT;2;SG;FORM
ilusionar	ilusionad	V;POS;IMP;2;PL;INFM
desmandar	desmandabas	V;IND;PST;IPFV;2;SG;INFM
pluralizar	pluralizaría	V;COND;2;SG;FORM
disputar	disputadnos	V;IMP;INFM;2;PL;DAT;PRO;1;PL
conllevar	conllevemos	V;SBJV;PRS;1;PL
orientar	oriente	V;POS;IMP;3;SG
aquietar	aquiétenme	V;IMP;FORM;2;PL;ACC;PRO;1;SG
mandamiento	mandamientos	N;MASC;PL
conminar	conminaras	V;SBJV;PST;LGSPEC1;2;SG;INFM
afilar	afilarlas	V;ACC;PRO;3;PL
sustituir	sustituimos	V;IND;PRS;1;PL
florecer	florézcanle	V;IMP;FORM;2;PL;DAT;PRO;3;SG
aunar	aúnen	V;SBJV;PRS;3;PL
migrar	migraos	V;IMP;INFM;2;PL;ACC;PRO;2;PL
neocolonizar	neocolonizarían	V;COND;3;PL
confeccionar	confeccionándole	V;V.CVB;PRS;DAT;PRO;3;SG
desforzar	desforzado	V;V.PTCP;PST;MASC;SG
macular	maculadme	V;IMP;INFM;2;PL;ACC;PRO;1;SG
calmar	cálmate	V;IMP;INFM;2;SG;DAT;PRO;2;SG
endiñar	endiñara	V;SBJV;PST;LGSPEC1;2;SG;FORM
repagar	repáganos	V;IMP;INFM;2;SG;ACC;PRO;1;PL
castigar	castigará	V;IND;FUT;2;SG;FORM
embaír	embaí	V;POS;IMP;2;SG;INFM
embolizar	embolizándola	V;V.CVB;PRS;ACC;PRO;3;SG
victimar	victimará	V;IND;FUT;3;SG
perfumar	perfumarme	V;ACC;PRO;1;SG
extraviar	extraviadla	V;IMP;INFM;2;PL;ACC;PRO;3;SG
draftear	drafteadas	V;V.PTCP;PST;FEM;PL
caldear	caldeándolas	V;V.CVB;PRS;ACC;PRO;3;PL
apocar	apocaren	V;SBJV;FUT;3;PL
adquirir	adquiría	V;IND;PST;IPFV;3;SG
exdefensor	exdefensores	N;MASC;PL
descomedir	descomediréis	V;IND;FUT;2;PL;INFM
lucir	luciría	V;COND;2;SG;FORM
repreguntar	no repreguntéis	V;NEG;IMP;2;PL;INFM
matonear	matoneas	V;IND;PRS;2;SG;INFM
desconchar	desconchaseis	V;SBJV;PST;2;PL;INFM
encorajinar	encorajinaremos	V;IND;FUT;1;PL
ludir	ludidme	V;IMP;INFM;2;PL;DAT;PRO;1;SG
macerar	macerándole	V;V.CVB;PRS;DAT;PRO;3;SG
lexicalizar	no lexicalicéis	V;NEG;IMP;2;PL;INFM
descarbonizar	descarbonicémosles	V;IMP;1;PL;DAT;PRO;3;PL
abocar	abocarnos	V;ACC;PRO;1;PL
esforzar	esfuercen	V;POS;IMP;2;PL;FORM
encariñarse	encariñemos	V;POS;IMP;1;PL
enmaderar	enmaderasteis	V;IND;PST;PFV;2;PL;INFM
empelar	empele	V;POS;IMP;2;SG;FORM
legatario	legatario	N;MASC;SG
microlito	microlito	N;MASC;SG
trapezoide	trapezoides	N;MASC;PL
irse	os iréis	V;IND;FUT;2;PL;INFM
tadalafilo	tadalafilos	N;MASC;PL
postensar	postensabais	V;IND;PST;IPFV;2;PL;INFM
descalabrar	descalabrándonos	V;V.CVB;PRS;DAT;PRO;1;PL
venenciar	venencies	V;SBJV;PRS;2;SG;INFM
disociar	disociémosle	V;IMP;1;PL;DAT;PRO;3;SG
afiliar	afílienme	V;IMP;FORM;2;PL;DAT;PRO;1;SG
hendir	hendida	V;V.PTCP;PST;FEM;SG
chaucha	chaucha	N;FEM;SG
segmentario	segmentaria	ADJ;FEM;SG
favelizar	favelizará	V;IND;FUT;3;SG
recomponer	recompóngala	V;IMP;FORM;2;SG;ACC;PRO;3;SG
endurecer	endureciéndonos	V;V.CVB;PRS;ACC;PRO;1;PL
sorprender	sorprendiéndome	V;V.CVB;PRS;ACC;PRO;1;SG
meter	metiese	V;SBJV;PST;LGSPEC2;2;SG;FORM
clasificarse	os clasificaseis	V;SBJV;PST;2;PL;INFM
adjudicar	adjudicadme	V;IMP;INFM;2;PL;ACC;PRO;1;SG
recetar	recetémoos	V;IMP;1;PL;ACC;PRO;2;PL
requisar	requisaré	V;IND;FUT;1;SG
peinar	peinásemos	V;SBJV;PST;LGSPEC2;1;PL
dializar	dializase	V;SBJV;PST;LGSPEC2;2;SG;FORM
cuarteadura	cuarteaduras	N;FEM;PL
olfatear	olfatearía	V;COND;3;SG
cedular	cedules	V;SBJV;PRS;2;SG;INFM
abuñolar	abuñoladnos	V;IMP;INFM;2;PL;DAT;PRO;1;PL
divagar	divaguemos	V;SBJV;PRS;1;PL
despejar	despejamos	V;IND;PRS;1;PL
exacerbar	exacerbabais	V;IND;PST;IPFV;2;PL;INFM
sobreexcitar	sobreexcitémosla	V;IMP;1;PL;ACC;PRO;3;SG
teletransportar	teletransportándoos	V;V.CVB;PRS;ACC;PRO;2;PL
replicar	replicarnos	V;ACC;PRO;1;PL
efectuar	efectuaseis	V;SBJV;PST;2;PL;INFM
lograr	logra	V;IND;PRS;2;SG;FORM
costalero	costalera	N;FEM;SG
cautelar	cauteláis	V;IND;PRS;2;PL;INFM
tesar	tesase	V;SBJV;PST;LGSPEC2;3;SG
crepitar	crepitarán	V;IND;FUT;3;PL
entenebrecer	entenebrecemos	V;IND;PRS;1;PL
cañón	cañones	N;MASC;PL
incógnita	incógnitas	N;FEM;PL
desganar	desganaríamos	V;COND;1;PL
transpirar	transpirara	V;SBJV;PST;LGSPEC1;3;SG
malcriar	malcriarnos	V;ACC;PRO;1;PL
evaluar	evalúenme	V;IMP;FORM;2;PL;DAT;PRO;1;SG
sugerir	sugeridnos	V;IMP;INFM;2;PL;DAT;PRO;1;PL
homenajear	homenajeara	V;SBJV;PST;LGSPEC1;3;SG
fosforilar	fosforilara	V;SBJV;PST;LGSPEC1;3;SG
abastecer	abastecí	V;IND;PST;PFV;1;SG
ofrecer	ofrezcáis	V;SBJV;PRS;2;PL;INFM
empingorotar	empingoroto	V;IND;PRS;1;SG
debelar	debelemos	V;SBJV;PRS;1;PL
augurar	auguró	V;IND;PST;PFV;3;SG
bullir	bullesen	V;SBJV;PST;LGSPEC2;3;PL
peregrinar	peregrine	V;SBJV;PRS;3;SG
funcionar	funcionarla	V;ACC;PRO;3;SG
inteligir	inteligiremos	V;IND;FUT;1;PL
andar	ándennos	V;IMP;FORM;2;PL;ACC;PRO;1;PL
cobijar	cobijémonos	V;IMP;1;PL;ACC;PRO;1;PL
eclíptica	eclíptica	N;FEM;SG
cloroformizar	cloroformizasteis	V;IND;PST;PFV;2;PL;INFM
loguear	logueadnos	V;IMP;INFM;2;PL;DAT;PRO;1;PL
recalar	recalándoos	V;V.CVB;PRS;DAT;PRO;2;PL
atinar	atinase	V;SBJV;PST;3;SG
encasquillar	encasquilladme	V;IMP;INFM;2;PL;DAT;PRO;1;SG
senaduría	senadurías	N;FEM;PL
refinar	refíneme	V;IMP;FORM;2;SG;ACC;PRO;1;SG
bisar	bisas	V;IND;PRS;2;SG;INFM
sobreinfectar	sobreinfecte	V;POS;IMP;2;SG;FORM
desgarrar	desgárrenme	V;IMP;FORM;2;PL;DAT;PRO;1;SG
exponer	exponiéndole	V;V.CVB;PRS;DAT;PRO;3;SG
desapalancar	desapalancadles	V;IMP;INFM;2;PL;DAT;PRO;3;PL
dilucidar	dilucídanos	V;IMP;INFM;2;SG;DAT;PRO;1;PL
herediano	heredianos	N;MASC;PL
almidonar	almidonaría	V;COND;2;SG;FORM
menstruar	menstruaseis	V;SBJV;PST;LGSPEC2;2;PL;INFM
reconsagrar	reconsagrarás	V;IND;FUT;2;SG;INFM
lóculo	lóculos	N;MASC;PL
transmigrar	transmigraría	V;COND;2;SG;FORM
ardid	ardid	N;MASC;SG
dispararse	me disparaba	V;IND;PST;IPFV;1;SG
recalificar	recalificaba	V;IND;PST;IPFV;1;SG
purificar	purificarle	V;DAT;PRO;3;SG
datar	datamos	V;IND;PRS;1;PL
aparejar	aparejaron	V;IND;PST;PFV;3;PL
desconsiderar	desconsiderándole	V;V.CVB;PRS;DAT;PRO;3;SG
humedecer	humedeciéndote	V;V.CVB;PRS;DAT;PRO;2;SG
asperjar	asperjémosles	V;IMP;1;PL;DAT;PRO;3;PL
santificar	santificarlas	V;ACC;PRO;3;PL
entremezclar	entremezclarte	V;DAT;PRO;2;SG
impactar	impactases	V;SBJV;PST;2;SG;INFM
migrar	no migren	V;NEG;IMP;3;PL
pentatleta	pentatletas	N;MASC+FEM;PL
dirigir	dirigidnos	V;IMP;INFM;2;PL;ACC;PRO;1;PL
sintetizar	sintetice	V;SBJV;PRS;2;SG;FORM
abastecer	abastécete	V;IMP;INFM;2;SG;DAT;PRO;2;SG
seducir	seduciros	V;DAT;PRO;2;PL
ataviar	atavíeme	V;IMP;FORM;2;SG;DAT;PRO;1;SG
desprestigiar	desprestígieles	V;IMP;FORM;2;SG;DAT;PRO;3;PL
filetear	filetéalas	V;IMP;INFM;2;SG;ACC;PRO;3;PL
fisurar	fisurándote	V;V.CVB;PRS;DAT;PRO;2;SG
ranurar	ranuráremos	V;SBJV;FUT;1;PL
rotar	rotaos	V;IMP;INFM;2;PL;ACC;PRO;2;PL
renumerar	renumeras	V;IND;PRS;2;SG;INFM
concertar	conciertan	V;IND;PRS;3;PL
mantener	no mantengas	V;NEG;IMP;2;SG;INFM
saturar	satura	V;POS;IMP;2;SG;INFM
regrabar	regrabas	V;IND;PRS;2;SG;INFM
reconectar	reconectarán	V;IND;FUT;3;PL
finiquitar	finiquitarás	V;IND;FUT;2;SG;INFM
alongar	aluengo	V;IND;PRS;1;SG
engrapar	engraparán	V;IND;FUT;3;PL
repudiar	repudiarle	V;DAT;PRO;3;SG
empobrecer	empobreciésemos	V;SBJV;PST;LGSPEC2;1;PL
descentralizar	descentralizaríamos	V;COND;1;PL
recodar	recodarles	V;DAT;PRO;3;PL
prohibir	prohibiese	V;SBJV;PST;3;SG
comisar	comisémoste	V;IMP;1;PL;DAT;PRO;2;SG
ralear	raleándote	V;V.CVB;PRS;ACC;PRO;2;SG
noticiar	noticiémoos	V;IMP;1;PL;ACC;PRO;2;PL
murmurar	murmurarla	V;ACC;PRO;3;SG
marchar	marchare	V;SBJV;FUT;1;SG
desfascistizar	desfascistizó	V;IND;PST;PFV;3;SG
metrificar	metrificarais	V;SBJV;PST;LGSPEC1;2;PL;INFM
circundar	circúndeme	V;IMP;FORM;2;SG;ACC;PRO;1;SG
apureña	apureño	N;MASC;SG
conquistar	conquistándonos	V;V.CVB;PRS;ACC;PRO;1;PL
encajonar	encajona	V;IND;PRS;2;SG;FORM
fisiografía	fisiografías	N;FEM;PL
desestructurar	desestructuraría	V;COND;2;SG;FORM
tricotar	tricotaran	V;SBJV;PST;LGSPEC1;3;PL
agazapar	agazápale	V;IMP;INFM;2;SG;DAT;PRO;3;SG
emplomar	emplomémosle	V;IMP;1;PL;DAT;PRO;3;SG
inhibir	inhibiste	V;IND;PST;PFV;2;SG;INFM
pielecilla	pielecillas	N;FEM;PL
enternecer	enterneciéndome	V;V.CVB;PRS;ACC;PRO;1;SG
reaccionar	reaccionaba	V;IND;PST;IPFV;1;SG
amonarse	no se amonen	V;NEG;IMP;3;PL
draftear	draftease	V;SBJV;PST;LGSPEC2;2;SG;FORM
consumir	consuman	V;POS;IMP;2;PL;FORM
alinear	no alineen	V;NEG;IMP;3;PL
ilustrar	ilustréis	V;SBJV;PRS;2;PL;INFM
arrogarse	te arrogues	V;SBJV;PRS;2;SG;INFM
arreciar	arreciados	V;V.PTCP;PST;MASC;PL
abrir	abridnos	V;IMP;INFM;2;PL;ACC;PRO;1;PL
citadino	citadina	ADJ;FEM;SG
contratacar	no contrataques	V;NEG;IMP;2;SG;INFM
deshumidificar	deshumidificarías	V;COND;2;SG;INFM
cabriolear	cabrioleásemos	V;SBJV;PST;LGSPEC2;1;PL
destripar	destriparán	V;IND;FUT;3;PL
decebir	decibiese	V;SBJV;PST;LGSPEC2;3;SG
aguardar	aguardaos	V;IMP;INFM;2;PL;DAT;PRO;2;PL
revestir	revistieseis	V;SBJV;PST;2;PL;INFM
mendigar	no mendiguen	V;NEG;IMP;3;PL
malentender	malentendamos	V;POS;IMP;1;PL
recaudar	recáudame	V;IMP;INFM;2;SG;DAT;PRO;1;SG
solfear	solfeasen	V;SBJV;PST;3;PL
instantón	instantón	N;MASC;SG
tropezar	tropezamos	V;IND;PST;PFV;1;PL
desalquilar	desalquilaran	V;SBJV;PST;LGSPEC1;3;PL
confuso	confusa	ADJ;FEM;SG
satisfacer	satisfagan	V;SBJV;PRS;3;PL
cronometrar	cronométreme	V;IMP;FORM;2;SG;ACC;PRO;1;SG
rogar	roguémonos	V;IMP;1;PL;ACC;PRO;1;PL
pujar	pujémonos	V;IMP;1;PL;DAT;PRO;1;PL
adorar	adórenme	V;IMP;FORM;2;PL;ACC;PRO;1;SG
transicionar	transicionaros	V;DAT;PRO;2;PL
noticiar	noticiándome	V;V.CVB;PRS;ACC;PRO;1;SG
exhalar	exhalaba	V;IND;PST;IPFV;2;SG;FORM
trasbordar	trasbórdanos	V;IMP;INFM;2;SG;DAT;PRO;1;PL
esquematizar	esquematizaríamos	V;COND;1;PL
disminuir	disminuid	V;POS;IMP;2;PL;INFM
encandilar	encandilabais	V;IND;PST;IPFV;2;PL;INFM
historiar	historiaras	V;SBJV;PST;LGSPEC1;2;SG;INFM
velar	veladle	V;IMP;INFM;2;PL;DAT;PRO;3;SG
flagelar	flagelarte	V;DAT;PRO;2;SG
anublar	anubladnos	V;IMP;INFM;2;PL;DAT;PRO;1;PL
visoriar	visoriándote	V;V.CVB;PRS;ACC;PRO;2;SG
balizar	balizáramos	V;SBJV;PST;LGSPEC1;1;PL
proyectar	proyectándote	V;V.CVB;PRS;DAT;PRO;2;SG
encomiar	encomiaron	V;IND;PST;PFV;3;PL
incrustar	incrustaran	V;SBJV;PST;LGSPEC1;3;PL
tolerar	toleraros	V;ACC;PRO;2;PL
empreñar	empreñáremos	V;SBJV;FUT;1;PL
chotear	no choteéis	V;NEG;IMP;2;PL;INFM
aliar	aliareis	V;SBJV;FUT;2;PL;INFM
novelizar	novelicéis	V;SBJV;PRS;2;PL;INFM
facer	fagámonos	V;IMP;1;PL;DAT;PRO;1;PL
asquear	asqueó	V;IND;PST;PFV;3;SG
hablador	habladora	N;FEM;SG
incentivar	incentivasen	V;SBJV;PST;LGSPEC2;3;PL
tacklear	tacklee	V;SBJV;PRS;1;SG
celebrar	celebre	V;SBJV;PRS;3;SG
destilar	destilases	V;SBJV;PST;LGSPEC2;2;SG;INFM
envenenar	envenenaría	V;COND;1;SG
lusófono	lusófona	ADJ;FEM;SG
certificar	certifiqué	V;IND;PST;PFV;1;SG
bajonear	bajonéeme	V;IMP;FORM;2;SG;ACC;PRO;1;SG
huantino	huantina	ADJ;FEM;SG
emparejar	emparejarte	V;ACC;PRO;2;SG
confirmar	confirmándonos	V;V.CVB;PRS;ACC;PRO;1;PL
codesarrollar	codesarróllenos	V;IMP;FORM;2;SG;DAT;PRO;1;PL
desgarrar	desgarrándoles	V;V.CVB;PRS;DAT;PRO;3;PL
bordear	bordeará	V;IND;FUT;3;SG
llamear	llaméenla	V;IMP;FORM;2;PL;ACC;PRO;3;SG
trompezar	trompecemos	V;POS;IMP;1;PL
curar	curaba	V;IND;PST;IPFV;3;SG
dolarizar	dolarizarán	V;IND;FUT;3;PL
zarabutear	zarabutearas	V;SBJV;PST;LGSPEC1;2;SG;INFM
pigmentar	pigmentara	V;SBJV;PST;LGSPEC1;3;SG
desconectar	desconéctenle	V;IMP;FORM;2;PL;DAT;PRO;3;SG
desmigar	desmigabais	V;IND;PST;IPFV;2;PL;INFM
ironizar	ironicémonos	V;IMP;1;PL;ACC;PRO;1;PL
desenvolver	desenvuélvanles	V;IMP;FORM;2;PL;DAT;PRO;3;PL
comprometer	comprometan	V;POS;IMP;2;PL;FORM
bráhmana	bráhmana	N;MASC;SG
leñar	leñaré	V;IND;FUT;1;SG
espulgar	espulgándolas	V;V.CVB;PRS;ACC;PRO;3;PL
atolondrar	atolondrar	V;NFIN
yuracaré	yuracarés	ADJ;PL
reenfocar	reenfoques	V;SBJV;PRS;2;SG;INFM
fracturar	fractures	V;SBJV;PRS;2;SG;INFM
falsificar	falsificarás	V;IND;FUT;2;SG;INFM
convidar	convidando	V;V.CVB;PRS
cavar	cavémoslas	V;IMP;1;PL;ACC;PRO;3;PL
sobrenadar	sobrenadaron	V;IND;PST;PFV;3;PL
absolver	absolveríais	V;COND;2;PL;INFM
cuchuchear	cuchuchearles	V;DAT;PRO;3;PL
revolear	revoleaseis	V;SBJV;PST;2;PL;INFM
blogger	bloggers	N;MASC;PL
colegir	colíjanla	V;IMP;FORM;2;PL;ACC;PRO;3;SG
propulsar	no propulsen	V;NEG;IMP;2;PL;FORM
noquear	noquearnos	V;ACC;PRO;1;PL
encarrilar	encarrílate	V;IMP;INFM;2;SG;DAT;PRO;2;SG
reautorizar	reautorizándonos	V;V.CVB;PRS;ACC;PRO;1;PL
revolver	revolvámoste	V;IMP;1;PL;DAT;PRO;2;SG
singar	singarais	V;SBJV;PST;LGSPEC1;2;PL;INFM
asuán	asuanes	N;MASC;PL
eclipsar	eclipsarte	V;DAT;PRO;2;SG
derrelinquir	derrelinquiría	V;COND;1;SG
enviudar	enviudaréis	V;IND;FUT;2;PL;INFM
sabayeño	sabayeños	ADJ;MASC;PL
ciberacosador	ciberacosadores	N;MASC;PL
guarnecer	guarnezcámoos	V;IMP;1;PL;ACC;PRO;2;PL
antevenir	antevendrán	V;IND;FUT;3;PL
desainar	desaínenme	V;IMP;FORM;2;PL;DAT;PRO;1;SG
asechar	asécheme	V;IMP;FORM;2;SG;DAT;PRO;1;SG
absorber	absórbela	V;IMP;INFM;2;SG;ACC;PRO;3;SG
incumbir	incumbirá	V;IND;FUT;2;SG;FORM
cobani	cobanis	N;MASC;PL
maltratar	no maltratéis	V;NEG;IMP;2;PL;INFM
ennegrecer	ennegrecería	V;COND;3;SG
pañoleta	pañoletas	N;FEM;PL
desencasillar	no desencasillemos	V;NEG;IMP;1;PL
afiliar	afiliarla	V;ACC;PRO;3;SG
aborrecer	no aborrezcan	V;NEG;IMP;2;PL;FORM
churrascar	churrascándote	V;V.CVB;PRS;DAT;PRO;2;SG
apisonar	apisonémoste	V;IMP;1;PL;ACC;PRO;2;SG
tremolar	tremolarles	V;DAT;PRO;3;PL
cizallar	cizallémoste	V;IMP;1;PL;ACC;PRO;2;SG
suprimir	suprímale	V;IMP;FORM;2;SG;DAT;PRO;3;SG
infatuar	infatuarían	V;COND;3;PL
escéptico	escépticas	ADJ;FEM;PL
apalizar	apalizaren	V;SBJV;FUT;3;PL
alienar	no alienen	V;NEG;IMP;3;PL
retundir	retundieses	V;SBJV;PST;LGSPEC2;2;SG;INFM
ibero	iberas	ADJ;FEM;PL
insertar	insertarás	V;IND;FUT;2;SG;INFM
excusar	excusásemos	V;SBJV;PST;1;PL
frivolizar	frivolizaste	V;IND;PST;PFV;2;SG;INFM
estragar	estragadnos	V;IMP;INFM;2;PL;DAT;PRO;1;PL
nacer	nazcámonos	V;IMP;1;PL;ACC;PRO;1;PL
reenergizar	reenergizarían	V;COND;3;PL
deglutir	deglutido	V;V.PTCP;PST;MASC;SG
aunar	aunés	V;SBJV;PRS;2;SG;INFM
recombinar	recombínate	V;IMP;INFM;2;SG;DAT;PRO;2;SG
apercibir	apercibiesen	V;SBJV;PST;LGSPEC2;3;PL
mercadotécnico	mercadotécnica	ADJ;FEM;SG
suplicación	suplicación	N;FEM;SG
pavimentar	pavimentará	V;IND;FUT;2;SG;FORM
redibujar	redibujare	V;SBJV;FUT;1;SG
atraer	atraiga	V;POS;IMP;2;SG;FORM
antimonárquico	antimonárquicos	ADJ;MASC;PL
saldar	saldarle	V;DAT;PRO;3;SG
pipetear	no pipeteéis	V;NEG;IMP;2;PL;INFM
desencaminar	desencaminase	V;SBJV;PST;LGSPEC2;2;SG;FORM
aglutinar	aglutínele	V;IMP;FORM;2;SG;DAT;PRO;3;SG
entumecer	entumezca	V;SBJV;PRS;3;SG
menoscabar	no menoscabemos	V;NEG;IMP;1;PL
descarbonatar	descarbonataros	V;ACC;PRO;2;PL
desaparear	desaparearía	V;COND;2;SG;FORM
descalificar	descalifiquémonos	V;IMP;1;PL;ACC;PRO;1;PL
aumentarse	se aumente	V;SBJV;PRS;3;SG
endilgar	endilgó	V;IND;PST;PFV;3;SG
interiorizar	interiorizaran	V;SBJV;PST;LGSPEC1;3;PL
largar	larguen	V;SBJV;PRS;3;PL
libar	líbala	V;IMP;INFM;2;SG;ACC;PRO;3;SG
desestabilizar	desestabilizaré	V;IND;FUT;1;SG
desbloquear	desbloqueémoslas	V;IMP;1;PL;ACC;PRO;3;PL
conjugar	conjugad	V;POS;IMP;2;PL;INFM
amariconar	no amaricones	V;NEG;IMP;2;SG;INFM
datear	datearás	V;IND;FUT;2;SG;INFM
entubar	entubarás	V;IND;FUT;2;SG;INFM
sobreactuar	sobreactúa	V;IND;PRS;3;SG
apacentar	apacentase	V;SBJV;PST;LGSPEC2;3;SG
entusiasmar	no entusiasmen	V;NEG;IMP;2;PL;FORM
desproteger	desproteger	V;NFIN
opacar	opacaros	V;ACC;PRO;2;PL
conservar	no conservéis	V;NEG;IMP;2;PL;INFM
interrumpir	interrumpía	V;IND;PST;IPFV;1;SG
crumble	crumble	N;MASC;SG
liderar	lidérale	V;IMP;INFM;2;SG;DAT;PRO;3;SG
cimbrear	cimbreabais	V;IND;PST;IPFV;2;PL;INFM
laudar	laudará	V;IND;FUT;2;SG;FORM
titularizar	titularícenme	V;IMP;FORM;2;PL;DAT;PRO;1;SG
cutícula	cutícula	N;FEM;SG
insultar	insultase	V;SBJV;PST;3;SG
reconstituir	reconstituyese	V;SBJV;PST;LGSPEC2;2;SG;FORM
ondular	ondularais	V;SBJV;PST;LGSPEC1;2;PL;INFM
cornear	cornea	V;IND;PRS;2;SG;FORM
blasonar	blasonó	V;IND;PST;PFV;3;SG
garronear	garronearía	V;COND;2;SG;FORM
cebollino	cebollino	N;MASC;SG
estratificar	estratifícanos	V;IMP;INFM;2;SG;DAT;PRO;1;PL
hebreo	hebreos	N;MASC;PL
sedar	sedándole	V;V.CVB;PRS;DAT;PRO;3;SG
existir	exísteles	V;IMP;INFM;2;SG;DAT;PRO;3;PL
monetizar	no moneticéis	V;NEG;IMP;2;PL;INFM
nominalizar	nominalicen	V;SBJV;PRS;3;PL
arramplar	arramplaba	V;IND;PST;IPFV;3;SG
trincar	trincadla	V;IMP;INFM;2;PL;ACC;PRO;3;SG
opacar	opacasteis	V;IND;PST;PFV;2;PL;INFM
reabastecer	reabastézcanlas	V;IMP;FORM;2;PL;ACC;PRO;3;PL
twitear	twitea	V;IND;PRS;2;SG;FORM
redecorar	redecorase	V;SBJV;PST;3;SG
coludir	coludámoos	V;IMP;1;PL;ACC;PRO;2;PL
coaccionar	no coaccionen	V;NEG;IMP;3;PL
descontento	descontentas	ADJ;FEM;PL
panfletario	panfletarios	N;MASC;PL
finiquitar	finiquitaren	V;SBJV;FUT;3;PL
alburear	albureadles	V;IMP;INFM;2;PL;DAT;PRO;3;PL
desenvolver	desenvolvernos	V;ACC;PRO;1;PL
hombrear	hombreaos	V;IMP;INFM;2;PL;DAT;PRO;2;PL
predeterminar	predeterminémoos	V;IMP;1;PL;ACC;PRO;2;PL
maquear	maqueara	V;SBJV;PST;LGSPEC1;3;SG
trimotor	trimotores	N;MASC;PL
pedalear	pedaleares	V;SBJV;FUT;2;SG;INFM
chaty	chaty	N;MASC;SG
capar	cápenles	V;IMP;FORM;2;PL;DAT;PRO;3;PL
regoldar	regoldaos	V;IMP;INFM;2;PL;ACC;PRO;2;PL
avocar	avocarais	V;SBJV;PST;LGSPEC1;2;PL;INFM
vendar	vendándoos	V;V.CVB;PRS;DAT;PRO;2;PL
conde	condesa	N;FEM;SG
tatuar	tatuaríais	V;COND;2;PL;INFM
acepillar	acepillaos	V;IMP;INFM;2;PL;ACC;PRO;2;PL
competir	competí	V;POS;IMP;2;SG;INFM
dispertar	dispertándote	V;V.CVB;PRS;ACC;PRO;2;SG
desobstruir	desobstruías	V;IND;PST;IPFV;2;SG;INFM
telonear	telonearla	V;ACC;PRO;3;SG
chef	chefs	N;MASC+FEM;PL
rumorar	rumoraremos	V;IND;FUT;1;PL
ignorar	ignorémosle	V;IMP;1;PL;DAT;PRO;3;SG
reasignar	reasignándonos	V;V.CVB;PRS;ACC;PRO;1;PL
agüevar	agüevó	V;IND;PST;PFV;3;SG
franquear	franquearais	V;SBJV;PST;LGSPEC1;2;PL;INFM
serpear	serpeare	V;SBJV;FUT;1;SG
regir	rijan	V;SBJV;PRS;3;PL
añoso	añosos	ADJ;MASC;PL
responder	respondiera	V;SBJV;PST;LGSPEC1;3;SG
refacturar	refacturáramos	V;SBJV;PST;LGSPEC1;1;PL
notificador	notificadoras	N;FEM;PL
autoconsumir	autoconsumirá	V;IND;FUT;2;SG;FORM
lisiar	lisiarte	V;ACC;PRO;2;SG
finalizar	finalizase	V;SBJV;PST;3;SG
trasmitir	trasmitiere	V;SBJV;FUT;3;SG
trasformar	trasforméis	V;SBJV;PRS;2;PL;INFM
reverenciar	reverencia	V;POS;IMP;2;SG;INFM
afincar	afínquenos	V;IMP;FORM;2;SG;DAT;PRO;1;PL
solfear	solfeémoste	V;IMP;1;PL;DAT;PRO;2;SG
tumultuar	tumultuaba	V;IND;PST;IPFV;1;SG
embrear	embréalas	V;IMP;INFM;2;SG;ACC;PRO;3;PL
ambientar	ambientándole	V;V.CVB;PRS;DAT;PRO;3;SG
tute	tute	N;MASC;SG
presenciar	presenciarte	V;DAT;PRO;2;SG
bolcheviquismo	bolcheviquismo	N;MASC;SG
apesadumbrar	apesadumbrarías	V;COND;2;SG;INFM
alfabetizar	alfabetizarais	V;SBJV;PST;LGSPEC1;2;PL;INFM
desear	deseéis	V;SBJV;PRS;2;PL;INFM
depauperar	depauperaba	V;IND;PST;IPFV;1;SG
preceptuar	no preceptúen	V;NEG;IMP;3;PL
mojonar	mojonaréis	V;IND;FUT;2;PL;INFM
florecer	florecerán	V;IND;FUT;3;PL
homenajear	homenajearme	V;ACC;PRO;1;SG
paralizar	paralizaré	V;IND;FUT;1;SG
ahitar	ahitaseis	V;SBJV;PST;LGSPEC2;2;PL;INFM
enhornar	enhornase	V;SBJV;PST;LGSPEC2;3;SG
aberrar	aberraren	V;SBJV;FUT;3;PL
amurallar	amurállame	V;IMP;INFM;2;SG;DAT;PRO;1;SG
despedazar	despedazándole	V;V.CVB;PRS;DAT;PRO;3;SG
preestrenar	preestrena	V;IND;PRS;2;SG;FORM
preciar	préciame	V;IMP;INFM;2;SG;DAT;PRO;1;SG
cumbre	cumbres	ADJ;PL
umbra	umbra	ADJ;FEM;SG
relegitimar	relegitimadle	V;IMP;INFM;2;PL;DAT;PRO;3;SG
sinonimizar	sinonimícenos	V;IMP;FORM;2;SG;DAT;PRO;1;PL
apurrir	apurridnos	V;IMP;INFM;2;PL;ACC;PRO;1;PL
afiligranar	afiligranases	V;SBJV;PST;LGSPEC2;2;SG;INFM
fletar	flétenos	V;IMP;FORM;2;SG;ACC;PRO;1;PL
acabar	acabará	V;IND;FUT;3;SG
atener	atuvisteis	V;IND;PST;PFV;2;PL;INFM
consternar	consternarte	V;ACC;PRO;2;SG
interaccionar	interaccionasen	V;SBJV;PST;3;PL
orar	orase	V;SBJV;PST;LGSPEC2;3;SG
resolución	resoluciones	N;FEM;PL
desconocer	desconozcámosla	V;IMP;1;PL;ACC;PRO;3;SG
atomizar	atomizadme	V;IMP;INFM;2;PL;DAT;PRO;1;SG
brincar	brincándolas	V;V.CVB;PRS;ACC;PRO;3;PL
garbar	garbáramos	V;SBJV;PST;LGSPEC1;1;PL
hidraulicidad	hidraulicidades	N;FEM;PL
fragilizar	fragilícenme	V;IMP;FORM;2;PL;DAT;PRO;1;SG
untuosidad	untuosidades	N;FEM;PL
rebuznar	rebuznaren	V;SBJV;FUT;3;PL
fruir	fruiste	V;IND;PST;PFV;2;SG;INFM
correlacionar	correlacionares	V;SBJV;FUT;2;SG;INFM
consultar	consultarte	V;DAT;PRO;2;SG
posponer	pospuse	V;IND;PST;PFV;1;SG
escamotear	escamotéelas	V;IMP;FORM;2;SG;ACC;PRO;3;PL
molinar	molinare	V;SBJV;FUT;2;SG;FORM
perjurar	perjúrennos	V;IMP;FORM;2;PL;DAT;PRO;1;PL
retozar	retoce	V;SBJV;PRS;1;SG
tintar	tintándoles	V;V.CVB;PRS;DAT;PRO;3;PL
abaratar	abaratásemos	V;SBJV;PST;1;PL
dar	diésemos	V;SBJV;PST;LGSPEC2;1;PL
cotizar	cotizarme	V;ACC;PRO;1;SG
sobrentender	sobrentendámoste	V;IMP;1;PL;ACC;PRO;2;SG
almorzar	almorcemos	V;SBJV;PRS;1;PL
interrogar	interróguenlas	V;IMP;FORM;2;PL;ACC;PRO;3;PL
rentero	rentera	N;FEM;SG
resaber	resepan	V;POS;IMP;2;PL;FORM
hidrogenar	hidrogenarnos	V;DAT;PRO;1;PL
aturdir	aturde	V;POS;IMP;2;SG;INFM
acceder	accediéndoos	V;V.CVB;PRS;DAT;PRO;2;PL
garchar	garchémoos	V;IMP;1;PL;DAT;PRO;2;PL
carnavalizar	carnavalizándole	V;V.CVB;PRS;DAT;PRO;3;SG
colorar	colorase	V;SBJV;PST;LGSPEC2;2;SG;FORM
escrutar	escrutara	V;SBJV;PST;LGSPEC1;3;SG
desimputar	desimputadles	V;IMP;INFM;2;PL;DAT;PRO;3;PL
subalimentar	subalimentemos	V;POS;IMP;1;PL
entrelazar	entrelazara	V;SBJV;PST;LGSPEC1;3;SG
cuajar	cuajo	V;IND;PRS;1;SG
algodonar	algodonará	V;IND;FUT;2;SG;FORM
presidir	presídales	V;IMP;FORM;2;SG;DAT;PRO;3;PL
atropar	atrópelas	V;IMP;FORM;2;SG;ACC;PRO;3;PL
eurófoba	eurófoba	ADJ;FEM;SG
sevillanita	sevillanitas	N;FEM;PL
desparasitante	desparasitante	N;MASC;SG
traspillar	traspilladla	V;IMP;INFM;2;PL;ACC;PRO;3;SG
tache	tache	N;MASC;SG
atardecer	atardezca	V;POS;IMP;3;SG
iqueño	iqueños	N;MASC;PL
nadar	nadaré	V;IND;FUT;1;SG
desperezarse	se desperezase	V;SBJV;PST;3;SG
murmurar	no murmuren	V;NEG;IMP;3;PL
cocer	cuécete	V;IMP;INFM;2;SG;ACC;PRO;2;SG
minoico	minoica	ADJ;FEM;SG
calladito	calladitos	ADJ;MASC;PL
tonelaje	tonelajes	N;MASC;PL
quedar	quédelas	V;IMP;FORM;2;SG;ACC;PRO;3;PL
enrutar	enrutarte	V;DAT;PRO;2;SG
enmarañar	enmarañases	V;SBJV;PST;LGSPEC2;2;SG;INFM
supervigilar	no supervigile	V;NEG;IMP;2;SG;FORM
detectar	detectaste	V;IND;PST;PFV;2;SG;INFM
húmico	húmica	ADJ;FEM;SG
eubeo	eubeas	N;FEM;PL
retiniano	retinianas	ADJ;FEM;PL
percudir	percudí	V;IND;PST;PFV;1;SG
reclinar	reclinases	V;SBJV;PST;2;SG;INFM
repletar	replétales	V;IMP;INFM;2;SG;DAT;PRO;3;PL
pixelar	pixeladla	V;IMP;INFM;2;PL;ACC;PRO;3;SG
amarse	os amarais	V;SBJV;PST;LGSPEC1;2;PL;INFM
seleccionar	no seleccionéis	V;NEG;IMP;2;PL;INFM
demarcar	demarcasteis	V;IND;PST;PFV;2;PL;INFM
reclinar	reclinaremos	V;IND;FUT;1;PL
concentrar	concéntrelas	V;IMP;FORM;2;SG;ACC;PRO;3;PL
tensar	ténsame	V;IMP;INFM;2;SG;DAT;PRO;1;SG
atracar	atrácala	V;IMP;INFM;2;SG;ACC;PRO;3;SG
homosexualizar	homosexualízale	V;IMP;INFM;2;SG;DAT;PRO;3;SG
redecorar	redecoradla	V;IMP;INFM;2;PL;ACC;PRO;3;SG
desgajar	desgaje	V;POS;IMP;3;SG
fulminar	fulminen	V;POS;IMP;2;PL;FORM
resellar	resella	V;IND;PRS;2;SG;FORM
guadañar	guadañaríamos	V;COND;1;PL
recriminar	recriminases	V;SBJV;PST;2;SG;INFM
apureña	apureña	ADJ;FEM;SG
astriñir	astriñera	V;SBJV;PST;LGSPEC1;2;SG;FORM
bofetear	bofeteémoslas	V;IMP;1;PL;ACC;PRO;3;PL
desmedrar	desmedrare	V;SBJV;FUT;1;SG
recomisionar	recomisionaos	V;IMP;INFM;2;PL;ACC;PRO;2;PL
fotografiar	fotografiaren	V;SBJV;FUT;3;PL
indagar	indaguemos	V;POS;IMP;1;PL
correy	correyes	N;MASC;PL
pulir	pulirla	V;ACC;PRO;3;SG
demonizar	demonizarles	V;DAT;PRO;3;PL
xatero	xateras	N;FEM;PL
penar	penaste	V;IND;PST;PFV;2;SG;INFM
ribetear	ribeteadla	V;IMP;INFM;2;PL;ACC;PRO;3;SG
pichoneta	pichoneta	N;MASC+FEM;SG
desenojar	desenójale	V;IMP;INFM;2;SG;DAT;PRO;3;SG
desoccidentalizar	no desoccidentalicen	V;NEG;IMP;2;PL;FORM
repeler	repeliéndonos	V;V.CVB;PRS;DAT;PRO;1;PL
instituir	instituyámoslas	V;IMP;1;PL;ACC;PRO;3;PL
retractar	retráctennos	V;IMP;FORM;2;PL;ACC;PRO;1;PL
tantear	tanteéis	V;SBJV;PRS;2;PL;INFM
amartillar	amartillaras	V;SBJV;PST;LGSPEC1;2;SG;INFM
sandunguear	sandunguearen	V;SBJV;FUT;3;PL
enrubiar	enrúbiame	V;IMP;INFM;2;SG;DAT;PRO;1;SG
desperdiciar	desperdiciara	V;SBJV;PST;LGSPEC1;2;SG;FORM
afinar	afinamos	V;IND;PRS;1;PL
cimentar	cimentase	V;SBJV;PST;3;SG
artimaña	artimañas	N;FEM;PL
eneadecágono	eneadecágonos	N;MASC;PL
punzar	punzaba	V;IND;PST;IPFV;2;SG;FORM
rediseñar	rediseñáis	V;IND;PRS;2;PL;INFM
recompilar	recompilaría	V;COND;1;SG
reciclar	recíclenles	V;IMP;FORM;2;PL;DAT;PRO;3;PL
aprestar	aprestemos	V;POS;IMP;1;PL
frecuentar	frecuénteme	V;IMP;FORM;2;SG;DAT;PRO;1;SG
muñir	muñirá	V;IND;FUT;2;SG;FORM
achicar	achicados	V;V.PTCP;PST;MASC;PL
recomenzar	recomenzándolas	V;V.CVB;PRS;ACC;PRO;3;PL
torpedear	torpedeó	V;IND;PST;PFV;3;SG
constar	constarnos	V;DAT;PRO;1;PL
desvestir	desvístelas	V;IMP;INFM;2;SG;ACC;PRO;3;PL
escanciar	no escancien	V;NEG;IMP;2;PL;FORM
retwitear	retwiteadles	V;IMP;INFM;2;PL;DAT;PRO;3;PL
hidratar	hidratásemos	V;SBJV;PST;LGSPEC2;1;PL
tributar	tribute	V;POS;IMP;3;SG
refinanciar	refinanciándonos	V;V.CVB;PRS;ACC;PRO;1;PL
atontar	atonta	V;POS;IMP;2;SG;INFM
fautora	fautora	N;FEM;SG
columpiar	columpiáis	V;IND;PRS;2;PL;INFM
requerir	requiérale	V;IMP;FORM;2;SG;DAT;PRO;3;SG
adietar	adieté	V;IND;PST;PFV;1;SG
hormigonar	hormigonarles	V;DAT;PRO;3;PL
refutar	refutémoste	V;IMP;1;PL;ACC;PRO;2;SG
guarachear	no guaracheen	V;NEG;IMP;2;PL;FORM
abrogar	abrogadlas	V;IMP;INFM;2;PL;ACC;PRO;3;PL
zueco	zueca	ADJ;FEM;SG
supercentenario	supercentenario	N;MASC;SG
tonificar	tonificamos	V;IND;PST;PFV;1;PL
minar	minó	V;IND;PST;PFV;2;SG;FORM
rasguñar	rasguñarla	V;ACC;PRO;3;SG
enterar	enterarías	V;COND;2;SG;INFM
notar	notándome	V;V.CVB;PRS;ACC;PRO;1;SG
chocar	no choques	V;NEG;IMP;2;SG;INFM
testimoniar	testimoniaran	V;SBJV;PST;LGSPEC1;3;PL
superponer	superponles	V;IMP;INFM;2;SG;DAT;PRO;3;PL
cladodio	cladodios	N;MASC;PL
alienar	alienasen	V;SBJV;PST;3;PL
fumar	fumasen	V;SBJV;PST;LGSPEC2;3;PL
encaminar	encaminarán	V;IND;FUT;3;PL
modelar	modelarás	V;IND;FUT;2;SG;INFM
desproveer	desprovéeles	V;IMP;INFM;2;SG;DAT;PRO;3;PL
escusar	escusamos	V;IND;PRS;1;PL
titularizar	titularicémoste	V;IMP;1;PL;ACC;PRO;2;SG
canear	canee	V;POS;IMP;3;SG
intercomprensión	intercomprensiones	N;FEM;PL
amilanar	amilanarías	V;COND;2;SG;INFM
robacoches	robacoches	N;MASC;SG
doblar	doblaros	V;DAT;PRO;2;PL
techar	teche	V;SBJV;PRS;2;SG;FORM
altear	alteados	V;V.PTCP;PST;MASC;PL
desembalsar	desembalsará	V;IND;FUT;2;SG;FORM
excretar	excretémosle	V;IMP;1;PL;DAT;PRO;3;SG
alijar	alijáramos	V;SBJV;PST;LGSPEC1;1;PL
sofocar	sofocan	V;IND;PRS;3;PL
aprontar	aprontad	V;POS;IMP;2;PL;INFM
rempujar	rempujaba	V;IND;PST;IPFV;2;SG;FORM
diversificar	diversificares	V;SBJV;FUT;2;SG;INFM
cosechar	coséchennos	V;IMP;FORM;2;PL;DAT;PRO;1;PL
rugir	rugís	V;IND;PRS;2;PL;INFM
tiranizar	tiranizaban	V;IND;PST;IPFV;3;PL
iluminar	iluminase	V;SBJV;PST;3;SG
remojar	remojase	V;SBJV;PST;3;SG
formatear	formateada	V;V.PTCP;PST;FEM;SG
arrimar	arrime	V;POS;IMP;2;SG;FORM
morir	murió	V;IND;PST;PFV;3;SG
malcriar	malcriases	V;SBJV;PST;LGSPEC2;2;SG;INFM
decaer	decaeríamos	V;COND;1;PL
desplomarse	te desplomases	V;SBJV;PST;2;SG;INFM
morigerar	morigerarías	V;COND;2;SG;INFM
repintar	repintarían	V;COND;3;PL
emborracharse	se emborrachaba	V;IND;PST;IPFV;3;SG
embutir	embutieran	V;SBJV;PST;LGSPEC1;3;PL
antedatar	antedates	V;SBJV;PRS;2;SG;INFM
reencarnar	reencarnases	V;SBJV;PST;LGSPEC2;2;SG;INFM
ambientar	ambientaréis	V;IND;FUT;2;PL;INFM
eslavo	eslava	ADJ;FEM;SG
desatinar	no desatinéis	V;NEG;IMP;2;PL;INFM
espaldar	espaldares	ADJ;PL
esputar	esputaremos	V;IND;FUT;1;PL
caucionar	cauciónenos	V;IMP;FORM;2;SG;ACC;PRO;1;PL
bruto	bruta	N;FEM;SG
inmovilizar	inmovilízame	V;IMP;INFM;2;SG;ACC;PRO;1;SG
cimbrar	cimbrase	V;SBJV;PST;1;SG
solemnizar	solemnizáis	V;IND;PRS;2;PL;INFM
estanear	estaneamos	V;IND;PST;PFV;1;PL
balcanizar	balcanícelas	V;IMP;FORM;2;SG;ACC;PRO;3;PL
andar	andaría	V;COND;2;SG;FORM
engatillar	engatillarnos	V;DAT;PRO;1;PL
novelizar	novelizan	V;IND;PRS;3;PL
rasmillar	rasmillarme	V;ACC;PRO;1;SG
equilibrar	equilibrados	V;V.PTCP;PST;MASC;PL
suturar	sutúreles	V;IMP;FORM;2;SG;DAT;PRO;3;PL
estallar	estallase	V;SBJV;PST;LGSPEC2;1;SG
enmarcar	enmárcate	V;IMP;INFM;2;SG;ACC;PRO;2;SG
esquiar	esquían	V;IND;PRS;3;PL
desendeudar	desendeudad	V;POS;IMP;2;PL;INFM
erigir	erigirlas	V;ACC;PRO;3;PL
aprovisionar	aprovisionarla	V;ACC;PRO;3;SG
estresar	estrésenlas	V;IMP;FORM;2;PL;ACC;PRO;3;PL
compadrear	compadrearen	V;SBJV;FUT;3;PL
acendrar	acendre	V;SBJV;PRS;3;SG
tejedor	tejedora	N;FEM;SG
irracionalidad	irracionalidades	N;FEM;PL
entronizar	entronícenlas	V;IMP;FORM;2;PL;ACC;PRO;3;PL
interaccionar	interaccionándonos	V;V.CVB;PRS;DAT;PRO;1;PL
obscurecer	obscurecido	V;V.PTCP;PST;MASC;SG
atenerse	se atengan	V;SBJV;PRS;3;PL
atildar	atildaste	V;IND;PST;PFV;2;SG;INFM
candomblé	candomblés	N;MASC;PL
gamberrear	gamberreara	V;SBJV;PST;LGSPEC1;2;SG;FORM
expedir	expedirnos	V;ACC;PRO;1;PL
atildar	atildaras	V;SBJV;PST;LGSPEC1;2;SG;INFM
chafar	chafará	V;IND;FUT;3;SG
reemprender	reemprenderle	V;DAT;PRO;3;SG
lingual	linguales	ADJ;PL
constreñir	constreñiros	V;DAT;PRO;2;PL
sobrellevar	sobrellevadla	V;IMP;INFM;2;PL;ACC;PRO;3;SG
planchar	plancharnos	V;DAT;PRO;1;PL
bocinar	bocinará	V;IND;FUT;2;SG;FORM
modorrar	modorraréis	V;IND;FUT;2;PL;INFM
solidarizar	solidarízate	V;IMP;INFM;2;SG;DAT;PRO;2;SG
entrepán	entrepanes	N;MASC;PL
sociabilizar	sociabilizaba	V;IND;PST;IPFV;1;SG
cumplido	cumplidas	ADJ;FEM;PL
aculebrar	aculebrad	V;POS;IMP;2;PL;INFM
contender	contenderemos	V;IND;FUT;1;PL
disparatar	disparato	V;IND;PRS;1;SG
circunferir	circunferías	V;IND;PST;IPFV;2;SG;INFM
punchar	punchara	V;SBJV;PST;LGSPEC1;1;SG
arrobar	arrobarás	V;IND;FUT;2;SG;INFM
compensar	compense	V;POS;IMP;3;SG
menuzar	menuzará	V;IND;FUT;3;SG
encomenzar	encomiéncenme	V;IMP;FORM;2;PL;ACC;PRO;1;SG
entubar	entúbela	V;IMP;FORM;2;SG;ACC;PRO;3;SG
ahorquillar	ahorquillo	V;IND;PRS;1;SG
converger	converjámoos	V;IMP;1;PL;ACC;PRO;2;PL
anonadar	anonadaréis	V;IND;FUT;2;PL;INFM
cepillarse	te cepillases	V;SBJV;PST;2;SG;INFM
coproducir	coprodúzcanla	V;IMP;FORM;2;PL;ACC;PRO;3;SG
callarse	se callaren	V;SBJV;FUT;3;PL
humildad	humildad	N;FEM;SG
semejar	semejas	V;IND;PRS;2;SG;INFM
deslenguar	deslengüéis	V;SBJV;PRS;2;PL;INFM
reinscribir	reinscribiese	V;SBJV;PST;LGSPEC2;1;SG
amurallar	amurallémosle	V;IMP;1;PL;DAT;PRO;3;SG
vulneración	vulneración	N;FEM;SG
hipotecar	hipotecabas	V;IND;PST;IPFV;2;SG;INFM
virar	viradnos	V;IMP;INFM;2;PL;ACC;PRO;1;PL
privilegiar	privilegie	V;SBJV;PRS;2;SG;FORM
remachar	remáchala	V;IMP;INFM;2;SG;ACC;PRO;3;SG
acicatear	acicatéalas	V;IMP;INFM;2;SG;ACC;PRO;3;PL
maliciar	maliciarla	V;ACC;PRO;3;SG
verdear	verdease	V;SBJV;PST;LGSPEC2;3;SG
titrar	titrase	V;SBJV;PST;LGSPEC2;3;SG
vello	vello	N;MASC;SG
ejecutoriar	ejecutoriaren	V;SBJV;FUT;3;PL
readiestrar	readiestrarla	V;ACC;PRO;3;SG
chusmear	chusmeaban	V;IND;PST;IPFV;3;PL
deshilvanar	deshilvánenle	V;IMP;FORM;2;PL;DAT;PRO;3;SG
perfumar	perfumémosla	V;IMP;1;PL;ACC;PRO;3;SG
encabritar	encabritare	V;SBJV;FUT;2;SG;FORM
patisserie	patisserie	N;FEM;SG
mojonar	mojonó	V;IND;PST;PFV;3;SG
abofetear	abofeteándonos	V;V.CVB;PRS;DAT;PRO;1;PL
explotar	explótale	V;IMP;INFM;2;SG;DAT;PRO;3;SG
afligir	afligiera	V;SBJV;PST;LGSPEC1;3;SG
desmeritar	desmeritaras	V;SBJV;PST;LGSPEC1;2;SG;INFM
memorializar	memorializarnos	V;DAT;PRO;1;PL
ramificar	no ramifique	V;NEG;IMP;2;SG;FORM
pichicatear	pichicatearnos	V;DAT;PRO;1;PL
tricotar	tricotasen	V;SBJV;PST;LGSPEC2;3;PL
electoralizar	electoralizaría	V;COND;3;SG
bubi	bubis	N;MASC+FEM;PL
peñizcar	peñizcan	V;IND;PRS;3;PL
santurrón	santurrón	N;MASC;SG
apandar	apándala	V;IMP;INFM;2;SG;ACC;PRO;3;SG
reabastecer	reabastecerte	V;ACC;PRO;2;SG
repelar	repelarnos	V;ACC;PRO;1;PL
vandalizar	vandalizase	V;SBJV;PST;LGSPEC2;1;SG
quiromasajista	quiromasajista	N;MASC+FEM;SG
culpabilizar	culpabilizarla	V;ACC;PRO;3;SG
gobernar	gobernabas	V;IND;PST;IPFV;2;SG;INFM
desvestir	desvístenos	V;IMP;INFM;2;SG;ACC;PRO;1;PL
emanar	emánanos	V;IMP;INFM;2;SG;DAT;PRO;1;PL
desmotivar	desmotivaos	V;IMP;INFM;2;PL;DAT;PRO;2;PL
mofar	mofáramos	V;SBJV;PST;LGSPEC1;1;PL
deslizar	deslizaran	V;SBJV;PST;LGSPEC1;3;PL
alcóxido	alcóxidos	N;MASC;PL
cimblar	cimbla	V;IND;PRS;2;SG;FORM
sobreseer	sobreseísteis	V;IND;PST;PFV;2;PL;INFM
reptar	reptamos	V;IND;PRS;1;PL
empedrar	empedrarla	V;ACC;PRO;3;SG
encarecedor	encarecedor	N;MASC;SG
entumido	entumida	ADJ;FEM;SG
apilar	apilémoslas	V;IMP;1;PL;ACC;PRO;3;PL
guinchar	guincho	V;IND;PRS;1;SG
aplicar	aplícate	V;IMP;INFM;2;SG;DAT;PRO;2;SG
retorcer	retorcerles	V;DAT;PRO;3;PL
adurir	aduriesen	V;SBJV;PST;3;PL
esmorecer	esmorecen	V;IND;PRS;3;PL
sinterizar	sinterizáramos	V;SBJV;PST;LGSPEC1;1;PL
desobstruir	desobstruirías	V;COND;2;SG;INFM
balbucear	balbuceen	V;POS;IMP;2;PL;FORM
ablación	ablaciones	N;FEM;PL
abotonar	abotonadle	V;IMP;INFM;2;PL;DAT;PRO;3;SG
ameritar	ameritare	V;SBJV;FUT;1;SG
recircular	recirculasen	V;SBJV;PST;LGSPEC2;3;PL
tantear	tantee	V;POS;IMP;3;SG
predeterminar	predeterminarte	V;DAT;PRO;2;SG
desmochar	desmochamos	V;IND;PST;PFV;1;PL
unificar	no unifiquemos	V;NEG;IMP;1;PL
clausurar	clausuraría	V;COND;1;SG
desfondar	desfondares	V;SBJV;FUT;2;SG;INFM
repartir	repartiese	V;SBJV;PST;1;SG
rumiar	rumiémoos	V;IMP;1;PL;DAT;PRO;2;PL
desarmar	desarmadas	V;V.PTCP;PST;FEM;PL
timidez	timideces	N;FEM;PL
temblar	tiémblela	V;IMP;FORM;2;SG;ACC;PRO;3;SG
shinto	shinto	N;MASC;SG
voznar	voznó	V;IND;PST;PFV;3;SG
enjaezar	enjaezamos	V;IND;PRS;1;PL
reñir	riñámosles	V;IMP;1;PL;DAT;PRO;3;PL
empanar	empanabais	V;IND;PST;IPFV;2;PL;INFM
incrementar	incrementes	V;SBJV;PRS;2;SG;INFM
sulcar	sulcase	V;SBJV;PST;LGSPEC2;1;SG
conhortar	conhórtele	V;IMP;FORM;2;SG;DAT;PRO;3;SG
pianola	pianola	N;FEM;SG
enclaustrar	enclaustraseis	V;SBJV;PST;LGSPEC2;2;PL;INFM
transigir	transigía	V;IND;PST;IPFV;2;SG;FORM
enmasillar	enmasillaría	V;COND;3;SG
derogar	derogaría	V;COND;2;SG;FORM
remar	remarían	V;COND;3;PL
acojonarse	me acojono	V;IND;PRS;1;SG
retardar	retardaríais	V;COND;2;PL;INFM
sobrerregular	sobrerregularíamos	V;COND;1;PL
descerebramiento	descerebramientos	N;MASC;PL
toser	no tosan	V;NEG;IMP;2;PL;FORM
referir	refiérela	V;IMP;INFM;2;SG;ACC;PRO;3;SG
trasladar	trasládeme	V;IMP;FORM;2;SG;DAT;PRO;1;SG
cohechar	cohechará	V;IND;FUT;3;SG
ahuecar	ahuecaros	V;DAT;PRO;2;PL
ejecutoriar	ejecutoriare	V;SBJV;FUT;2;SG;FORM
heder	hederíamos	V;COND;1;PL
reabastecer	reabastezcamos	V;SBJV;PRS;1;PL
normar	normarte	V;ACC;PRO;2;SG
enredar	enredado	V;V.PTCP;PST;MASC;SG
hegemonizar	hegemonicen	V;SBJV;PRS;3;PL
sobrevendir	sobrevendidas	V;V.PTCP;PST;FEM;PL
parlotear	parloteemos	V;SBJV;PRS;1;PL
sumariar	sumariéis	V;SBJV;PRS;2;PL;INFM
pastorcillo	pastorcillo	N;MASC;SG
copar	cópela	V;IMP;FORM;2;SG;ACC;PRO;3;SG
desalentar	desalentándote	V;V.CVB;PRS;DAT;PRO;2;SG
reinvertir	reinvertisteis	V;IND;PST;PFV;2;PL;INFM
medicar	medícate	V;IMP;INFM;2;SG;DAT;PRO;2;SG
examen	examen	N;MASC;SG
acrecer	acrezcan	V;POS;IMP;3;PL
reencauzar	reencauzas	V;IND;PRS;2;SG;INFM
semiretirado	semiretirada	ADJ;FEM;SG
naufragar	naufragare	V;SBJV;FUT;3;SG
obstaculizar	obstaculizara	V;SBJV;PST;LGSPEC1;1;SG
necesitar	necesitase	V;SBJV;PST;LGSPEC2;3;SG
descubrir	descubrías	V;IND;PST;IPFV;2;SG;INFM
tricoma	tricoma	N;MASC;SG
voluntad	voluntades	N;FEM;PL
apostrofar	apostrofarían	V;COND;3;PL
consejar	conseje	V;POS;IMP;3;SG
desacatar	desacataríais	V;COND;2;PL;INFM
volear	voléales	V;IMP;INFM;2;SG;DAT;PRO;3;PL
granizar	granizándote	V;V.CVB;PRS;ACC;PRO;2;SG
desganar	desgánala	V;IMP;INFM;2;SG;ACC;PRO;3;SG
modificar	modificarla	V;ACC;PRO;3;SG
serruchar	serruchase	V;SBJV;PST;LGSPEC2;1;SG
reportar	reportaba	V;IND;PST;IPFV;2;SG;FORM
jarcha	jarchas	N;FEM;PL
desmoronar	desmoronamos	V;IND;PRS;1;PL
burgalés	burgaleses	ADJ;MASC;PL
pelear	peléele	V;IMP;FORM;2;SG;DAT;PRO;3;SG
apelmazar	apelmazadme	V;IMP;INFM;2;PL;ACC;PRO;1;SG
promocionar	promocionándoos	V;V.CVB;PRS;ACC;PRO;2;PL
serruchar	serruchémosla	V;IMP;1;PL;ACC;PRO;3;SG
regir	rijámoos	V;IMP;1;PL;ACC;PRO;2;PL
devorar	devore	V;POS;IMP;2;SG;FORM
broncear	bronceen	V;SBJV;PRS;3;PL
rastrear	rastrearnos	V;DAT;PRO;1;PL
municionar	municionémoste	V;IMP;1;PL;ACC;PRO;2;SG
amarizar	amarizarás	V;IND;FUT;2;SG;INFM
incapacitar	incapacítate	V;IMP;INFM;2;SG;ACC;PRO;2;SG
hermandar	hermanda	V;IND;PRS;2;SG;FORM
reingresar	reingresará	V;IND;FUT;3;SG
pulsar	púlsenlas	V;IMP;FORM;2;PL;ACC;PRO;3;PL
amansar	amansaríamos	V;COND;1;PL
saetear	saetees	V;SBJV;PRS;2;SG;INFM
tonificar	tonificará	V;IND;FUT;3;SG
controlador	controladora	N;FEM;SG
amanecer	amanézcame	V;IMP;FORM;2;SG;DAT;PRO;1;SG
deslavar	deslavarás	V;IND;FUT;2;SG;INFM
ajardinar	ajardinarle	V;DAT;PRO;3;SG
abañar	abañará	V;IND;FUT;2;SG;FORM
acoquinar	acoquinaba	V;IND;PST;IPFV;3;SG
fallar	falle	V;SBJV;PRS;2;SG;FORM
democratizar	democratizaste	V;IND;PST;PFV;2;SG;INFM
valuar	valúate	V;IMP;INFM;2;SG;DAT;PRO;2;SG
notariar	notariáremos	V;SBJV;FUT;1;PL
reasignar	reasignándote	V;V.CVB;PRS;ACC;PRO;2;SG
validar	validaba	V;IND;PST;IPFV;3;SG
deslindar	deslindare	V;SBJV;FUT;1;SG
revesar	revesaseis	V;SBJV;PST;LGSPEC2;2;PL;INFM
lisonjear	lisonjeaban	V;IND;PST;IPFV;3;PL
espumear	espumeada	V;V.PTCP;PST;FEM;SG
venenoso	venenosas	ADJ;FEM;PL
yuyo	yuyo	N;MASC;SG
despegar	despegara	V;SBJV;PST;LGSPEC1;3;SG
contextualizar	contextualízame	V;IMP;INFM;2;SG;DAT;PRO;1;SG
dudar	dúdanos	V;IMP;INFM;2;SG;DAT;PRO;1;PL
comedir	comedía	V;IND;PST;IPFV;2;SG;FORM
forzar	forcémoste	V;IMP;1;PL;DAT;PRO;2;SG
incardinar	incardinamos	V;IND;PRS;1;PL
teletransportar	no teletransporten	V;NEG;IMP;3;PL
maleducar	maleduquen	V;POS;IMP;2;PL;FORM
piercing	piercings	N;MASC;PL
bizcar	bizquen	V;POS;IMP;2;PL;FORM
patrullar	patrúllate	V;IMP;INFM;2;SG;ACC;PRO;2;SG
desenvainar	desenvainaríais	V;COND;2;PL;INFM
atrincherar	atrincheraste	V;IND;PST;PFV;2;SG;INFM
abatatar	abatatará	V;IND;FUT;2;SG;FORM
ceñir	ceñíais	V;IND;PST;IPFV;2;PL;INFM
halogenar	halogenaros	V;ACC;PRO;2;PL
despolarizar	despolarizarán	V;IND;FUT;3;PL
tolerar	tolerando	V;V.CVB;PRS
recaer	recaíste	V;IND;PST;PFV;2;SG;INFM
relicto	relictos	ADJ;MASC;PL
réprobo	réprobas	ADJ;FEM;PL
alinear	alinead	V;POS;IMP;2;PL;INFM
silbar	silbadle	V;IMP;INFM;2;PL;DAT;PRO;3;SG
marmolear	marmolee	V;SBJV;PRS;3;SG
juane	juane	N;MASC;SG
querellarse	queréllense	V;POS;IMP;3;PL
autografiar	autografiándolas	V;V.CVB;PRS;ACC;PRO;3;PL
substantivar	substantivareis	V;SBJV;FUT;2;PL;INFM
cloquear	cloqueó	V;IND;PST;PFV;3;SG
infestar	infestes	V;SBJV;PRS;2;SG;INFM
ferrolano	ferrolanos	N;MASC;PL
amarrar	amarrándoos	V;V.CVB;PRS;DAT;PRO;2;PL
dragar	dragaría	V;COND;3;SG
microfilmar	microfilmarais	V;SBJV;PST;LGSPEC1;2;PL;INFM
encantar	encantemos	V;POS;IMP;1;PL
arrumar	arrumaron	V;IND;PST;PFV;3;PL
desprotonar	desprotonasen	V;SBJV;PST;LGSPEC2;3;PL
endulzar	endulzará	V;IND;FUT;2;SG;FORM
tanquear	tanquearía	V;COND;3;SG
despeñar	despeñes	V;SBJV;PRS;2;SG;INFM
ustedear	ustedeo	V;IND;PRS;1;SG
reconvertir	reconvirtieren	V;SBJV;FUT;3;PL
descubrir	descubrid	V;POS;IMP;2;PL;INFM
mortificar	mortifíquelas	V;IMP;FORM;2;SG;ACC;PRO;3;PL
encalabozar	encalabozaba	V;IND;PST;IPFV;1;SG
agrumar	agrumarás	V;IND;FUT;2;SG;INFM
combar	combaría	V;COND;3;SG
vencer	vencerás	V;IND;FUT;2;SG;INFM
rimbombar	rimbomben	V;SBJV;PRS;3;PL
tatuar	tatuase	V;SBJV;PST;1;SG
decorar	decorases	V;SBJV;PST;LGSPEC2;2;SG;INFM
rezongar	rezongaréis	V;IND;FUT;2;PL;INFM
chungo	chungas	ADJ;FEM;PL
aquejar	aquejándoles	V;V.CVB;PRS;DAT;PRO;3;PL
machihembrar	machihembrarán	V;IND;FUT;3;PL
refigurar	refiguren	V;POS;IMP;2;PL;FORM
mentar	mentar	V;NFIN
disfamar	disfamásemos	V;SBJV;PST;LGSPEC2;1;PL
permitir	permitirás	V;IND;FUT;2;SG;INFM
subdividir	subdividíos	V;IMP;INFM;2;PL;DAT;PRO;2;PL
megafusión	megafusiones	N;FEM;PL
maniobrar	maniobraron	V;IND;PST;PFV;3;PL
enfrascar	enfráscate	V;IMP;INFM;2;SG;DAT;PRO;2;SG
procurar	procurará	V;IND;FUT;3;SG
informatizar	informaticen	V;POS;IMP;2;PL;FORM
adivinar	adivínenla	V;IMP;FORM;2;PL;ACC;PRO;3;SG
agitar	agitadnos	V;IMP;INFM;2;PL;ACC;PRO;1;PL
mitraísmo	mitraísmo	N;MASC;SG
sobrecoger	sobrecogeré	V;IND;FUT;1;SG
subagudo	subagudas	ADJ;FEM;PL
encubridor	encubridor	N;MASC;SG
mecanizar	mecanizabais	V;IND;PST;IPFV;2;PL;INFM
avenir	aviniste	V;IND;PST;PFV;2;SG;INFM
tensar	ténsenme	V;IMP;FORM;2;PL;DAT;PRO;1;SG
malvivir	malvivirá	V;IND;FUT;3;SG
buzonear	buzonearla	V;ACC;PRO;3;SG
atarear	atarea	V;IND;PRS;3;SG
desatraillar	desatraillásemos	V;SBJV;PST;LGSPEC2;1;PL
replantear	replanteare	V;SBJV;FUT;1;SG
azulear	azulearas	V;SBJV;PST;LGSPEC1;2;SG;INFM
sentirse	te sintieras	V;SBJV;PST;LGSPEC1;2;SG;INFM
sobresaturar	sobresaturemos	V;SBJV;PRS;1;PL
liderizar	lidericen	V;SBJV;PRS;3;PL
subrayar	subráyennos	V;IMP;FORM;2;PL;ACC;PRO;1;PL
babear	babéame	V;IMP;INFM;2;SG;DAT;PRO;1;SG
desempatar	desempató	V;IND;PST;PFV;2;SG;FORM
criollización	criollización	N;FEM;SG
inducir	inducidme	V;IMP;INFM;2;PL;DAT;PRO;1;SG
sobrar	sobrarlas	V;ACC;PRO;3;PL
corroborar	corrobóralas	V;IMP;INFM;2;SG;ACC;PRO;3;PL
desinformar	desinformarte	V;DAT;PRO;2;SG
carrilear	carrilearte	V;DAT;PRO;2;SG
agremiar	agremiarme	V;ACC;PRO;1;SG
reprogramar	reprogramemos	V;POS;IMP;1;PL
morfar	morfábamos	V;IND;PST;IPFV;1;PL
recordatorio	recordatorios	N;MASC;PL
hipotecar	hipotecas	V;IND;PRS;2;SG;INFM
experienciar	experienciándoles	V;V.CVB;PRS;DAT;PRO;3;PL
temblar	temblarlas	V;ACC;PRO;3;PL
reescalar	reescaló	V;IND;PST;PFV;2;SG;FORM
estropear	estropeemos	V;SBJV;PRS;1;PL
castañear	castañea	V;IND;PRS;3;SG
saltar	saltarás	V;IND;FUT;2;SG;INFM
ciudadanizar	ciudadaniza	V;POS;IMP;2;SG;INFM
despachar	despachas	V;IND;PRS;2;SG;INFM
escabechar	escabéchanos	V;IMP;INFM;2;SG;ACC;PRO;1;PL
interdecir	interdiré	V;IND;FUT;1;SG
resguardar	resguardándoles	V;V.CVB;PRS;DAT;PRO;3;PL
ofertar	ofertara	V;SBJV;PST;LGSPEC1;2;SG;FORM
concentrar	concentrándote	V;V.CVB;PRS;ACC;PRO;2;SG
alertar	alertases	V;SBJV;PST;2;SG;INFM
enzacatar	enzacáteles	V;IMP;FORM;2;SG;DAT;PRO;3;PL
constreñir	constreñirla	V;ACC;PRO;3;SG
aburrirse	me aburro	V;IND;PRS;1;SG
erguir	erguid	V;POS;IMP;2;PL;INFM
alborear	alborea	V;IND;PRS;3;SG
enllavar	enllavarían	V;COND;3;PL
imponer	imponerlas	V;ACC;PRO;3;PL
descascarar	descascárele	V;IMP;FORM;2;SG;DAT;PRO;3;SG
noviar	noviados	V;V.PTCP;PST;MASC;PL
reblandecer	reblandéceles	V;IMP;INFM;2;SG;DAT;PRO;3;PL
deslindar	deslindase	V;SBJV;PST;LGSPEC2;1;SG
encauzar	encauzándoos	V;V.CVB;PRS;ACC;PRO;2;PL
conmutar	conmutase	V;SBJV;PST;1;SG
teorización	teorizaciones	N;FEM;PL
cizañear	cizañeare	V;SBJV;FUT;3;SG
secundar	secundaseis	V;SBJV;PST;LGSPEC2;2;PL;INFM
churrascar	churrásqueles	V;IMP;FORM;2;SG;DAT;PRO;3;PL
apedazar	apedazaréis	V;IND;FUT;2;PL;INFM
traumatizar	traumatizarte	V;ACC;PRO;2;SG
decelerar	decelerarías	V;COND;2;SG;INFM
clasificarse	os clasificaréis	V;IND;FUT;2;PL;INFM
abastecedor	abastecedores	N;MASC;PL
desenmascarar	desenmascarándoos	V;V.CVB;PRS;DAT;PRO;2;PL
sérico	sérica	ADJ;FEM;SG
reconectar	reconectarles	V;DAT;PRO;3;PL
avanzar	avanza	V;IND;PRS;3;SG
relegitimar	no relegitimemos	V;NEG;IMP;1;PL
defoliar	defoliarme	V;DAT;PRO;1;SG
sambenitar	sambenítenla	V;IMP;FORM;2;PL;ACC;PRO;3;SG
transversalizar	transversalizaría	V;COND;2;SG;FORM
castigar	castigaseis	V;SBJV;PST;LGSPEC2;2;PL;INFM
sonrosar	no sonroses	V;NEG;IMP;2;SG;INFM
playo	playo	N;MASC;SG
ratonar	ratonases	V;SBJV;PST;LGSPEC2;2;SG;INFM
engastar	engastará	V;IND;FUT;2;SG;FORM
descontracturar	descontracturaba	V;IND;PST;IPFV;2;SG;FORM
modular	modularás	V;IND;FUT;2;SG;INFM
clorar	clorare	V;SBJV;FUT;2;SG;FORM
descollar	descollase	V;SBJV;PST;LGSPEC2;2;SG;FORM
reinventar	reinventaré	V;IND;FUT;1;SG
chivatear	chivatearéis	V;IND;FUT;2;PL;INFM
bofetear	bofeteándoos	V;V.CVB;PRS;DAT;PRO;2;PL
reaprovisionar	reaprovisione	V;POS;IMP;2;SG;FORM
confederar	confederarais	V;SBJV;PST;LGSPEC1;2;PL;INFM
someter	sometes	V;IND;PRS;2;SG;INFM
prosperar	prosperé	V;IND;PST;PFV;1;SG
propasar	propasemos	V;SBJV;PRS;1;PL
facer	fágala	V;IMP;FORM;2;SG;ACC;PRO;3;SG
pimplar	pimpladme	V;IMP;INFM;2;PL;DAT;PRO;1;SG
consumir	consumámosles	V;IMP;1;PL;DAT;PRO;3;PL
purificar	purificaros	V;DAT;PRO;2;PL
doler	dolía	V;IND;PST;IPFV;1;SG
drapear	drapearte	V;DAT;PRO;2;SG
enderezar	enderezan	V;IND;PRS;3;PL
sobredimensionar	sobredimensionándonos	V;V.CVB;PRS;DAT;PRO;1;PL
silesia	silesia	ADJ;FEM;SG
preformar	preformase	V;SBJV;PST;LGSPEC2;1;SG
demonizar	demonízalas	V;IMP;INFM;2;SG;ACC;PRO;3;PL
baratar	baratásemos	V;SBJV;PST;LGSPEC2;1;PL
reflexionar	reflexiónale	V;IMP;INFM;2;SG;DAT;PRO;3;SG
adoctrinar	adoctrinándonos	V;V.CVB;PRS;ACC;PRO;1;PL
desaduanizar	desaduanices	V;SBJV;PRS;2;SG;INFM
envilecer	envilecerán	V;IND;FUT;3;PL
seducir	sedujera	V;SBJV;PST;LGSPEC1;1;SG
recontar	recontaste	V;IND;PST;PFV;2;SG;INFM
resquebrajar	resquebrajásemos	V;SBJV;PST;LGSPEC2;1;PL
blandear	blandeémonos	V;IMP;1;PL;ACC;PRO;1;PL
linear	linearía	V;COND;3;SG
silabear	silabeamos	V;IND;PRS;1;PL
trastabillar	trastabillase	V;SBJV;PST;1;SG
aquerenciarse	me aquerencio	V;IND;PRS;1;SG
transvasar	transvásennos	V;IMP;FORM;2;PL;ACC;PRO;1;PL
auspiciar	auspícialas	V;IMP;INFM;2;SG;ACC;PRO;3;PL
egresar	egresó	V;IND;PST;PFV;3;SG
cortar	córtenme	V;IMP;FORM;2;PL;DAT;PRO;1;SG
escodar	escodar	V;NFIN
sortear	sortearías	V;COND;2;SG;INFM
azuleño	azuleña	N;FEM;SG
planificar	planifiquémosla	V;IMP;1;PL;ACC;PRO;3;SG
ratear	ratéenles	V;IMP;FORM;2;PL;DAT;PRO;3;PL
reprender	repréndale	V;IMP;FORM;2;SG;DAT;PRO;3;SG
bochar	bochad	V;POS;IMP;2;PL;INFM
parafrasear	parafraseabas	V;IND;PST;IPFV;2;SG;INFM
desazonar	desazonáis	V;IND;PRS;2;PL;INFM
espichar	espicharme	V;ACC;PRO;1;SG
tremolar	tremolarte	V;DAT;PRO;2;SG
multar	multaban	V;IND;PST;IPFV;3;PL
pandear	pandeaste	V;IND;PST;PFV;2;SG;INFM
empellar	empellara	V;SBJV;PST;LGSPEC1;3;SG
discernir	discerniere	V;SBJV;FUT;2;SG;FORM
deleitar	deleitados	V;V.PTCP;PST;MASC;PL
maquear	maqueaos	V;IMP;INFM;2;PL;DAT;PRO;2;PL
commover	commoverles	V;DAT;PRO;3;PL
prohijar	prohíjen	V;SBJV;PRS;3;PL
criogenizar	criogenizadles	V;IMP;INFM;2;PL;DAT;PRO;3;PL
agredir	agrede	V;IND;PRS;2;SG;FORM
sambenitar	sambenitarle	V;DAT;PRO;3;SG
abducción	abducciones	N;FEM;PL
encapsular	no encapsule	V;NEG;IMP;2;SG;FORM
levantarse	levantado	V;V.PTCP;PST;MASC;SG
extruir	extruyéndolas	V;V.CVB;PRS;ACC;PRO;3;PL
empanizar	empanizadme	V;IMP;INFM;2;PL;ACC;PRO;1;SG
sombrear	sombrearan	V;SBJV;PST;LGSPEC1;3;PL
vosear	voseémoste	V;IMP;1;PL;ACC;PRO;2;SG
despojar	despoje	V;SBJV;PRS;1;SG
posponer	pospóngala	V;IMP;FORM;2;SG;ACC;PRO;3;SG
fisionar	fisionaréis	V;IND;FUT;2;PL;INFM
aclimatarse	se aclimatarán	V;IND;FUT;3;PL
aerotransportar	aerotransportadnos	V;IMP;INFM;2;PL;ACC;PRO;1;PL
desembolsillar	desembolsillabais	V;IND;PST;IPFV;2;PL;INFM
estornudar	estornudemos	V;POS;IMP;1;PL
eurito	eurito	N;MASC;SG
arrempujar	arrempujémoos	V;IMP;1;PL;DAT;PRO;2;PL
flagelar	flagelémosle	V;IMP;1;PL;DAT;PRO;3;SG
alevantar	alevántenos	V;IMP;FORM;2;SG;DAT;PRO;1;PL
yugular	no yugulemos	V;NEG;IMP;1;PL
invalidar	invalidándoles	V;V.CVB;PRS;DAT;PRO;3;PL
grafitero	grafiteras	N;FEM;PL
depurar	depuraréis	V;IND;FUT;2;PL;INFM
emplumar	emplumé	V;IND;PST;PFV;1;SG
biogénico	biogénicos	ADJ;MASC;PL
victimizar	victimizaos	V;IMP;INFM;2;PL;ACC;PRO;2;PL
trasponer	traspondrías	V;COND;2;SG;INFM
revivir	reviviéndoles	V;V.CVB;PRS;DAT;PRO;3;PL
carpir	carpamos	V;SBJV;PRS;1;PL
circuir	circúyanos	V;IMP;FORM;2;SG;ACC;PRO;1;PL
novelesco	novelescos	ADJ;MASC;PL
criticar	criticaríamos	V;COND;1;PL
desfalcar	desfalcaste	V;IND;PST;PFV;2;SG;INFM
acepillar	acepillarme	V;DAT;PRO;1;SG
retratar	no retratéis	V;NEG;IMP;2;PL;INFM
movilizar	movilizaros	V;ACC;PRO;2;PL
ababillarse	se ababillarían	V;COND;3;PL
transfundir	transfundirle	V;DAT;PRO;3;SG
mandíbula	mandíbulas	N;FEM;PL
mezquinar	mezquinadla	V;IMP;INFM;2;PL;ACC;PRO;3;SG
dimitir	dimitirte	V;ACC;PRO;2;SG
zancadillear	zancadilleadme	V;IMP;INFM;2;PL;ACC;PRO;1;SG
cizañear	cizañease	V;SBJV;PST;LGSPEC2;3;SG
ludir	ludiéndonos	V;V.CVB;PRS;DAT;PRO;1;PL
sellar	sellan	V;IND;PRS;3;PL
fantasear	fantasearía	V;COND;1;SG
trufar	trufas	V;IND;PRS;2;SG;INFM
panonio	panonio	N;MASC;SG
mezquinar	mezquinémosles	V;IMP;1;PL;DAT;PRO;3;PL
estabilizar	estabilicémoos	V;IMP;1;PL;ACC;PRO;2;PL
reasumir	reasumía	V;IND;PST;IPFV;3;SG
trazar	trazaren	V;SBJV;FUT;3;PL
llavear	llavearais	V;SBJV;PST;LGSPEC1;2;PL;INFM
charquear	charqueaba	V;IND;PST;IPFV;1;SG
pincelar	pincelarán	V;IND;FUT;3;PL
refundar	refúndanos	V;IMP;INFM;2;SG;DAT;PRO;1;PL
inactivar	inactivándonos	V;V.CVB;PRS;DAT;PRO;1;PL
estacar	estacada	V;V.PTCP;PST;FEM;SG
hegemonizar	hegemonizamos	V;IND;PRS;1;PL
augurar	augurándole	V;V.CVB;PRS;DAT;PRO;3;SG
proseguir	prosiga	V;POS;IMP;3;SG
acompañar	acompañarme	V;DAT;PRO;1;SG
avizorar	avizoró	V;IND;PST;PFV;2;SG;FORM
disgustar	disgustamos	V;IND;PRS;1;PL
amplificar	amplifiquen	V;POS;IMP;3;PL
contentar	contentaríamos	V;COND;1;PL
desparasitación	desparasitación	N;FEM;SG
desmineralizar	desmineralizarán	V;IND;FUT;3;PL
rascañar	rascáñelas	V;IMP;FORM;2;SG;ACC;PRO;3;PL
florear	floreáramos	V;SBJV;PST;LGSPEC1;1;PL
largar	largadnos	V;IMP;INFM;2;PL;DAT;PRO;1;PL
empellar	empellándoles	V;V.CVB;PRS;DAT;PRO;3;PL
renunciar	renunciándote	V;V.CVB;PRS;DAT;PRO;2;SG
limar	limémosles	V;IMP;1;PL;DAT;PRO;3;PL
estanear	estaneándoos	V;V.CVB;PRS;DAT;PRO;2;PL
acolchonar	acolchonemos	V;SBJV;PRS;1;PL
combar	combemos	V;SBJV;PRS;1;PL
hostiar	hostiarme	V;DAT;PRO;1;SG
enflaquecer	enflaquecerás	V;IND;FUT;2;SG;INFM
asturianizar	asturianícenla	V;IMP;FORM;2;PL;ACC;PRO;3;SG
secarse	no se sequen	V;NEG;IMP;3;PL
pifia	pifias	N;FEM;PL
adornar	adórnales	V;IMP;INFM;2;SG;DAT;PRO;3;PL
derrocar	derrocará	V;IND;FUT;3;SG
devastación	devastación	N;FEM;SG
pifear	pifeábamos	V;IND;PST;IPFV;1;PL
eritorbato	eritorbatos	N;MASC;PL
completar	completadas	V;V.PTCP;PST;FEM;PL
votar	vótenos	V;IMP;FORM;2;SG;DAT;PRO;1;PL
titularizar	titularícenle	V;IMP;FORM;2;PL;DAT;PRO;3;SG
compulsar	compúlsennos	V;IMP;FORM;2;PL;ACC;PRO;1;PL
enardecer	no enardezcamos	V;NEG;IMP;1;PL
auspicioso	auspiciosos	ADJ;MASC;PL
minorar	minorémoos	V;IMP;1;PL;DAT;PRO;2;PL
palmotear	palmoteándola	V;V.CVB;PRS;ACC;PRO;3;SG
tratar	no tratéis	V;NEG;IMP;2;PL;INFM
salsateca	salsatecas	N;FEM;PL
peligrar	peligraron	V;IND;PST;PFV;3;PL
culminar	culminásemos	V;SBJV;PST;1;PL
desocupar	desocupaos	V;IMP;INFM;2;PL;ACC;PRO;2;PL
congratular	congratulándonos	V;V.CVB;PRS;DAT;PRO;1;PL
discriminar	discriminadnos	V;IMP;INFM;2;PL;ACC;PRO;1;PL
momentito	momentito	N;MASC;SG
sobrenadar	sobrenada	V;POS;IMP;2;SG;INFM
excitar	excitase	V;SBJV;PST;3;SG
encaminar	encamináremos	V;SBJV;FUT;1;PL
ideático	ideática	ADJ;FEM;SG
radiodifundir	radiodifundiese	V;SBJV;PST;LGSPEC2;1;SG
maestra	maestra	N;FEM;SG
fortificante	fortificantes	ADJ;PL
vedar	vedaron	V;IND;PST;PFV;3;PL
acorralar	acorralémosles	V;IMP;1;PL;DAT;PRO;3;PL
reabrir	reabrían	V;IND;PST;IPFV;3;PL
trefilar	trefilasteis	V;IND;PST;PFV;2;PL;INFM
martillar	martíllenos	V;IMP;FORM;2;SG;DAT;PRO;1;PL
restañar	restáñanos	V;IMP;INFM;2;SG;DAT;PRO;1;PL
subministrar	subministrase	V;SBJV;PST;LGSPEC2;1;SG
comiscar	comiscadas	V;V.PTCP;PST;FEM;PL
desarreglar	desarreglarán	V;IND;FUT;3;PL
manducar	manduquémoos	V;IMP;1;PL;DAT;PRO;2;PL
matarse	se mataron	V;IND;PST;PFV;3;PL
aducir	aduciéndolas	V;V.CVB;PRS;ACC;PRO;3;PL
ateroesclerosis	ateroesclerosis	N;FEM;SG
readquirir	readquiéranme	V;IMP;FORM;2;PL;DAT;PRO;1;SG
córnico	córnico	N;MASC;SG
desmotivar	desmotívate	V;IMP;INFM;2;SG;DAT;PRO;2;SG
santista	santistas	N;MASC+FEM;PL
cuetear	cuetee	V;SBJV;PRS;1;SG
jurar	jurarme	V;ACC;PRO;1;SG
deshojar	deshojarte	V;DAT;PRO;2;SG
enconar	encónenos	V;IMP;FORM;2;SG;ACC;PRO;1;PL
desafinar	desafinémosle	V;IMP;1;PL;DAT;PRO;3;SG
gamborimbo	gamborimbo	N;MASC;SG
cuajar	cuajáis	V;IND;PRS;2;PL;INFM
subastar	subastara	V;SBJV;PST;LGSPEC1;2;SG;FORM
evaporar	evaporarán	V;IND;FUT;3;PL
encolerizar	encolericémosla	V;IMP;1;PL;ACC;PRO;3;SG
aerografiar	aerografiara	V;SBJV;PST;LGSPEC1;1;SG
lacar	no laquen	V;NEG;IMP;2;PL;FORM
gastroenterólogo	gastroenterólogo	N;MASC;SG
reenvasar	reenvasáremos	V;SBJV;FUT;1;PL
alzar	alcémoos	V;IMP;1;PL;ACC;PRO;2;PL
doctrinar	doctrínanos	V;IMP;INFM;2;SG;ACC;PRO;1;PL
acompasar	acompasáramos	V;SBJV;PST;LGSPEC1;1;PL
simpatizar	simpatizarás	V;IND;FUT;2;SG;INFM
sacarosa	sacarosas	N;FEM;PL
picar	picara	V;SBJV;PST;LGSPEC1;3;SG
boletinar	boletinándoos	V;V.CVB;PRS;DAT;PRO;2;PL
calcetar	no calcetes	V;NEG;IMP;2;SG;INFM
chorrear	chorreándote	V;V.CVB;PRS;DAT;PRO;2;SG
rebautizar	rebautizabas	V;IND;PST;IPFV;2;SG;INFM
esnifar	no esnifemos	V;NEG;IMP;1;PL
trompezar	trompezaseis	V;SBJV;PST;2;PL;INFM
respaldar	respalde	V;SBJV;PRS;3;SG
adyacer	adyagas	V;SBJV;PRS;2;SG;INFM
desenfadar	desenfademos	V;SBJV;PRS;1;PL
rehacer	rehágala	V;IMP;FORM;2;SG;ACC;PRO;3;SG
blasonar	blasónale	V;IMP;INFM;2;SG;DAT;PRO;3;SG
escalafonamiento	escalafonamiento	N;MASC;SG
hacendar	hacendáramos	V;SBJV;PST;LGSPEC1;1;PL
generar	genero	V;IND;PRS;1;SG
peinar	peinarnos	V;DAT;PRO;1;PL
trastornar	no trastornes	V;NEG;IMP;2;SG;INFM
guionar	guionen	V;SBJV;PRS;3;PL
mosquear	mosquee	V;POS;IMP;2;SG;FORM
saludar	no saluden	V;NEG;IMP;2;PL;FORM
guiadora	guiadora	N;FEM;SG
atesorar	atesoradlas	V;IMP;INFM;2;PL;ACC;PRO;3;PL
mamar	mamaseis	V;SBJV;PST;2;PL;INFM
amortizar	amortizase	V;SBJV;PST;3;SG
incitar	incitamos	V;IND;PRS;1;PL
engolosinar	engolosinase	V;SBJV;PST;LGSPEC2;2;SG;FORM
charlar	charlaríais	V;COND;2;PL;INFM
parquear	parquéenles	V;IMP;FORM;2;PL;DAT;PRO;3;PL
reperfilar	reperfiladme	V;IMP;INFM;2;PL;ACC;PRO;1;SG
moscar	moscaríais	V;COND;2;PL;INFM
cambiar	cambiase	V;SBJV;PST;1;SG
brujulear	brujuleara	V;SBJV;PST;LGSPEC1;3;SG
inorgánico	inorgánicas	ADJ;FEM;PL
preprocesar	preprocesareis	V;SBJV;FUT;2;PL;INFM
grafitear	grafiteas	V;IND;PRS;2;SG;INFM
esmaltar	esmaltaré	V;IND;FUT;1;SG
atrapar	atrápenos	V;IMP;FORM;2;SG;DAT;PRO;1;PL
reptar	reptara	V;SBJV;PST;LGSPEC1;1;SG
crucificar	crucifiquen	V;SBJV;PRS;3;PL
jugar	jugarme	V;ACC;PRO;1;SG
miniaturizar	no miniaturicemos	V;NEG;IMP;1;PL
deprimir	deprimiere	V;SBJV;FUT;3;SG
enfilar	enfílenle	V;IMP;FORM;2;PL;DAT;PRO;3;SG
enmaderar	enmaderara	V;SBJV;PST;LGSPEC1;2;SG;FORM
vestir	vestirte	V;DAT;PRO;2;SG
ondear	no ondeen	V;NEG;IMP;2;PL;FORM
sobreactuación	sobreactuación	N;FEM;SG
orellanense	orellanenses	ADJ;PL
hispanizar	hispanicémonos	V;IMP;1;PL;DAT;PRO;1;PL
sucitar	sucitamos	V;IND;PRS;1;PL
multar	multémonos	V;IMP;1;PL;DAT;PRO;1;PL
aromar	arome	V;SBJV;PRS;2;SG;FORM
vigorizar	vigorícenme	V;IMP;FORM;2;PL;DAT;PRO;1;SG
descender	descendidos	V;V.PTCP;PST;MASC;PL
deslavar	deslavados	V;V.PTCP;PST;MASC;PL
trastear	trasteará	V;IND;FUT;3;SG
percudir	percúdanos	V;IMP;FORM;2;SG;DAT;PRO;1;PL
complejizar	complejizareis	V;SBJV;FUT;2;PL;INFM
autobusero	autobuseros	N;MASC;PL
ampollar	ampollarte	V;DAT;PRO;2;SG
salvaguardar	salvaguardarías	V;COND;2;SG;INFM
desambiguar	desambiguamos	V;IND;PST;PFV;1;PL
reemprender	reemprendía	V;IND;PST;IPFV;2;SG;FORM
tradición	tradiciones	N;FEM;PL
regentear	regentearemos	V;IND;FUT;1;PL
libertar	libertarían	V;COND;3;PL
imperar	impérennos	V;IMP;FORM;2;PL;DAT;PRO;1;PL
destocar	destocado	V;V.PTCP;PST;MASC;SG
sobremedicar	sobremedíquela	V;IMP;FORM;2;SG;ACC;PRO;3;SG
instaurador	instauradores	N;MASC;PL
abismar	abísmenos	V;IMP;FORM;2;SG;ACC;PRO;1;PL
espesar	espesó	V;IND;PST;PFV;2;SG;FORM
acumular	acumúleles	V;IMP;FORM;2;SG;DAT;PRO;3;PL
bogotano	bogotana	N;FEM;SG
paduano	paduanas	ADJ;FEM;PL
jadeíta	jadeítas	N;FEM;PL
premostrar	premostrándole	V;V.CVB;PRS;DAT;PRO;3;SG
pendejear	pendejeémoste	V;IMP;1;PL;DAT;PRO;2;SG
intranquilizar	intranquilicémosla	V;IMP;1;PL;ACC;PRO;3;SG
focalizar	focalizarte	V;ACC;PRO;2;SG
rumiar	no rumiéis	V;NEG;IMP;2;PL;INFM
abochornarse	se abochornan	V;IND;PRS;3;PL
acitronar	acitrónele	V;IMP;FORM;2;SG;DAT;PRO;3;SG
acceder	accederle	V;DAT;PRO;3;SG
estatua	estatuas	N;FEM;PL
aderezar	aderezada	V;V.PTCP;PST;FEM;SG
desplumar	desplúmame	V;IMP;INFM;2;SG;DAT;PRO;1;SG
tabular	tabulasen	V;SBJV;PST;LGSPEC2;3;PL
alquitarar	alquitararán	V;IND;FUT;3;PL
sobrevivir	sobrevivid	V;POS;IMP;2;PL;INFM
chafar	cháfate	V;IMP;INFM;2;SG;ACC;PRO;2;SG
avistar	avistasen	V;SBJV;PST;LGSPEC2;3;PL
corroborar	corroborándonos	V;V.CVB;PRS;ACC;PRO;1;PL
perpetuar	perpetúame	V;IMP;INFM;2;SG;DAT;PRO;1;SG
escoltar	escoltémoos	V;IMP;1;PL;ACC;PRO;2;PL
desquiciar	desquiciadas	V;V.PTCP;PST;FEM;PL
extruir	extruirá	V;IND;FUT;3;SG
preaprobar	preaprobare	V;SBJV;FUT;3;SG
complejizar	complejizarla	V;ACC;PRO;3;SG
restar	restado	V;V.PTCP;PST;MASC;SG
falsear	falseados	V;V.PTCP;PST;MASC;PL
empedrar	empedrara	V;SBJV;PST;LGSPEC1;1;SG
retraducir	retraduzcámosle	V;IMP;1;PL;DAT;PRO;3;SG
ojón	ojones	N;MASC;PL
otorrinolaringóloga	otorrinolaringólogas	N;FEM;PL
gloriar	gloríele	V;IMP;FORM;2;SG;DAT;PRO;3;SG
hermanar	hermanarme	V;DAT;PRO;1;SG
reenviar	reenviémoste	V;IMP;1;PL;ACC;PRO;2;SG
azolvar	azolvéis	V;SBJV;PRS;2;PL;INFM
parar	parándolas	V;V.CVB;PRS;ACC;PRO;3;PL
gaussiano	gaussiana	ADJ;FEM;SG
carpir	carpas	V;SBJV;PRS;2;SG;INFM
martirizar	martirízate	V;IMP;INFM;2;SG;DAT;PRO;2;SG
abakuá	abakuá	N;MASC;SG
arribar	arribaros	V;DAT;PRO;2;PL
suncho	suncho	N;MASC;SG
pontificar	pontificabais	V;IND;PST;IPFV;2;PL;INFM
trasferir	trasfiriéndote	V;V.CVB;PRS;DAT;PRO;2;SG
aguardiente	aguardientes	N;MASC;PL
alistar	alistemos	V;SBJV;PRS;1;PL
lamentar	lamentándome	V;V.CVB;PRS;DAT;PRO;1;SG
martillear	martillearéis	V;IND;FUT;2;PL;INFM
reflotar	reflota	V;IND;PRS;3;SG
desapasionar	desapasióneme	V;IMP;FORM;2;SG;DAT;PRO;1;SG
rebalancear	rebalanceare	V;SBJV;FUT;1;SG
serotoninérgico	serotoninérgicas	ADJ;FEM;PL
sancionar	no sancionen	V;NEG;IMP;2;PL;FORM
eligir	no elijáis	V;NEG;IMP;2;PL;INFM
embretar	embrétales	V;IMP;INFM;2;SG;DAT;PRO;3;PL
aperturar	apertura	V;IND;PRS;2;SG;FORM
afinar	no afinéis	V;NEG;IMP;2;PL;INFM
lisiar	lísiales	V;IMP;INFM;2;SG;DAT;PRO;3;PL
recorrer	recorriéremos	V;SBJV;FUT;1;PL
cronometrar	cronometrarte	V;DAT;PRO;2;SG
bastardear	bastardeamos	V;IND;PRS;1;PL
irrespetar	no irrespeten	V;NEG;IMP;2;PL;FORM
autoabastecerse	se autoabastecerá	V;IND;FUT;3;SG
adentrar	adentrarles	V;DAT;PRO;3;PL
desconcentrar	desconcentraros	V;ACC;PRO;2;PL
desregular	desregúlennos	V;IMP;FORM;2;PL;ACC;PRO;1;PL
sobrera	sobrera	ADJ;FEM;SG
fruncir	fruncirme	V;DAT;PRO;1;SG
equivaler	equivalemos	V;IND;PRS;1;PL
rostir	rostiereis	V;SBJV;FUT;2;PL;INFM
gilipollear	gilipollee	V;POS;IMP;2;SG;FORM
excavar	excavaseis	V;SBJV;PST;LGSPEC2;2;PL;INFM
anublar	anublare	V;SBJV;FUT;2;SG;FORM
antiglobalista	antiglobalistas	N;MASC+FEM;PL
arrear	arréenla	V;IMP;FORM;2;PL;ACC;PRO;3;SG
endiosar	endiosaren	V;SBJV;FUT;3;PL
secuenciar	secuenciémoos	V;IMP;1;PL;DAT;PRO;2;PL
destacar	destacaron	V;IND;PST;PFV;3;PL
descaminar	descaminadlas	V;IMP;INFM;2;PL;ACC;PRO;3;PL
turbocargar	turbocargó	V;IND;PST;PFV;3;SG
humillar	humillémosle	V;IMP;1;PL;DAT;PRO;3;SG
escaldar	escaldémoslas	V;IMP;1;PL;ACC;PRO;3;PL
anglificar	anglificándome	V;V.CVB;PRS;DAT;PRO;1;SG
rebatir	rebatámosle	V;IMP;1;PL;DAT;PRO;3;SG
incentivar	incentivábamos	V;IND;PST;IPFV;1;PL
guitarrear	guitarrease	V;SBJV;PST;LGSPEC2;1;SG
empachar	empácheles	V;IMP;FORM;2;SG;DAT;PRO;3;PL
dispensarizar	dispensarizase	V;SBJV;PST;LGSPEC2;3;SG
cancro	cancros	N;MASC;PL
monologar	monologaras	V;SBJV;PST;LGSPEC1;2;SG;INFM
interpelar	interpelarte	V;ACC;PRO;2;SG
escenario	escenarios	N;MASC;PL
calibrar	calibraseis	V;SBJV;PST;LGSPEC2;2;PL;INFM
desfondar	desfondándome	V;V.CVB;PRS;ACC;PRO;1;SG
escobar	escobaré	V;IND;FUT;1;SG
resembrar	resembraba	V;IND;PST;IPFV;3;SG
ningunear	ninguneadles	V;IMP;INFM;2;PL;DAT;PRO;3;PL
circunscribir	circunscribís	V;IND;PRS;2;PL;INFM
envejecer	envejécenos	V;IMP;INFM;2;SG;DAT;PRO;1;PL
tribunalicio	tribunalicia	ADJ;FEM;SG
carburar	carburásemos	V;SBJV;PST;LGSPEC2;1;PL
podar	podaremos	V;IND;FUT;1;PL
derrapar	derraparon	V;IND;PST;PFV;3;PL
chaquira	chaquira	N;FEM;SG
gravar	gravará	V;IND;FUT;3;SG
desnudar	desnudarle	V;DAT;PRO;3;SG
relativizar	relativicémoste	V;IMP;1;PL;ACC;PRO;2;SG
remixar	remixamos	V;IND;PST;PFV;1;PL
obstar	obstarais	V;SBJV;PST;LGSPEC1;2;PL;INFM
maliciar	maliciémoos	V;IMP;1;PL;DAT;PRO;2;PL
conquiolina	conquiolinas	N;FEM;PL
comprehender	no comprehenda	V;NEG;IMP;2;SG;FORM
rostizar	rostizáramos	V;SBJV;PST;LGSPEC1;1;PL
descontentar	desconténtenme	V;IMP;FORM;2;PL;ACC;PRO;1;SG
aplásico	aplásica	ADJ;FEM;SG
sobrevalorar	sobrevaloraras	V;SBJV;PST;LGSPEC1;2;SG;INFM
exhalar	exhalarais	V;SBJV;PST;LGSPEC1;2;PL;INFM
pavimentar	paviméntenla	V;IMP;FORM;2;PL;ACC;PRO;3;SG
desajustar	desajustémonos	V;IMP;1;PL;DAT;PRO;1;PL
recomenzar	recomencémoste	V;IMP;1;PL;ACC;PRO;2;SG
compenetrar	compenetres	V;SBJV;PRS;2;SG;INFM
embullar	embullémoos	V;IMP;1;PL;DAT;PRO;2;PL
postítulo	postítulo	N;MASC;SG
demarrar	demarrase	V;SBJV;PST;LGSPEC2;3;SG
fermentar	fermentara	V;SBJV;PST;LGSPEC1;1;SG
solicitar	solicitándoles	V;V.CVB;PRS;DAT;PRO;3;PL
establecer	estableciese	V;SBJV;PST;3;SG
apagar	apáguenos	V;IMP;FORM;2;SG;ACC;PRO;1;PL
pringar	pringarás	V;IND;FUT;2;SG;INFM
palmotear	palmotea	V;IND;PRS;3;SG
psicoprofiláctico	psicoprofilácticos	ADJ;MASC;PL
anticuar	anticuaseis	V;SBJV;PST;LGSPEC2;2;PL;INFM
arreglar	arréglelas	V;IMP;FORM;2;SG;ACC;PRO;3;PL
afantasmar	no afantasméis	V;NEG;IMP;2;PL;INFM
emular	emulaba	V;IND;PST;IPFV;1;SG
anidar	anidándome	V;V.CVB;PRS;DAT;PRO;1;SG
olear	oléela	V;IMP;FORM;2;SG;ACC;PRO;3;SG
flirtear	flirteen	V;POS;IMP;2;PL;FORM
publicar	publicándole	V;V.CVB;PRS;DAT;PRO;3;SG
encuadernar	encuadernase	V;SBJV;PST;3;SG
