kelek	keleğin	N;NOM;SG;PSS2S
boşanmak	boşanmamıştın	V;INFR;PST;PFV;2;SG;NEG;DECL
benzemek	benziyor olur muydunuz	V;IND;PST;HAB+PROG;2;PL;INTR;POS
verdirtmek	verdirtir olacakmışsın	V;INFR;FUT;HAB;2;SG;POS;DECL
kuvvetlilik	kuvvetliliklerini	N;ACC;PL;PSS2S
valiz	valizlerimizde	N;LOC;PL;PSS1P
ürümek	ürüyecek miymişim	V;INFR;FUT;1;SG;INTR;POS
tıkmak	tıkıyor olacaklar	V;IND;FUT;PROG;3;PL;POS;DECL
aldırtmak	aldırtmadınız mı	V;IND;PST;2;PL;NEG;INTR
onguncu	onguncularınızı	N;ACC;PL;PSS2P
gidilmek	gidilecek olacak mısınız	V;IND;FUT;PROSP;2;PL;INTR;POS
solumak	soluyor olmayacaklarmış	V;INFR;FUT;PROG;3;PL;NEG;DECL
göstermek	gösteriyor olacaktın	V;IND;PST;PROSP+PROG;2;SG;POS;DECL
eskimek	eskimemişler mi	V;INFR;PST;3;PL;NEG;INTR
ölümsüzleştirmek	ölümsüzleştirecek olmayacakmışsın	V;INFR;FUT;PROSP;2;SG;NEG;DECL
barışmak	barışıyor olmayacakmış	V;INFR;FUT;PROG;3;SG;NEG;DECL
puding	pudingin	N;GEN;SG
kılmak	kılmeli misin	V;OBLIG;PRS;2;SG;INTR;POS
yetmek	yetiyor olmamalı mıymışız	V;OBLIG;INFR;PRS;PROG;1;PL;NEG;INTR
atılmak	atılıyor olmamalıymışsın	V;OBLIG;INFR;PRS;PROG;2;SG;NEG;DECL
eziyetçi	eziyetçilermişim	N;ARGNO1S;PL;LGSPEC2
sütlü kahve	sütlü kahvesi	N;NOM;SG;PSS3S
pisletmek	pisletiyor olmamalı mıymışsınız	V;OBLIG;INFR;PRS;PROG;2;PL;NEG;INTR
ehemmiyetlilik	ehemmiyetliliklerine	N;DAT;PL;PSS3S
canlandırmamak	canlandırıyın	V;IMP;2;PL;POS;DECL
kaşımak	kaşımelisin	V;OBLIG;PRS;2;SG;POS;DECL
yuvarlamak	yuvarlayacaktı	V;IND;PST;PROSP;3;SG;POS;DECL
verimsizleştirmek	verimsizleştirmiyor muydunuz	V;IND;PST;PROG;2;PL;NEG;INTR
müge	mügelerimizin	N;GEN;PL;PSS1P
dolap çevirmek	dolap çeviriyor olmamalıyız	V;OBLIG;PRS;PROG;1;PL;NEG;DECL
tosbağa	tosbağanız	N;NOM;SG;PSS2P
uyanmak	uyanmayacak mısın	V;IND;FUT;2;SG;NEG;INTR
konmak	konmayacakmışım	V;INFR;FUT;1;SG;NEG;DECL
ölçüşmek	ölçüşüyor olmayacakmışım	V;INFR;FUT;PROG;1;SG;NEG;DECL
yerleşmek	yerleşir olmayacak mıymışsın	V;INFR;FUT;HAB;2;SG;NEG;INTR
eğlenmek	eğlenmeyecek miymişim	V;INFR;FUT;1;SG;NEG;INTR
karıştırmak	karıştırır olacak mıymışım	V;INFR;FUT;HAB;1;SG;INTR;POS
yontulmak	yontulmuyorlar	V;IND;PRS;PROG;3;PL;NEG;DECL
pişmek	pişmemeli misin	V;OBLIG;PRS;2;SG;NEG;INTR
canlanmak	canlanıyor olmamalı mıydınız	V;OBLIG;PST;PROG;2;PL;NEG;INTR
sezmek	sezmiyorum	V;IND;PRS;PROG;1;SG;NEG;DECL
palmiye	palmiyesini	N;ACC;SG;PSS3S
havlu atmak	havlu atar olacakmışsın	V;INFR;FUT;HAB;2;SG;POS;DECL
imrenmek	imrenmeyecekler	V;IND;FUT;3;PL;NEG;DECL
atıştırmak	atıştıracağız	V;IND;FUT;1;PL;POS;DECL
kötüleşmek	kötüleştiler	V;IND;PST;3;PL;POS;DECL
silkmek	silkiyor olmamalıyız	V;OBLIG;PRS;PROG;1;PL;NEG;DECL
kalkmak	kalkmış olmayacak mıydı	V;INFR;PST;PROSP;3;SG;NEG;INTR
miyoloji	miyolojilerden	N;ABL;PL
musluk	musluklar	N;NOM;PL
yanıt vermek	yanıt verecek miydik	V;IND;PST;PROSP;1;PL;INTR;POS
yutak	yutaktan	N;ABL;SG
bulmak	bulmamışlar mıymış	V;INFR;LGSPEC1;PST;3;PL;NEG;INTR
sıvılaştırmak	sıvılaştıracakmışım	V;INFR;FUT;1;SG;POS;DECL
yıpratmak	yıpratmak	V;NFIN
öpmek	öpecek olacakmışsın	V;INFR;FUT;PROSP;2;SG;POS;DECL
babasız	babasızlarında	N;LOC;PL;PSS3S
ölçüşmek	ölçüşecek olacak mısınız	V;IND;FUT;PROSP;2;PL;INTR;POS
öğütmek	öğütmüş olacaklar mı	V;INFR;FUT;PFV;3;PL;INTR;POS
otuz bir çekmek	otuz bir çekmemiş miydim	V;INFR;PST;PFV;1;SG;NEG;INTR
gözden kaybolmak	gözden kaybolmayın	V;IMP;2;PL;NEG;DECL
öldürmek	öldürür olmayacakmış	V;INFR;FUT;HAB;3;SG;NEG;DECL
kanamak	kanayacak olacağım	V;IND;FUT;PROSP;1;SG;POS;DECL
taşmak	taşıyor olmayacaklar mıydı	V;IND;PST;PROSP+PROG;3;PL;NEG;INTR
kızmak	kızmazlarmış	V;INFR;PRS;HAB;3;PL;NEG;DECL
kursiyer	kursiyerlerinizden	N;ABL;PL;PSS2P
zartayı çekmek	zartayı çekecek olacağız	V;IND;FUT;PROSP;1;PL;POS;DECL
sünger	süngerde	N;LOC;SG
gerekmek	gerekmemiş miydi	V;INFR;PST;PFV;3;SG;NEG;INTR
şeftali	şeftaliden	N;ABL;SG
dövüşmek	dövüşür mü	V;IND;PRS;HAB;3;SG;INTR;POS
binmek	binmiyor muyum	V;IND;PRS;PROG;1;SG;NEG;INTR
kaynaştırtılmak	kaynaştırtılmıyorsunuz	V;IND;PRS;PROG;2;PL;NEG;DECL
coşmak	coşmuyoruz	V;IND;PRS;PROG;1;PL;NEG;DECL
bozmak	bozdular mı	V;IND;PST;3;PL;INTR;POS
çıldırtmak	çıldırtıyor muydun	V;IND;PST;PROG;2;SG;INTR;POS
tanımak	tanıyordunuz	V;IND;PST;PROG;2;PL;POS;DECL
mühimlik	mühimliğinizde	N;LOC;SG;PSS2P
ettirtmek	ettirtti miydi	V;IND;PST;PFV;3;SG;INTR;POS
ikilem	ikilemlerimizin	N;GEN;PL;PSS1P
dizi	dizilerden	N;ABL;PL
patlamak	patlıyormuşsunuz	V;INFR;PRS;PROG;2;PL;POS;DECL
görüntü	görüntülerinden	N;ABL;PL;PSS3S
örmek	örüyor olmayacaktınız	V;IND;PST;PROSP+PROG;2;PL;NEG;DECL
yağmak	yağmış olmayacaklar mıydı	V;INFR;PST;PROSP;3;PL;NEG;INTR
ateşe vermek	ateşe verecek olmayacak mıymışsın	V;INFR;FUT;PROSP;2;SG;NEG;INTR
seçmek	seçmez miydiniz	V;IND;PST;HAB;2;PL;NEG;INTR
yazmak	yazıyor muydun	V;IND;PST;PROG;2;SG;INTR;POS
cızlamı çekmek	cızlamı çekiyor olurlar mıydı	V;IND;PST;HAB+PROG;3;PL;INTR;POS
bilmek	bilmezdi	V;IND;PST;HAB;3;SG;NEG;DECL
öğrenci	öğrenciden	N;ABL;SG
soğumak	soğumamalıymışsın	V;OBLIG;INFR;PST;2;SG;NEG;DECL
bunamak	bunayacaktık	V;IND;PST;PROSP;1;PL;POS;DECL
uyanmak	uyanıyor olur muydum	V;IND;PST;HAB+PROG;1;SG;INTR;POS
şaşırttırmak	şaşırttırmazmışız	V;INFR;PRS;HAB;1;PL;NEG;DECL
koşulmak	koşulmalılardı	V;OBLIG;PST;3;PL;POS;DECL
sululuk	sululuklar	N;NOM;PL
çalgıç	çalgıçlarını	N;ACC;PL;PSS3S
uçmak	uçuyor olmamalı mıydın	V;OBLIG;PST;PROG;2;SG;NEG;INTR
büyümek	büyümüş olmayacaktık	V;INFR;PST;PROSP;1;PL;NEG;DECL
aldırtmamak	aldırtırmıyor muydunuz	V;IND;PST;PROG;2;PL;INTR;POS
kaynaştırtılmak	kaynaştırtılacaklardı	V;IND;PST;PROSP;3;PL;POS;DECL
kararmak	kararıyormuşum	V;INFR;PRS;PROG;1;SG;POS;DECL
günahkâr	günahkârlarınıza	N;DAT;PL;PSS2P
bir avuç toprak olmak	bir avuç toprak olmayacak mıydınız	V;IND;PST;PROSP;2;PL;NEG;INTR
bitirttirmek	bitirttirmiş olmayacaklar	V;INFR;FUT;PFV;3;PL;NEG;DECL
dalmak	dalıyor olmalı	V;OBLIG;PRS;PROG;3;SG;POS;DECL
acıktırmak	yaptırıyor olmalılar mıymış	V;OBLIG;INFR;PRS;PROG;3;PL;INTR;POS
içermek	içermeyecek misin	V;IND;FUT;2;SG;NEG;INTR
seçici	seçicilerine	N;DAT;PL;PSS2S
okumak	okuacak olmayacak mıymışsın	V;INFR;FUT;PROSP;2;SG;NEG;INTR
evlenmek	evleniyor olur muyduk	V;IND;PST;HAB+PROG;1;PL;INTR;POS
şaşmak	şaşacak olacakmışsınız	V;INFR;FUT;PROSP;2;PL;POS;DECL
ayarlatmak	ayarlatıyordu	V;IND;PST;PROG;3;SG;POS;DECL
kaynaştırtmak	kaynaştırtıyor olmamalıydınız	V;OBLIG;PST;PROG;2;PL;NEG;DECL
kış uykusuna yatmak	kış uykusuna yatmış olacaktınız	V;INFR;PST;PROSP;2;PL;POS;DECL
can vermek	can vermemiş miymiş	V;INFR;LGSPEC1;PST;3;SG;NEG;INTR
yalamak	yalıyor olmalıydı	V;OBLIG;PST;PROG;3;SG;POS;DECL
anmak	anmıyor muyduk	V;IND;PST;PROG;1;PL;NEG;INTR
saydırtmak	saydırtmış olacaktık	V;INFR;PST;PROSP;1;PL;POS;DECL
kimyasal tepkime	kimyasal tepkimelerini	N;ACC;PL;PSS2S
dokunmatik ekran	dokunmatik ekranı	N;ACC;SG
satılmak	satılmış olacaktın	V;INFR;PST;PROSP;2;SG;POS;DECL
enişte	eniştelerinizi	N;ACC;PL;PSS2P
dedikoducu	dedikoduculardın	N;ARGNO2S;PL;PST
verilmek	verilmeliymişim	V;OBLIG;INFR;PST;1;SG;POS;DECL
üzmek	üzmemiş misin	V;INFR;PST;2;SG;NEG;INTR
büktürtmek	büktürtüyor olmayacakmışsın	V;INFR;FUT;PROG;2;SG;NEG;DECL
taklitçi olmak	taklitçi olmuş olacak mı	V;INFR;FUT;PFV;3;SG;INTR;POS
ölmek	ölüyor olacaksın	V;IND;FUT;PROG;2;SG;POS;DECL
zartayı çekmek	zartayı çeker olmayacaklarmış	V;INFR;FUT;HAB;3;PL;NEG;DECL
köpürmek	köpürmüşler miydi	V;INFR;PST;PFV;3;PL;INTR;POS
öğütmek	öğütmüş müsün	V;INFR;PST;2;SG;INTR;POS
doğru	doğruduk	ADJ;LGSPEC1;PST;1;PL;POS;DECL
uyumak	uyuduyduk	V;IND;PST;PFV;1;PL;POS;DECL
sürünmek	sürünmeyecekmiş	V;INFR;FUT;3;SG;NEG;DECL
taramak	taramalılardı	V;OBLIG;PST;3;PL;POS;DECL
dürtmek	dürtüyor olacak mıydınız	V;IND;PST;PROSP+PROG;2;PL;INTR;POS
Hakk'ın rahmetine kavuşmak	Hakk'ın rahmetine kavuşmuş	V;INFR;PST;3;SG;POS;DECL
yelken	yelkeninden	N;ABL;SG;PSS3S
iyileşmek	iyileşiyor olacak mıymışız	V;INFR;FUT;PROG;1;PL;INTR;POS
yıpratmak	yıpratmış mıymışım	V;INFR;LGSPEC1;PST;1;SG;INTR;POS
süzmek	süzecek olacak mıyız	V;IND;FUT;PROSP;1;PL;INTR;POS
yalancı	yalancı	N;ARGNO3S;SG;PRS
cızlamı çekmek	cızlamı çekmezdim	V;IND;PST;HAB;1;SG;NEG;DECL
zurna	zurnaları	N;ACC;PL
açılmak	açılacak mıyız	V;IND;FUT;1;PL;INTR;POS
batmak	batmamışım	V;INFR;PST;1;SG;NEG;DECL
arzu	arzularında	N;LOC;PL;PSS3S
kunduz	kunduzları	N;NOM;PL;PSS3S
çeç	çeçinizden	N;ABL;SG;PSS2P
kaçmak	kaçacak olacaklar mıymış	V;INFR;FUT;PROSP;3;PL;INTR;POS
şüphe	şüphelerinde	N;LOC;PL;PSS3S
tıkmak	tıkıyor olmalıyım	V;OBLIG;PRS;PROG;1;SG;POS;DECL
sattırtmak	sattırtırlar mıydı	V;IND;PST;HAB;3;PL;INTR;POS
simit	simidinize	N;DAT;SG;PSS2P
yaptırmak	yaptırdı mıydım	V;IND;PST;PFV;1;SG;INTR;POS
doğmak	doğacak olmayacak mıymış	V;INFR;FUT;PROSP;3;SG;NEG;INTR
pişmek	pişiyor olmamalı mıydım	V;OBLIG;PST;PROG;1;SG;NEG;INTR
ölümsüzleştirmek	ölümsüzleştirmemişlerdi	V;INFR;PST;PFV;3;PL;NEG;DECL
indirim	indirimlerinin	N;GEN;PL;PSS2S
kusmak	kusardım	V;IND;PST;HAB;1;SG;POS;DECL
çalmak	çalmalı mıydı	V;OBLIG;PST;3;SG;INTR;POS
kapatmak	kapatmamıştık	V;INFR;PST;PFV;1;PL;NEG;DECL
kakmak	kakıyor olacaksınız	V;IND;FUT;PROG;2;PL;POS;DECL
sürtmek	sürtmediydik	V;IND;PST;PFV;1;PL;NEG;DECL
sinirlendirmek	sinirlendiriyor olmalı mıymışsın	V;OBLIG;INFR;PRS;PROG;2;SG;INTR;POS
seçilmek	seçilmeli misin	V;OBLIG;PRS;2;SG;INTR;POS
yuvarlamak	yuvarladı mıydınız	V;IND;PST;PFV;2;PL;INTR;POS
süt sağmak	süt sağmameliyiz	V;OBLIG;PRS;1;PL;NEG;DECL
yapılmak	yapılacak olmayacakmışız	V;INFR;FUT;PROSP;1;PL;NEG;DECL
açmak	açmışlardı	V;INFR;PST;PFV;3;PL;POS;DECL
geğirmek	geğirmiyor muydun	V;IND;PST;PROG;2;SG;NEG;INTR
evlenmek	evlenecek miymişsiniz	V;INFR;FUT;2;PL;INTR;POS
acımak	acımayacaklarmış	V;INFR;FUT;3;PL;NEG;DECL
yendirtmek	yendirtir miymişsiniz	V;INFR;PRS;HAB;2;PL;INTR;POS
aldırtmak	aldırtmamışmışsın	V;INFR;LGSPEC1;PST;2;SG;NEG;DECL
dilmek	dilmemiştik	V;INFR;PST;PFV;1;PL;NEG;DECL
tenisçi	tenisçilerin	N;NOM;PL;PSS2S
çürümek	çürüyor olmalılarmış	V;OBLIG;INFR;PRS;PROG;3;PL;POS;DECL
bağlamak	bağlıyor olmayacakmışız	V;INFR;FUT;PROG;1;PL;NEG;DECL
çarmıha germek	çarmıha geriyor olmayacakmış	V;INFR;FUT;PROG;3;SG;NEG;DECL
ağlaşmak	ağlaşmayacaklar	V;IND;FUT;3;PL;NEG;DECL
gözden kaybolmak	gözden kaybolmayacaksın	V;IND;FUT;2;SG;NEG;DECL
bikini	bikiniden	N;ABL;SG
işitmek	işitiyor olmalıymış	V;OBLIG;INFR;PRS;PROG;3;SG;POS;DECL
gülünçleşmek	gülünçleşmeyecekler miymiş	V;INFR;FUT;3;PL;NEG;INTR
çalgıç	çalgıçları	N;NOM;PL;PSS3S
kakmak	kakmış olacaktın	V;INFR;PST;PROSP;2;SG;POS;DECL
ilerletmek	ilerletmeyecek	V;IND;FUT;3;SG;NEG;DECL
kışkırtmak	kışkırtmış olmayacak mıyız	V;INFR;FUT;PFV;1;PL;NEG;INTR
şamdan	şamdanımızda	N;LOC;SG;PSS1P
dalgalanmak	dalgalanmazsın	V;IND;PRS;HAB;2;SG;NEG;DECL
eğitmek	eğitecek olmayacakmışım	V;INFR;FUT;PROSP;1;SG;NEG;DECL
geğirmek	geğirmiş miymişim	V;INFR;LGSPEC1;PST;1;SG;INTR;POS
kuyruk	kuyruğunuza	N;DAT;SG;PSS2P
sızmak	sızacak olmayacakmışsınız	V;INFR;FUT;PROSP;2;PL;NEG;DECL
uyuşturucu	uyuşturucunuz	N;NOM;SG;PSS2P
öğretmek	öğretiyor olmayacakmış	V;INFR;FUT;PROG;3;SG;NEG;DECL
yolcu	yolcunuzdan	N;ABL;SG;PSS2P
canlandırmak	canlandıracaktım	V;IND;PST;PROSP;1;SG;POS;DECL
toprak olmak	toprak oldular mı	V;IND;PST;3;PL;INTR;POS
sayım	sayımımız	N;NOM;SG;PSS1P
patlamak	patlayacağız	V;IND;FUT;1;PL;POS;DECL
çözelti	çözeltileri	N;NOM;PL;PSS3S
karar vermek	karar vermedik mi	V;IND;PST;1;PL;NEG;INTR
köpürmek	köpürmüş müydük	V;INFR;PST;PFV;1;PL;INTR;POS
çevirmek	çevirir miymişsiniz	V;INFR;PRS;HAB;2;PL;INTR;POS
gizlemek	gizlememeli miydiniz	V;OBLIG;PST;2;PL;NEG;INTR
canlanılmak	canlanılmadılar	V;IND;PST;3;PL;NEG;DECL
kanamak	kanayacak olacağız	V;IND;FUT;PROSP;1;PL;POS;DECL
ülke	ülkelerinizin	N;GEN;PL;PSS2P
sikişmek	sikişiyor muyum	V;IND;PRS;PROG;1;SG;INTR;POS
nefes aldırtmak	nefes aldırtmaz mıydık	V;IND;PST;HAB;1;PL;NEG;INTR
düşmek	düşmemişmişsin	V;INFR;LGSPEC1;PST;2;SG;NEG;DECL
veri grubu	veri gruplarını	N;ACC;PL
ayarlatmak	ayarlatmış mıymış	V;INFR;LGSPEC1;PST;3;SG;INTR;POS
güvenmek	güvendim mi	V;IND;PST;1;SG;INTR;POS
iffet	iffetlerine	N;DAT;PL;PSS2S
canlandırtılmak	canlandırtılacak olmayacaklar mıymış	V;INFR;FUT;PROSP;3;PL;NEG;INTR
kararmak	kararmazmışsın	V;INFR;PRS;HAB;2;SG;NEG;DECL
iyileştirmek	iyileştirmemelisiniz	V;OBLIG;PRS;2;PL;NEG;DECL
haberleşmek	haberleşiyor olurdum	V;IND;PST;HAB+PROG;1;SG;POS;DECL
programlatmak	programlatmayacaktın	V;IND;PST;PROSP;2;SG;NEG;DECL
kaltak	kaltaklarımız	N;NOM;PL;PSS1P
evren	evreninizde	N;LOC;SG;PSS2P
süründürtmek	süründürtmüyordun	V;IND;PST;PROG;2;SG;NEG;DECL
ılımak	ılımalılardı	V;OBLIG;PST;3;PL;POS;DECL
diremek	diriyor olmalıydım	V;OBLIG;PST;PROG;1;SG;POS;DECL
öğretmek	öğretirmişim	V;INFR;PRS;HAB;1;SG;POS;DECL
karın	karınları	N;ACC;PL
koca	kocalarınıza	N;DAT;PL;PSS2P
sevkiyat	sevkiyatımızdan	N;ABL;SG;PSS1P
ılımak	ılımalı mıymışsınız	V;OBLIG;INFR;PST;2;PL;INTR;POS
atmamak	atmaz mıymışsın	V;INFR;PRS;HAB;2;SG;INTR;POS
kopmak	koptuk	V;IND;PST;1;PL;POS;DECL
kararmak	kararacak olacak mıymışız	V;INFR;FUT;PROSP;1;PL;INTR;POS
sermek	sermiş olacak mıydı	V;INFR;PST;PROSP;3;SG;INTR;POS
iğrenmek	iğrenecekler mi	V;IND;FUT;3;PL;INTR;POS
cüce gezegen	cüce gezegenimizi	N;ACC;SG;PSS1P
evlat	evladın	N;GEN;SG
irdelemek	irdelememeli miydin	V;OBLIG;PST;2;SG;NEG;INTR
inanmak	inanmamışmışsınız	V;INFR;LGSPEC1;PST;2;PL;NEG;DECL
bunamak	bunamalı mıymış	V;OBLIG;INFR;PST;3;SG;INTR;POS
sattırmak	sattırıyor olmalılar mı	V;OBLIG;PRS;PROG;3;PL;INTR;POS
kaynaştırmak	kaynaştırmayacak mıydın	V;IND;PST;PROSP;2;SG;NEG;INTR
gelinmek	gelinecek miymişim	V;INFR;FUT;1;SG;INTR;POS
ayarlatmak	ayarlatıyor olmayacakmışım	V;INFR;FUT;PROG;1;SG;NEG;DECL
götürmek	götürmeyeceğiz	V;IND;FUT;1;PL;NEG;DECL
yormak	yormuş	V;INFR;PST;3;SG;POS;DECL
yırtmak	yırtmayacaklar mıymış	V;INFR;FUT;3;PL;NEG;INTR
otomobilci	otomobilciydi	N;ARGNO3S;SG;PST
öpüşmek	öpüşecek olmayacak mısın	V;IND;FUT;PROSP;2;SG;NEG;INTR
yetiştirmek	yetiştirmiyormuşum	V;INFR;PRS;PROG;1;SG;NEG;DECL
yaptırmak	yaptırıyor olacak mısınız	V;IND;FUT;PROG;2;PL;INTR;POS
ibnelik	ibneliklerine	N;DAT;PL;PSS2S
ettirtmek	ettirtmiş olacak mıydım	V;INFR;PST;PROSP;1;SG;INTR;POS
kısrak	kısrağınızda	N;LOC;SG;PSS2P
atışmak	atışınız	V;IMP;2;PL;LGSPEC2;POS;DECL
yoldaş	yoldaşını	N;ACC;SG;PSS3S
bitirttirmek	bitirttirecektin	V;IND;PST;PROSP;2;SG;POS;DECL
daldırtmak	daldırtmameli	V;OBLIG;PRS;3;SG;NEG;DECL
oturmak	oturmuş olacak	V;INFR;FUT;PFV;3;SG;POS;DECL
uyumak	uyuruz	V;IND;PRS;HAB;1;PL;POS;DECL
göstermek	göstermeli misin	V;OBLIG;PRS;2;SG;INTR;POS
analitik geometri	analitik geometrinizin	N;GEN;SG;PSS2P
kaçmak	kaçmayacak mıydım	V;IND;PST;PROSP;1;SG;NEG;INTR
kopmak	kopmuşsunuz	V;INFR;PST;2;PL;POS;DECL
daldırtmak	daldırtmış olmayacak mıydın	V;INFR;PST;PROSP;2;SG;NEG;INTR
göç	göçlerinde	N;LOC;PL;PSS2S
bomba	bombaların	N;NOM;PL;PSS2S
ılımak	ılımamalılar mıydı	V;OBLIG;PST;3;PL;NEG;INTR
bekletmek	bekletmemişmiş	V;INFR;LGSPEC1;PST;3;SG;NEG;DECL
düşünmek	düşünüyor olmayacak mıydık	V;IND;PST;PROSP+PROG;1;PL;NEG;INTR
tutuşturmak	tutuşturmazlar mı	V;IND;PRS;HAB;3;PL;NEG;INTR
ittirilmek	ittiriliyor olmalılar mıymış	V;OBLIG;INFR;PRS;PROG;3;PL;INTR;POS
aşık attırmak	aşık attıracaksın	V;IND;FUT;2;SG;POS;DECL
işletim	işletimler	N;ARGNO3S;PL;PRS
kalıp	kalıplarınızda	N;LOC;PL;PSS2P
ekşimek	ekşiyecek olacak	V;IND;FUT;PROSP;3;SG;POS;DECL
taç	tacını	N;ACC;SG;PSS2S
kullanmak	kullanmeli	V;OBLIG;PRS;3;SG;POS;DECL
üstesinden gelmek	üstesinden gelmiş olacağız	V;INFR;FUT;PFV;1;PL;POS;DECL
hız	hızınızda	N;LOC;SG;PSS2P
işletim	işletiminizi	N;ACC;SG;PSS2P
heyecanlandırtmak	heyecanlandırtacak mıydınız	V;IND;PST;PROSP;2;PL;INTR;POS
kışkırtmak	kışkırtıyor olmayacaklar mıymış	V;INFR;FUT;PROG;3;PL;NEG;INTR
yoksullaştırmak	yoksullaştırmışlarmış	V;INFR;LGSPEC1;PST;3;PL;POS;DECL
yıpranmak	yıpranmalıydı	V;OBLIG;PST;3;SG;POS;DECL
sikmek	sikersiniz	V;IND;PRS;HAB;2;PL;POS;DECL
yıpranmak	yıpranıyor olmamalı mıymış	V;OBLIG;INFR;PRS;PROG;3;SG;NEG;INTR
erkecel	erkecellerine	N;DAT;PL;PSS3S
gözlemek	gözlemişiz	V;INFR;PST;1;PL;POS;DECL
seçmen	seçmenlerdin	N;ARGNO2S;PL;PST
koklamak	koklamazdın	V;IND;PST;HAB;2;SG;NEG;DECL
içermek	içermişsin	V;INFR;PST;2;SG;POS;DECL
ittirtmek	ittirtti miydim	V;IND;PST;PFV;1;SG;INTR;POS
vermek	vermeyeceklermiş	V;INFR;FUT;3;PL;NEG;DECL
memleket	memleketinin	N;GEN;SG;PSS2S
sunu	sunusundan	N;ABL;SG;PSS3S
döndürmek	döndürüyor olacak	V;IND;FUT;PROG;3;SG;POS;DECL
kanamak	kanayacak olmayacağım	V;IND;FUT;PROSP;1;SG;NEG;DECL
ekşitmek	ekşitmiyormuşsun	V;INFR;PRS;PROG;2;SG;NEG;DECL
silkmek	silker olacakmışsınız	V;INFR;FUT;HAB;2;PL;POS;DECL
sıyırmak	sıyırıyor olmalı mı	V;OBLIG;PRS;PROG;3;SG;INTR;POS
serpmek	serpeceklermiş	V;INFR;FUT;3;PL;POS;DECL
yoğurmak	yoğurmamalıymışım	V;OBLIG;INFR;PST;1;SG;NEG;DECL
tercüman	tercüman	N;ARGNO3S;SG;PRS
Hakk'ın rahmetine kavuşmak	Hakk'ın rahmetine kavuşur olacakmışız	V;INFR;FUT;HAB;1;PL;POS;DECL
örtmek	örtecek miymişim	V;INFR;FUT;1;SG;INTR;POS
ölçüşmek	ölçüşecek olmayacakmışız	V;INFR;FUT;PROSP;1;PL;NEG;DECL
batmak	batmamalıydım	V;OBLIG;PST;1;SG;NEG;DECL
büktürtmemek	büktürtürmüşüz	V;INFR;PRS;HAB;1;PL;POS;DECL
dönmek	dön	V;IMP;2;SG;POS;DECL
model	modellerinden	N;ABL;PL;PSS3S
vernik	vernik	N;NOM;SG
yazmak	yazmıyorduk	V;IND;PST;PROG;1;PL;NEG;DECL
coşmak	coşmamışlar mı	V;INFR;PST;3;PL;NEG;INTR
koyulaşmak	koyulaşacaklardı	V;IND;PST;PROSP;3;PL;POS;DECL
acıktırmak	acıktırmazmış	V;INFR;PRS;HAB;3;SG;NEG;DECL
iğrenmek	iğren	V;IMP;2;SG;POS;DECL
patlamak	patlamadıydım	V;IND;PST;PFV;1;SG;NEG;DECL
keser	keserlarımıza	N;DAT;PL;PSS1P
ağda yapmak	ağd yapıyor muydu	V;IND;PST;PROG;3;SG;INTR;POS
germek	germiyor muymuşsunuz	V;INFR;PRS;PROG;2;PL;NEG;INTR
ölçülmek	ölçülüyor olacak mı	V;IND;FUT;PROG;3;SG;INTR;POS
dirsek	dirseklerinin	N;GEN;PL;PSS3S
fakir	fakirini	N;ACC;SG;PSS2S
yapışmak	yapışmış olmayacak mısın	V;INFR;FUT;PFV;2;SG;NEG;INTR
akciğer	akciğerinin	N;GEN;SG;PSS2S
jokey	jokeylerinden	N;ABL;PL;PSS3S
süzgeç	süzgeçlerimiz	N;NOM;PL;PSS1P
ayılmak	ayılmayacaklar mı	V;IND;FUT;3;PL;NEG;INTR
şikâyet etmek	şikâyet edeceklerdi	V;IND;PST;PROSP;3;PL;POS;DECL
unutmak	unutmuş olacak mısınız	V;INFR;FUT;PFV;2;PL;INTR;POS
okumak	okumuş olmayacak mıydı	V;INFR;PST;PROSP;3;SG;NEG;INTR
unutmak	unutmuyormuşsunuz	V;INFR;PRS;PROG;2;PL;NEG;DECL
pelin	pelinlerine	N;DAT;PL;PSS3S
batmak	batacak mıydı	V;IND;PST;PROSP;3;SG;INTR;POS
acıtmak	acıtacak olacak mısın	V;IND;FUT;PROSP;2;SG;INTR;POS
ağlaşmak	ağlaşır olmayacaklarmış	V;INFR;FUT;HAB;3;PL;NEG;DECL
tükenmek	tükenmemeli miymişim	V;OBLIG;INFR;PST;1;SG;NEG;INTR
duş almak	duş alacak olacakmışsınız	V;INFR;FUT;PROSP;2;PL;POS;DECL
kalmak	kalmamış mıydınız	V;INFR;PST;PFV;2;PL;NEG;INTR
dayamak	dayıyor olacak mıymışsınız	V;INFR;FUT;PROG;2;PL;INTR;POS
kırdırtmak	kırdırtıyor olmaz mıydı	V;IND;PST;HAB+PROG;3;SG;NEG;INTR
sunulmak	sunulmuş muymuşum	V;INFR;LGSPEC1;PST;1;SG;INTR;POS
eksi sayı	eksi sayılarını	N;ACC;PL;PSS2S
koymak	koymamıştın	V;INFR;PST;PFV;2;SG;NEG;DECL
geciktirmek	geciktirmiyor muymuşsunuz	V;INFR;PRS;PROG;2;PL;NEG;INTR
iyileştirmek	iyileştirmez miymişim	V;INFR;PRS;HAB;1;SG;NEG;INTR
üşenmek	üşenmeyecek miyim	V;IND;FUT;1;SG;NEG;INTR
delik	deliklere	N;DAT;PL
seyretmek	seyretiyor olacağım	V;IND;FUT;PROG;1;SG;POS;DECL
ürümek	ürüyor olmayacaklardı	V;IND;PST;PROSP+PROG;3;PL;NEG;DECL
hece	heceydiler	N;ARGNO3P;SG;PST
yitmek	yitecek olacakmışsın	V;INFR;FUT;PROSP;2;SG;POS;DECL
saklamak	saklar olmayacakmışım	V;INFR;FUT;HAB;1;SG;NEG;DECL
delik	deliklerinden	N;ABL;PL;PSS2S
sunmak	sunmuştuk	V;INFR;PST;PFV;1;PL;POS;DECL
makarna	makarnalarınızın	N;GEN;PL;PSS2P
garp	garplarımız	N;NOM;PL;PSS1P
koymak	koymamış mıymış	V;INFR;LGSPEC1;PST;3;SG;NEG;INTR
bilinemezcilik	bilinemezciliğin	N;GEN;SG
titremek	titriyor olmamalı mıymışsın	V;OBLIG;INFR;PRS;PROG;2;SG;NEG;INTR
verimsizleştirmek	verimsizleştirmedi miydin	V;IND;PST;PFV;2;SG;NEG;INTR
kalıp	kalıplarını	N;ACC;PL;PSS2S
birleştirtmek	birleştirtiyor olmalıyım	V;OBLIG;PRS;PROG;1;SG;POS;DECL
homonim	homoniminizin	N;GEN;SG;PSS2P
kaybolmak	kaybolmuyorlar mıymış	V;INFR;PRS;PROG;3;PL;NEG;INTR
değişmek	değişir miymişsiniz	V;INFR;PRS;HAB;2;PL;INTR;POS
yan cümle	yan cümlelerinizde	N;LOC;PL;PSS2P
yanıt vermek	yanıt veriyor olmamalıydın	V;OBLIG;PST;PROG;2;SG;NEG;DECL
sevişmek	sevişir miymişiz	V;INFR;PRS;HAB;1;PL;INTR;POS
darılmak	darılacak olmayacak mıymış	V;INFR;FUT;PROSP;3;SG;NEG;INTR
almak	almıştı	V;INFR;PST;PFV;3;SG;POS;DECL
bunamak	bunamış olacak mısın	V;INFR;FUT;PFV;2;SG;INTR;POS
itilmek	itiliyor olmayacaktım	V;IND;PST;PROSP+PROG;1;SG;NEG;DECL
şaşılmak	şaşılır olmayacak mıymış	V;INFR;FUT;HAB;3;SG;NEG;INTR
şaşırtmak	şaşırtıyor olmamalıyız	V;OBLIG;PRS;PROG;1;PL;NEG;DECL
ağlaşmak	ağlaşıyorlardı	V;IND;PST;PROG;3;PL;POS;DECL
çalışmak	çalışmamış mısınız	V;INFR;PST;2;PL;NEG;INTR
delirmek	deliriyorlarmış	V;INFR;PRS;PROG;3;PL;POS;DECL
kaynaşmak	kaynaşmış olacaklardı	V;INFR;PST;PROSP;3;PL;POS;DECL
şaşırtmak	şaşırtmış olmayacak mıydın	V;INFR;PST;PROSP;2;SG;NEG;INTR
yaratma	yaratmamızın	N;GEN;SG;PSS1P
öpmek	öper miyiz	V;IND;PRS;HAB;1;PL;INTR;POS
sıyırmak	sıyırıyor olmayacaktık	V;IND;PST;PROSP+PROG;1;PL;NEG;DECL
gecikmek	gecikiyor olmalı mıymışsın	V;OBLIG;INFR;PRS;PROG;2;SG;INTR;POS
tartmak	tartıyor olmazdın	V;IND;PST;HAB+PROG;2;SG;NEG;DECL
dinmek	diniyor olacağım	V;IND;FUT;PROG;1;SG;POS;DECL
paylaşmak	paylaşacak olacağım	V;IND;FUT;PROSP;1;SG;POS;DECL
karnabahar	karnabaharları	N;ACC;PL
attırmak	attırmış mıydık	V;INFR;PST;PFV;1;PL;INTR;POS
sendrom	sendromlarınızı	N;ACC;PL;PSS2P
sıkmak	sıkmamelisiniz	V;OBLIG;PRS;2;PL;NEG;DECL
gezmek	gezerler miymiş	V;INFR;PRS;HAB;3;PL;INTR;POS
yaymak	yayıyorlar	V;IND;PRS;PROG;3;PL;POS;DECL
totemcilik	totemciliğinizi	N;ACC;SG;PSS2P
çarmıha germek	çarmıha geriyor olmalıydın	V;OBLIG;PST;PROG;2;SG;POS;DECL
yanıt vermek	yanıt vermeyecek misiniz	V;IND;FUT;2;PL;NEG;INTR
oynamak	oynardınız	V;IND;PST;HAB;2;PL;POS;DECL
alındırtmak	alındırtmışız	V;INFR;PST;1;PL;POS;DECL
iyileştirmek	iyileştirmeyecek miyim	V;IND;FUT;1;SG;NEG;INTR
dökmek	dökmedilerdi	V;IND;PST;PFV;3;PL;NEG;DECL
cüce gezegen	cüce gezegenlerimize	N;DAT;PL;PSS1P
ayrılmak	ayrılıyordun	V;IND;PST;PROG;2;SG;POS;DECL
voleybol	voleybol	N;NOM;SG
peron	peronlarında	N;LOC;PL;PSS2S
yapışık ikiz	yapışık ikizinden	N;ABL;SG;PSS3S
Web sunucusu	Web sunucularını	N;ACC;PL
kalkmak	kalkıyor olacaklar mı	V;IND;FUT;PROG;3;PL;INTR;POS
ılımak	ılımıyorsunuz	V;IND;PRS;PROG;2;PL;NEG;DECL
geciktirmek	geciktiriyor olacağız	V;IND;FUT;PROG;1;PL;POS;DECL
acıktırtmak	acıktırtıyor olmamalıymışım	V;OBLIG;INFR;PRS;PROG;1;SG;NEG;DECL
kırılmak	kırılıyor olmalıydınız	V;OBLIG;PST;PROG;2;PL;POS;DECL
takmak	taktı mı	V;IND;PST;3;SG;INTR;POS
sevişmek	sevişiyor olacakmışım	V;INFR;FUT;PROG;1;SG;POS;DECL
yoksullaştırmak	yoksullaştırırdı	V;IND;PST;HAB;3;SG;POS;DECL
çevirmek	çevirmezdiniz	V;IND;PST;HAB;2;PL;NEG;DECL
helak olmak	helak olmuş olmayacak mıyım	V;INFR;FUT;PFV;1;SG;NEG;INTR
bölmek	bölerdi	V;IND;PST;HAB;3;SG;POS;DECL
işitmek	işitiyor muymuşum	V;INFR;PRS;PROG;1;SG;INTR;POS
enginar	enginarınıza	N;DAT;SG;PSS2P
otomobil	otomobillerimizin	N;GEN;PL;PSS1P
doğurmak	doğuruyorlarmış	V;INFR;PRS;PROG;3;PL;POS;DECL
ayırmak	ayıracak olacakmış	V;INFR;FUT;PROSP;3;SG;POS;DECL
yermek	yermemiş mi	V;INFR;PST;3;SG;NEG;INTR
bulunmak	bulunmamıştım	V;INFR;PST;PFV;1;SG;NEG;DECL
sunmak	sunmamış mıyız	V;INFR;PST;1;PL;NEG;INTR
sosis	sosisinde	N;LOC;SG;PSS3S
deşmek	deşiyor olmayacaktık	V;IND;PST;PROSP+PROG;1;PL;NEG;DECL
verdirtmek	verdirtmeyecek misiniz	V;IND;FUT;2;PL;NEG;INTR
gezmek	gezdin mi	V;IND;PST;2;SG;INTR;POS
site	sitenin	N;GEN;SG
iğne	iğnelerinizin	N;GEN;PL;PSS2P
dolap çevirmek	dolap çevirmiş olacaktın	V;INFR;PST;PROSP;2;SG;POS;DECL
flaş	flaştım	N;ARGNO1S;SG;PST
kurumak	kuruyor olmamalılar mıymış	V;OBLIG;INFR;PRS;PROG;3;PL;NEG;INTR
seçmek	seçmeyecekler miydi	V;IND;PST;PROSP;3;PL;NEG;INTR
kütük	kütüklerin	N;NOM;PL;PSS2S
izlemek	izlemeyecek miydiniz	V;IND;PST;PROSP;2;PL;NEG;INTR
allık	allıklardan	N;ABL;PL
doğru	doğru değil miyim?	ADJ;LGSPEC1;PRS;1;SG;NEG;INTR
dokumak	dokumamış mıydık	V;INFR;PST;PFV;1;PL;NEG;INTR
geçmek	geçiyor olmayacak	V;IND;FUT;PROG;3;SG;NEG;DECL
üretmek	ürettin	V;IND;PST;2;SG;POS;DECL
asmak	asıyor olmazdınız	V;IND;PST;HAB+PROG;2;PL;NEG;DECL
kusmak	kusmuyormuş	V;INFR;PRS;PROG;3;SG;NEG;DECL
çıkmak	çıktık mı	V;IND;PST;1;PL;INTR;POS
şamarlamak	şamarlamayacaklar mıydı	V;IND;PST;PROSP;3;PL;NEG;INTR
yıldız	yıldızlardan	N;ABL;PL
kromozom	kromozomlarınızın	N;GEN;PL;PSS2P
patlamak	patlıyor olur muydun	V;IND;PST;HAB+PROG;2;SG;INTR;POS
dirilmek	dirilmiş olmayacak mıydım	V;INFR;PST;PROSP;1;SG;NEG;INTR
şamarlamak	şamarlamayacaklar mı	V;IND;FUT;3;PL;NEG;INTR
takmak	takmışsınız	V;INFR;PST;2;PL;POS;DECL
seccade	seccadelerinden	N;ABL;PL;PSS3S
otostop	otostoplarını	N;ACC;PL;PSS2S
iyileşmek	iyileşiyorsun	V;IND;PRS;PROG;2;SG;POS;DECL
en küçük ortak kat	en küçük ortak kat	N;LOC;SG;PSS3P
denilmek	denilecek olmayacakmışsınız	V;INFR;FUT;PROSP;2;PL;NEG;DECL
şişmek	şişiyor olmayacağım	V;IND;FUT;PROG;1;SG;NEG;DECL
kararmak	kararmayacakmışsın	V;INFR;FUT;2;SG;NEG;DECL
paylaşmak	paylaştıydınız	V;IND;PST;PFV;2;PL;POS;DECL
yapılmak	yapılmamıştı	V;INFR;PST;PFV;3;SG;NEG;DECL
gelinmek	geliniyor olur muydunuz	V;IND;PST;HAB+PROG;2;PL;INTR;POS
ayakkabı	ayakkabın	N;NOM;SG;PSS2S
karıştırmak	karıştırır olmayacakmışsınız	V;INFR;FUT;HAB;2;PL;NEG;DECL
konsey	konseylerinin	N;GEN;PL;PSS2S
İngilizceleştirmek	İngilizceleştirmeyecekmişsin	V;INFR;FUT;2;SG;NEG;DECL
verilmek	verilmeli miymişiz	V;OBLIG;INFR;PST;1;PL;INTR;POS
ateşe vermek	ateşe vermiş olacak mı	V;INFR;FUT;PFV;3;SG;INTR;POS
aldırtmamak	aldırtmamamışlardı	V;INFR;PST;PFV;3;PL;NEG;DECL
nedime	nedimelerinin	N;GEN;PL;PSS2S
bohça	bohçaymışsın	N;ARGNO2S;SG;LGSPEC2
saklamak	saklarım	V;IND;PRS;HAB;1;SG;POS;DECL
öpmek	öpüyor olmayacak mısın	V;IND;FUT;PROG;2;SG;NEG;INTR
yaptırtmak	yaptırtıyor olmayacaktın	V;IND;PST;PROSP+PROG;2;SG;NEG;DECL
batmak	batıyor olacak mıydı	V;IND;PST;PROSP+PROG;3;SG;INTR;POS
yapboz	yapbozlarımızın	N;GEN;PL;PSS1P
yetiştirmek	yetiştiriyor olmayacak mıymışsın	V;INFR;FUT;PROG;2;SG;NEG;INTR
öğretmek	öğretiyor olmalı mı	V;OBLIG;PRS;PROG;3;SG;INTR;POS
taklitçi olmak	taklitçi oluyor olur muydun	V;IND;PST;HAB+PROG;2;SG;INTR;POS
aramak	aramalıydık	V;OBLIG;PST;1;PL;POS;DECL
paskalya	paskalyada	N;LOC;SG
sille	sillenizin	N;GEN;SG;PSS2P
çığırtkanlık	çığırtkanlıklarınızın	N;GEN;PL;PSS2P
köpürmek	köpürecek olacaksın	V;IND;FUT;PROSP;2;SG;POS;DECL
sattırtmak	sattırtmaz mıymışsın	V;INFR;PRS;HAB;2;SG;NEG;INTR
hastalanmak	hastalanıyor olmamalı mıydın	V;OBLIG;PST;PROG;2;SG;NEG;INTR
orta parmak	orta parmaklarımızın	N;GEN;PL;PSS1P
karakter	karaktersin	N;ARGNO2S;SG;PRS
sınamak	sınamazmış	V;INFR;PRS;HAB;3;SG;NEG;DECL
yolundurtmak	yolundurtmamalı mıymışsınız	V;OBLIG;INFR;PST;2;PL;NEG;INTR
katılmak	katılacak olacaklar mı	V;IND;FUT;PROSP;3;PL;INTR;POS
gezmek	geziyor olmalı mı	V;OBLIG;PRS;PROG;3;SG;INTR;POS
ateşe vermek	ateşe veriyor olacak mıyız	V;IND;FUT;PROG;1;PL;INTR;POS
adalet	adalete	N;DAT;SG
göçmek	göçmüyor mu	V;IND;PRS;PROG;3;SG;NEG;INTR
büktürtmek	büktürtmezler miydi	V;IND;PST;HAB;3;PL;NEG;INTR
tartmak	tartmışmışız	V;INFR;LGSPEC1;PST;1;PL;POS;DECL
açmak	açıyordu	V;IND;PST;PROG;3;SG;POS;DECL
ittirmek	ittiriyor olmalılarmış	V;OBLIG;INFR;PRS;PROG;3;PL;POS;DECL
yolundurtmak	yolundurtmaz mıymış	V;INFR;PRS;HAB;3;SG;NEG;INTR
vefat	vefatımıza	N;DAT;SG;PSS1P
artmak	artmadınız mı	V;IND;PST;2;PL;NEG;INTR
sattırtmak	sattırtmadım mı	V;IND;PST;1;SG;NEG;INTR
tepmek	teper olacakmışız	V;INFR;FUT;HAB;1;PL;POS;DECL
çalgıcı	çalgıcıymışlar	N;ARGNO3P;SG;LGSPEC2
delirmek	deliriyor olmalıymışsınız	V;OBLIG;INFR;PRS;PROG;2;PL;POS;DECL
öldürmek	öldürmemeli miymişsiniz	V;OBLIG;INFR;PST;2;PL;NEG;INTR
kalkmak	kalktım mı	V;IND;PST;1;SG;INTR;POS
kılmak	kılıyor olacaklar mıymış	V;INFR;FUT;PROG;3;PL;INTR;POS
hava atmak	hava atın	V;IMP;2;PL;POS;DECL
anmak	anmış olacak mıyım	V;INFR;FUT;PFV;1;SG;INTR;POS
başvuru	başvurularında	N;LOC;PL;PSS2S
utandırmak	utandırırmışım	V;INFR;PRS;HAB;1;SG;POS;DECL
çarşaf	çarşafının	N;GEN;SG;PSS2S
kopmak	kopuyor olmalı mıydım	V;OBLIG;PST;PROG;1;SG;INTR;POS
uğratılmak	uğratılıyor olacak mısınız	V;IND;FUT;PROG;2;PL;INTR;POS
yazmak	yazıyorsunuz	V;IND;PRS;PROG;2;PL;POS;DECL
örmek	örmeyecek	V;IND;FUT;3;SG;NEG;DECL
yetiştirmek	yetiştirmeyecekti	V;IND;PST;PROSP;3;SG;NEG;DECL
gelinmek	gelinmeli miydi	V;OBLIG;PST;3;SG;INTR;POS
buharlaşmak	buharlaşmayacakmışım	V;INFR;FUT;1;SG;NEG;DECL
bükmek	bükmezdi	V;IND;PST;HAB;3;SG;NEG;DECL
sıyırmak	sıyırır olmayacak mıymışsın	V;INFR;FUT;HAB;2;SG;NEG;INTR
Hakk'ın rahmetine kavuşmak	Hakk'ın rahmetine kavuştu muydunuz	V;IND;PST;PFV;2;PL;INTR;POS
arınmak	arınmadı mıydı	V;IND;PST;PFV;3;SG;NEG;INTR
bilemek	bileyecektin	V;IND;PST;PROSP;2;SG;POS;DECL
devinmek	devinmiş	V;INFR;PST;3;SG;POS;DECL
doymak	doyar mı	V;IND;PRS;HAB;3;SG;INTR;POS
taban	tabanınıza	N;DAT;SG;PSS2P
tanışmak	tanışıyor olmamalılarmış	V;OBLIG;INFR;PRS;PROG;3;PL;NEG;DECL
boşalmak	boşalır mıyız	V;IND;PRS;HAB;1;PL;INTR;POS
uyanmak	uyanacaksınız	V;IND;FUT;2;PL;POS;DECL
üstesinden gelmek	üstesinden gelmemeli miymişsiniz	V;OBLIG;INFR;PST;2;PL;NEG;INTR
alındırmak	alındırmamalı mıymışız	V;OBLIG;INFR;PST;1;PL;NEG;INTR
oynamak	oynuyor olmaz mıydım	V;IND;PST;HAB+PROG;1;SG;NEG;INTR
eksiklik	eksiklikte	N;LOC;SG
karıştırmak	karıştırmış olmayacaklar	V;INFR;FUT;PFV;3;PL;NEG;DECL
düzeltmek	düzeltmemişlermiş	V;INFR;LGSPEC1;PST;3;PL;NEG;DECL
çıkmak	çıkmışlar	V;INFR;PST;3;PL;POS;DECL
yutak	yutaklarınıza	N;DAT;PL;PSS2P
süsmek	süsüyor olmamalıydık	V;OBLIG;PST;PROG;1;PL;NEG;DECL
saklanmak	saklanmadınız mı	V;IND;PST;2;PL;NEG;INTR
öbek	öbekleriniz	N;NOM;PL;PSS2P
temizlemek	temizlememişsiniz	V;INFR;PST;2;PL;NEG;DECL
görmek	görmedin mi	V;IND;PST;2;SG;NEG;INTR
soymak	soymuş olacaklar mı	V;INFR;FUT;PFV;3;PL;INTR;POS
hoca	hocana	N;DAT;SG;PSS2S
disket	disketlerinizi	N;ACC;PL;PSS2P
duymak	duydu muyduk	V;IND;PST;PFV;1;PL;INTR;POS
yıpranmak	yıpranmadı mıydınız	V;IND;PST;PFV;2;PL;NEG;INTR
öpmek	öpmüş olacak mı	V;INFR;FUT;PFV;3;SG;INTR;POS
yedirmek	yedirmiş olmayacaktım	V;INFR;PST;PROSP;1;SG;NEG;DECL
deney	deneyinde	N;LOC;SG;PSS2S
hata yapmak	hata yapacak olacaklar	V;IND;FUT;PROSP;3;PL;POS;DECL
belde	beldenizin	N;GEN;SG;PSS2P
kavun	kavunların	N;GEN;PL
süründürmek	süründürüyor olacakmışsınız	V;INFR;FUT;PROG;2;PL;POS;DECL
kibir	kibire	N;DAT;SG
yakşı	yakşı değilmişler	ADJ;LGSPEC1;LGSPEC2;3;PL;NEG;DECL
kirpi	kirpilerinin	N;GEN;PL;PSS3S
bir avuç toprak olmak	bir avuç toprak olmadık	V;IND;PST;1;PL;NEG;DECL
sürüm	sürümleri	N;NOM;PL;PSS3S
gölge	gölgeleriniz	N;NOM;PL;PSS2P
verdirtmek	verdirtiyor muyum	V;IND;PRS;PROG;1;SG;INTR;POS
heyecanlanmak	heyecanlanmamışlarmış	V;INFR;LGSPEC1;PST;3;PL;NEG;DECL
Abu Dabili	Abu Dabili	N;ARGNO3S;SG;PRS
salçalık	salçalığından	N;ABL;SG;PSS2S
yormak	yormalı mıydık	V;OBLIG;PST;1;PL;INTR;POS
cavlağı çekmek	cavlağı çekiyor olmazdın	V;IND;PST;HAB+PROG;2;SG;NEG;DECL
çıngırağı çekmek	çıngırağı çekecek olacak	V;IND;FUT;PROSP;3;SG;POS;DECL
diremek	direecek olmayacak mıymış	V;INFR;FUT;PROSP;3;SG;NEG;INTR
övmek	övüyor olacaklar mı	V;IND;FUT;PROG;3;PL;INTR;POS
kullanılmak	kullanılmaz mıydı	V;IND;PST;HAB;3;SG;NEG;INTR
mağara	mağarasından	N;ABL;SG;PSS3S
abadi	abadinizi	N;ACC;SG;PSS2P
yağmak	yağmadık mı	V;IND;PST;1;PL;NEG;INTR
hasta	hastalarına	N;DAT;PL;PSS2S
doğurmak	doğuracak olmayacak mıymışsınız	V;INFR;FUT;PROSP;2;PL;NEG;INTR
wiki	wikimizden	N;ABL;SG;PSS1P
kaynaştırmak	kaynaştıracak mıymışsın	V;INFR;FUT;2;SG;INTR;POS
yaptırtmak	yaptırtacak mıymışsınız	V;INFR;FUT;2;PL;INTR;POS
süründürtmek	süründürtüyor olmayacak	V;IND;FUT;PROG;3;SG;NEG;DECL
lezbiyen	lezbiyeninin	N;GEN;SG;PSS3S
alkış	alkışlarını	N;ACC;PL;PSS2S
patlamak	patlamış olacak mıydınız	V;INFR;PST;PROSP;2;PL;INTR;POS
geçmek	geçer olacak mıymışsın	V;INFR;FUT;HAB;2;SG;INTR;POS
fındık	fındıklar	N;ARGNO3S;PL;PRS
çalışmak	çalışıyor olacakmışım	V;INFR;FUT;PROG;1;SG;POS;DECL
kıskanmak	kıskanmalıydın	V;OBLIG;PST;2;SG;POS;DECL
aşık	aşıklarına	N;DAT;PL;PSS2S
yapma	yapmanızda	N;LOC;SG;PSS2P
tutuşturmak	tutuşturuyor olmalıyım	V;OBLIG;PRS;PROG;1;SG;POS;DECL
açılmak	açılacak olmayacak mıyız	V;IND;FUT;PROSP;1;PL;NEG;INTR
germek	germemişmişsin	V;INFR;LGSPEC1;PST;2;SG;NEG;DECL
kullanmak	kullanmış mıymışsınız	V;INFR;LGSPEC1;PST;2;PL;INTR;POS
sesçi	sesçilerimizden	N;ABL;PL;PSS1P
kaynaştırtılmak	kaynaştırtılmışlar	V;INFR;PST;3;PL;POS;DECL
gelişmek	geliştiydik	V;IND;PST;PFV;1;PL;POS;DECL
üşenmek	üşenmez miymişim	V;INFR;PRS;HAB;1;SG;NEG;INTR
dalak	dalağınızın	N;GEN;SG;PSS2P
kuyruğu titretmek	kuyruğu titretmiş olacak mı	V;INFR;FUT;PFV;3;SG;INTR;POS
sinirlendirmek	sinirlendirmeyecekti	V;IND;PST;PROSP;3;SG;NEG;DECL
koymak	koyuyor olmayacak mısın	V;IND;FUT;PROG;2;SG;NEG;INTR
dirilmemek	dirilmemişler miydi	V;INFR;PST;PFV;3;PL;INTR;POS
kışkırtmak	kışkırtıyor olacak mıydık	V;IND;PST;PROSP+PROG;1;PL;INTR;POS
atmamak	atmıyormuş	V;INFR;PRS;PROG;3;SG;POS;DECL
kapmak	kaparmışız	V;INFR;PRS;HAB;1;PL;POS;DECL
yağlamak	yağlayacaksın	V;IND;FUT;2;SG;POS;DECL
babalı	babalılar	N;NOM;PL
deşmek	deşer olmayacaklar mıymış	V;INFR;FUT;HAB;3;PL;NEG;INTR
işitmek	işitmemişmişsin	V;INFR;LGSPEC1;PST;2;SG;NEG;DECL
alışmak	alışır olacak mıymış	V;INFR;FUT;HAB;3;SG;INTR;POS
türemek	türememiş misiniz	V;INFR;PST;2;PL;NEG;INTR
konferans	konferansımızın	N;GEN;SG;PSS1P
ölmek	ölüyor olmayacaklar	V;IND;FUT;PROG;3;PL;NEG;DECL
polis	polislermişsin	N;ARGNO2S;PL;LGSPEC2
kızmak	kızmayacaksınız	V;IND;FUT;2;PL;NEG;DECL
yolundurmak	yolundurmayacaklarmış	V;INFR;FUT;3;PL;NEG;DECL
aşık olmak	aşık olacak olacaklarmış	V;INFR;FUT;PROSP;3;PL;POS;DECL
otostop çekmek	otostop çekmiş olmayacaktım	V;INFR;PST;PROSP;1;SG;NEG;DECL
geliştirmek	geliştiriyor olmamalı mıymışız	V;OBLIG;INFR;PRS;PROG;1;PL;NEG;INTR
osurmak	osurmayacak mıydım	V;IND;PST;PROSP;1;SG;NEG;INTR
davranmak	davranmıyor muymuşum	V;INFR;PRS;PROG;1;SG;NEG;INTR
kırdırtmak	kırdırtmış olmayacaksınız	V;INFR;FUT;PFV;2;PL;NEG;DECL
karga	kargayı	N;ACC;SG
iç ağ	iç ağlarınıza	N;DAT;PL;PSS2P
parçalanmak	parçalanıyor olmayacak mıydım	V;IND;PST;PROSP+PROG;1;SG;NEG;INTR
alındırmak	alındıracak olacağız	V;IND;FUT;PROSP;1;PL;POS;DECL
çökertmek	çökertmelisin	V;OBLIG;PRS;2;SG;POS;DECL
tenisçi	tenisçiydin	N;ARGNO2S;SG;PST
solumak	solur muymuşum	V;INFR;PRS;HAB;1;SG;INTR;POS
erimek	erimiş olacaktı	V;INFR;PST;PROSP;3;SG;POS;DECL
altını çizmek	altını çizmez miymişsin	V;INFR;PRS;HAB;2;SG;NEG;INTR
insanımsı	insanımsınızdan	N;ABL;SG;PSS2P
kaynaşmak	kaynaşıyor olmamalı mıymışsın	V;OBLIG;INFR;PRS;PROG;2;SG;NEG;INTR
salmak	salıyor olmayacaktık	V;IND;PST;PROSP+PROG;1;PL;NEG;DECL
ermek	ermemiştin	V;INFR;PST;PFV;2;SG;NEG;DECL
duş almak	duş almamışmış	V;INFR;LGSPEC1;PST;3;SG;NEG;DECL
ülke	ülkeyiz	N;ARGNO1P;SG;PRS
ulumak	ulumaz mıydınız	V;IND;PST;HAB;2;PL;NEG;INTR
boşalmak	boşalmışmışsın	V;INFR;LGSPEC1;PST;2;SG;POS;DECL
zartayı çekmek	zartayı çekmiş olacaksın	V;INFR;FUT;PFV;2;SG;POS;DECL
uğratılmak	uğratılıyor olmalı mıyım	V;OBLIG;PRS;PROG;1;SG;INTR;POS
küçülmek	küçülecekmişsiniz	V;INFR;FUT;2;PL;POS;DECL
senaryo	senaryolarını	N;ACC;PL;PSS2S
dönmek	dönmüş olacaklar mıydı	V;INFR;PST;PROSP;3;PL;INTR;POS
diremek	diredin	V;IND;PST;2;SG;POS;DECL
nefes aldırtmak	nefes aldırtmalı mıymışım	V;OBLIG;INFR;PST;1;SG;INTR;POS
silmek	silecek olmayacakmış	V;INFR;FUT;PROSP;3;SG;NEG;DECL
doğramak	doğraacak olmayacak mıymış	V;INFR;FUT;PROSP;3;SG;NEG;INTR
kirletmek	kirletiyorlardı	V;IND;PST;PROG;3;PL;POS;DECL
ölçülmek	ölçülecek olmayacak mıymışım	V;INFR;FUT;PROSP;1;SG;NEG;INTR
çıngırağı çekmek	çıngırağı çekmemişlerdi	V;INFR;PST;PFV;3;PL;NEG;DECL
yağlamak	yağlamayacakmışsın	V;INFR;FUT;2;SG;NEG;DECL
programlattırmak	programlattıracağım	V;IND;FUT;1;SG;POS;DECL
kamçı	kamçılarınızdan	N;ABL;PL;PSS2P
makara	makaralarda	N;LOC;PL
koklamak	kokluyor olmazlardı	V;IND;PST;HAB+PROG;3;PL;NEG;DECL
seçilmek	seçilmeyecekti	V;IND;PST;PROSP;3;SG;NEG;DECL
Türkçeleştirmek	Türkçeleştirmezlerdi	V;IND;PST;HAB;3;PL;NEG;DECL
artçı deprem	artçı depremimizi	N;ACC;SG;PSS1P
attırmak	atırıyor olmayacaktım	V;IND;PST;PROSP+PROG;1;SG;NEG;DECL
yaptırmak	yaptırıyor olmayacakmışsın	V;INFR;FUT;PROG;2;SG;NEG;DECL
dağıtmak	dağıtmıştın	V;INFR;PST;PFV;2;SG;POS;DECL
kıymak	kıymayacak mısın	V;IND;FUT;2;SG;NEG;INTR
görmek	görmüyormuşsunuz	V;INFR;PRS;PROG;2;PL;NEG;DECL
öğretmek	öğretmiş olmayacak mıydık	V;INFR;PST;PROSP;1;PL;NEG;INTR
yaymak	yaymameli	V;OBLIG;PRS;3;SG;NEG;DECL
şişmek	şişiyor olmayacaktınız	V;IND;PST;PROSP+PROG;2;PL;NEG;DECL
sattırmak	sattırmalıymış	V;OBLIG;INFR;PST;3;SG;POS;DECL
parlatmak	parlatıyor olmalıymışız	V;OBLIG;INFR;PRS;PROG;1;PL;POS;DECL
yıldırım	yıldırımının	N;GEN;SG;PSS3S
sekmek	sekmiş olacak mısınız	V;INFR;FUT;PFV;2;PL;INTR;POS
üzmek	üzmemişmişsin	V;INFR;LGSPEC1;PST;2;SG;NEG;DECL
otuz bir çekmek	otuz bir çekiyor olmalılardı	V;OBLIG;PST;PROG;3;PL;POS;DECL
yağlayıcı	yağlayıcılarının	N;GEN;PL;PSS2S
bunamak	bunamamışlar mıydı	V;INFR;PST;PFV;3;PL;NEG;INTR
sosis	sosisin	N;GEN;SG
halk	halkında	N;LOC;SG;PSS2S
tutuşturmak	tutuşturacak olacak mıymışız	V;INFR;FUT;PROSP;1;PL;INTR;POS
vurmak	vurdum	V;IND;PST;1;SG;POS;DECL
bağlamak	bağlıyor olmazlar mıydı	V;IND;PST;HAB+PROG;3;PL;NEG;INTR
kuyumcu	kuyumcumuzdan	N;ABL;SG;PSS1P
melek	meleği	N;ACC;SG
basmak	basmış	V;INFR;PST;3;SG;POS;DECL
aldırtmamak	aldırtırmacak olmayacaksınız	V;IND;FUT;PROSP;2;PL;NEG;DECL
çalmak	çalıyor olmazlar mıydı	V;IND;PST;HAB+PROG;3;PL;NEG;INTR
barışmak	barışmaz mısınız	V;IND;PRS;HAB;2;PL;NEG;INTR
veteriner	veterinerlermiş	N;ARGNO3S;PL;LGSPEC2
yapışmak	yapışmayacaktı	V;IND;PST;PROSP;3;SG;NEG;DECL
hareket etmek	hareket eder olacakmış	V;INFR;FUT;HAB;3;SG;POS;DECL
kılmak	kılıyor olmayacak	V;IND;FUT;PROG;3;SG;NEG;DECL
ittirtmek	ittirtmiyormuşuz	V;INFR;PRS;PROG;1;PL;NEG;DECL
elmas	elmasının	N;GEN;SG;PSS3S
geçmek	geçmezmişim	V;INFR;PRS;HAB;1;SG;NEG;DECL
aşık atmak	aşık atmayacakmışız	V;INFR;FUT;1;PL;NEG;DECL
süpürmek	süpürürlerdi	V;IND;PST;HAB;3;PL;POS;DECL
sıkmak	sıkmış olacak	V;INFR;FUT;PFV;3;SG;POS;DECL
ece	ecelermiş	N;ARGNO3P;PL;LGSPEC2
yetiştirmek	yetiştirecek olmayacak mıymışız	V;INFR;FUT;PROSP;1;PL;NEG;INTR
sahipli yazılım	sahipli yazılımınızda	N;LOC;SG;PSS2P
acıkmak	acıkıyor olmayacak mıydım	V;IND;PST;PROSP+PROG;1;SG;NEG;INTR
çürümek	çürümemeli miyim	V;OBLIG;PRS;1;SG;NEG;INTR
sığmak	sığmıyormuşum	V;INFR;PRS;PROG;1;SG;NEG;DECL
yoldurtmak	yoldurtmuşsunuz	V;INFR;PST;2;PL;POS;DECL
hastalanmak	hastalanıyor olacak	V;IND;FUT;PROG;3;SG;POS;DECL
gücenmek	gücenmeyeceksin	V;IND;FUT;2;SG;NEG;DECL
güvenmek	güvenmedik mi	V;IND;PST;1;PL;NEG;INTR
sunmak	sunmuyorlarmış	V;INFR;PRS;PROG;3;PL;NEG;DECL
beyit	beyitmişim	N;ARGNO1S;SG;LGSPEC2
seçmek	seçmezler	V;IND;PRS;HAB;3;PL;NEG;DECL
değiştirmek	değiştirmeyecek miyiz	V;IND;FUT;1;PL;NEG;INTR
soğumak	soğur olmayacakmış	V;INFR;FUT;HAB;3;SG;NEG;DECL
tekila	tekilalarını	N;ACC;PL;PSS3S
vakit	vakitte	N;LOC;SG
ettirmek	ettirmemişsiniz	V;INFR;PST;2;PL;NEG;DECL
programlatmak	programlatmış olmayacaklar	V;INFR;FUT;PFV;3;PL;NEG;DECL
geliştirmek	geliştirmeyecek miymiş	V;INFR;FUT;3;SG;NEG;INTR
vermek	vermeliler mi	V;OBLIG;PRS;3;PL;INTR;POS
komikleşmek	komikleşiyor olmalıymışım	V;OBLIG;INFR;PRS;PROG;1;SG;POS;DECL
karşılık	karşılığına	N;DAT;SG;PSS3S
yıldırım	yıldırımınızı	N;ACC;SG;PSS2P
şaşılmak	şaşılıyor olmamalılar	V;OBLIG;PRS;PROG;3;PL;NEG;DECL
takmak	takmamalı mıymışım	V;OBLIG;INFR;PST;1;SG;NEG;INTR
kaynaştırtmak	kaynaştırtıyor olmalıydın	V;OBLIG;PST;PROG;2;SG;POS;DECL
çevirmek	çeviriyor olmamalılar mı	V;OBLIG;PRS;PROG;3;PL;NEG;INTR
duş almak	duş alır olmayacak mıymışız	V;INFR;FUT;HAB;1;PL;NEG;INTR
kulağını bükmek	bükecek olacağız	V;IND;FUT;PROSP;1;PL;POS;DECL
silmek	silmiş olacağım	V;INFR;FUT;PFV;1;SG;POS;DECL
inmek	inmemişlerdi	V;INFR;PST;PFV;3;PL;NEG;DECL
öldürmek	öldürmüş müyüz	V;INFR;PST;1;PL;INTR;POS
yenilmek	yenilmiş olmayacak mıydın	V;INFR;PST;PROSP;2;SG;NEG;INTR
angut	angutları	N;NOM;PL;PSS3S
kullanılmak	kullanılmış olacaktı	V;INFR;PST;PROSP;3;SG;POS;DECL
coşmak	coştum mu	V;IND;PST;1;SG;INTR;POS
eğitmek	eğiteceksin	V;IND;FUT;2;SG;POS;DECL
alındırmak	alındırmışmışım	V;INFR;LGSPEC1;PST;1;SG;POS;DECL
göç	göçüne	N;DAT;SG;PSS3S
pisletmek	pisletiyor olmaz mıydı	V;IND;PST;HAB+PROG;3;SG;NEG;INTR
yormak	yoruyor olmayacaktım	V;IND;PST;PROSP+PROG;1;SG;NEG;DECL
yıpratmak	yıpratırım	V;IND;PRS;HAB;1;SG;POS;DECL
geçmiş	geçmişlerinizin	N;GEN;PL;PSS2P
kazmak	kazmış olacak mı	V;INFR;FUT;PFV;3;SG;INTR;POS
boğaz	boğazı	N;NOM;SG;PSS3S
arpa	arpalarımıza	N;DAT;PL;PSS1P
ıslık çalmak	ıslık çalıyorsun	V;IND;PRS;PROG;2;SG;POS;DECL
itilmek	itilmeli miydim	V;OBLIG;PST;1;SG;INTR;POS
dökmek	döker misiniz	V;IND;PRS;HAB;2;PL;INTR;POS
ovmak	ovmuyor muydunuz	V;IND;PST;PROG;2;PL;NEG;INTR
yıkmak	yıkmış olacaktım	V;INFR;PST;PROSP;1;SG;POS;DECL
ikiz	ikiz	N;NOM;SG
sonuç	sonuçtu	N;ARGNO3S;SG;PST
temizlemek	temizlemiş olacaklar mı	V;INFR;FUT;PFV;3;PL;INTR;POS
ekşitmek	ekşitiyorlar mıydı	V;IND;PST;PROG;3;PL;INTR;POS
enjeksiyon	enjeksiyonlarında	N;LOC;PL;PSS2S
yendirtmek	yendirtirsin	V;IND;PRS;HAB;2;SG;POS;DECL
ölüm	ölümdük	N;ARGNO1P;SG;PST
bitmek	bitmeyiz	V;IND;PRS;HAB;1;PL;NEG;DECL
bir avuç toprak olmak	bir avuç toprak olacağız	V;IND;FUT;1;PL;POS;DECL
döndürmek	döndürdüydün	V;IND;PST;PFV;2;SG;POS;DECL
abadi	abadiyi	N;ACC;SG
öfkelendirmek	öfkelendirmemiş miyiz	V;INFR;PST;1;PL;NEG;INTR
delirmek	deliriyor olacak mıymış	V;INFR;FUT;PROG;3;SG;INTR;POS
davranmak	davranmazlar mı	V;IND;PRS;HAB;3;PL;NEG;INTR
yabancı anahtar	yabancı anahtar	N;NOM;SG
olmazsa olmaz	olmazsa olmazlardan	N;ABL;PL
programlattırmak	programlattırmamalı mıydın	V;OBLIG;PST;2;SG;NEG;INTR
değiştirmek	değiştirecek olacakmışım	V;INFR;FUT;PROSP;1;SG;POS;DECL
kısmak	kısmazdım	V;IND;PST;HAB;1;SG;NEG;DECL
aktör	aktörlerden	N;ABL;PL
oğlancı	oğlancımız	N;NOM;SG;PSS1P
eylem	eylemleri	N;ACC;PL
sakin	sakinimizin	N;GEN;SG;PSS1P
vurmak	vurmamışmışım	V;INFR;LGSPEC1;PST;1;SG;NEG;DECL
sunmak	sunuyor olacaklar	V;IND;FUT;PROG;3;PL;POS;DECL
anmak	anacak mıydınız	V;IND;PST;PROSP;2;PL;INTR;POS
böğürtlen	böğürtlendi	N;ARGNO3S;SG;PST
kazanmak	kazanıyor olmayacaktın	V;IND;PST;PROSP+PROG;2;SG;NEG;DECL
bükmemek	büküyor olacaklar mı	V;IND;FUT;PROG;3;PL;INTR;POS
eşcinsel	eşcinsellerde	N;LOC;PL
delirmek	deliriyor olmalıymış	V;OBLIG;INFR;PRS;PROG;3;SG;POS;DECL
lord	lordlarımızın	N;GEN;PL;PSS1P
ağda yapmak	ağd yapacak olmayacak	V;IND;FUT;PROSP;3;SG;NEG;DECL
tıraş olmak	tıraş olmameliyim	V;OBLIG;PRS;1;SG;NEG;DECL
seçmek	seçmiş olmayacaksın	V;INFR;FUT;PFV;2;SG;NEG;DECL
anjiyografi	anjiyografisi	N;NOM;SG;PSS3S
programlanmak	programlanmam	V;IND;PRS;HAB;1;SG;NEG;DECL
gözden kaybolmak	gözden kayboluyor olmamalı mısın	V;OBLIG;PRS;PROG;2;SG;NEG;INTR
unutmak	unutur olmayacakmışsın	V;INFR;FUT;HAB;2;SG;NEG;DECL
satın almak	satın alırdınız	V;IND;PST;HAB;2;PL;POS;DECL
çevirmek	çeviriyor olmayacakmış	V;INFR;FUT;PROG;3;SG;NEG;DECL
dürtmek	dürtüyor olmazlar mıydı	V;IND;PST;HAB+PROG;3;PL;NEG;INTR
şapkacı	şapkacıymışsın	N;ARGNO2S;SG;LGSPEC2
yendirtmek	yendirtmiş olacaksınız	V;INFR;FUT;PFV;2;PL;POS;DECL
heyecanlandırmak	heyecanlandırıyor olmazdık	V;IND;PST;HAB+PROG;1;PL;NEG;DECL
tensör	tensörlerine	N;DAT;PL;PSS3S
sinirlendirmek	sinirlendiriyor olmalıymış	V;OBLIG;INFR;PRS;PROG;3;SG;POS;DECL
kibutz	kibutzlarımızı	N;ACC;PL;PSS1P
tanımak	tanımışlar mıydı	V;INFR;PST;PFV;3;PL;INTR;POS
seks yapmak	seks yapmeliyim	V;OBLIG;PRS;1;SG;POS;DECL
cevap vermek	cevap vermez mi	V;IND;PRS;HAB;3;SG;NEG;INTR
benzemek	benzemelilermiş	V;OBLIG;INFR;PST;3;PL;POS;DECL
soğan	soğanlarınız	N;NOM;PL;PSS2P
vurmak	vurmayacaklar	V;IND;FUT;3;PL;NEG;DECL
bildirmek	bildirmeliymişiz	V;OBLIG;INFR;PST;1;PL;POS;DECL
sıyırmak	sıyırmıyor muyuz	V;IND;PRS;PROG;1;PL;NEG;INTR
satılmak	satılmamışmışsınız	V;INFR;LGSPEC1;PST;2;PL;NEG;DECL
tümce	tümcelerdik	N;ARGNO1P;PL;PST
aldırtmak	aldırtıyor olmamalılarmış	V;OBLIG;INFR;PRS;PROG;3;PL;NEG;DECL
değişmek	değişmiş olmayacak mıyız	V;INFR;FUT;PFV;1;PL;NEG;INTR
nöron	nöronlarında	N;LOC;PL;PSS2S
parabol	parabollerinde	N;LOC;PL;PSS3S
sanmak	sanmamalı mıydınız	V;OBLIG;PST;2;PL;NEG;INTR
kısmak	kısmamalılar mıydı	V;OBLIG;PST;3;PL;NEG;INTR
ehemmiyetlilik	ehemmiyetliliklerin	N;GEN;PL
uçmak	uçardın	V;IND;PST;HAB;2;SG;POS;DECL
ilklendirmek	ilklendirecek olacakmışım	V;INFR;FUT;PROSP;1;SG;POS;DECL
kuvvet	kuvvettik	N;ARGNO1P;SG;PST
kılmak	kılacak mı	V;IND;FUT;3;SG;INTR;POS
uyanmak	uyanıyor olmamalılar	V;OBLIG;PRS;PROG;3;PL;NEG;DECL
mutfak	mutfaklardan	N;ABL;PL
kurtarmak	kurtardıydınız	V;IND;PST;PFV;2;PL;POS;DECL
yıpranmak	yıpranıyormuşum	V;INFR;PRS;PROG;1;SG;POS;DECL
zurna	zurnanızı	N;ACC;SG;PSS2P
âşık olmak	âşık olmamalıydık	V;OBLIG;PST;1;PL;NEG;DECL
gebermek	geberir olmayacaklar mıymış	V;INFR;FUT;HAB;3;PL;NEG;INTR
portakal	portakallarınızdan	N;ABL;PL;PSS2P
belde	beldelerinde	N;LOC;PL;PSS3S
dirilmek	diriliyor olmayacaklarmış	V;INFR;FUT;PROG;3;PL;NEG;DECL
taklit	taklitlerinden	N;ABL;PL;PSS3S
üzüm	üzümlerini	N;ACC;PL;PSS2S
cavlağı çekmek	cavlağı çekmez miydin	V;IND;PST;HAB;2;SG;NEG;INTR
bunamak	bunamış olmayacaksın	V;INFR;FUT;PFV;2;SG;NEG;DECL
kerpiç	kerpicinize	N;DAT;SG;PSS2P
gerinmek	gerinecek miydin	V;IND;PST;PROSP;2;SG;INTR;POS
ekşitmek	ekşitmiş olmayacaktım	V;INFR;PST;PROSP;1;SG;NEG;DECL
çizmek	çizmiyor musunuz	V;IND;PRS;PROG;2;PL;NEG;INTR
klitoris	klitorislerini	N;ACC;PL;PSS3S
takmak	takmadılar mıydı	V;IND;PST;PFV;3;PL;NEG;INTR
enflasyon	enflasyonun	N;GEN;SG
onarmak	onarmamış mıyız	V;INFR;PST;1;PL;NEG;INTR
alyan	alyanlarınızı	N;ACC;PL;PSS2P
göçmek	göçmüş olmayacaktınız	V;INFR;PST;PROSP;2;PL;NEG;DECL
geyik	geyiğine	N;DAT;SG;PSS2S
katmak	katıyor olacak mı	V;IND;FUT;PROG;3;SG;INTR;POS
büktürtmemek	büktürtüyecektiniz	V;IND;PST;PROSP;2;PL;POS;DECL
kapamak	kapamadı mıydım	V;IND;PST;PFV;1;SG;NEG;INTR
yırtmak	yırtıyor olmayacaklarmış	V;INFR;FUT;PROG;3;PL;NEG;DECL
gütmek	güder misin	V;IND;PRS;HAB;2;SG;INTR;POS
kurtarmak	kurtarmak	V;NFIN
yuva	yuvasını	N;ACC;SG;PSS3S
afiyet	afiyetinize	N;DAT;SG;PSS2P
yığmak	yığacak olmayacak mıymışsın	V;INFR;FUT;PROSP;2;SG;NEG;INTR
yaymak	yaydı mıydı	V;IND;PST;PFV;3;SG;INTR;POS
rahmetli olmak	rahmetli olmamalılar mıymış	V;OBLIG;INFR;PST;3;PL;NEG;INTR
dilmek	diler olmayacak mıymış	V;INFR;FUT;HAB;3;SG;NEG;INTR
sanmak	sanacaklar mı	V;IND;FUT;3;PL;INTR;POS
süzmek	süzmüş olacaktım	V;INFR;PST;PROSP;1;SG;POS;DECL
dadanmak	dadanıyor olacak mıymış	V;INFR;FUT;PROG;3;SG;INTR;POS
cimcime	cimcimemizden	N;ABL;SG;PSS1P
canlanmak	canlanmıyormuşsunuz	V;INFR;PRS;PROG;2;PL;NEG;DECL
bitmek	bitiyor olmalısın	V;OBLIG;PRS;PROG;2;SG;POS;DECL
akrobat	akrobatına	N;DAT;SG;PSS3S
firavun	firavunlarına	N;DAT;PL;PSS2S
genel bilgi	genel bilgilerinden	N;ABL;PL;PSS3S
âşık olmak	âşık olmayacak mıydım	V;IND;PST;PROSP;1;SG;NEG;INTR
hareket etmek	hareket etmiş olacak mısınız	V;INFR;FUT;PFV;2;PL;INTR;POS
yardımseverlik	yardımseverliklerimizden	N;ABL;PL;PSS1P
Kopenhaglı	Kopenhaglılarımızı	N;ACC;PL;PSS1P
mıh	mıhlarınızda	N;LOC;PL;PSS2P
yolunmak	yolunacak olacağım	V;IND;FUT;PROSP;1;SG;POS;DECL
bütünleşmek	bütünleşecek miydin	V;IND;PST;PROSP;2;SG;INTR;POS
kılmak	kılmış olmayacaktı	V;INFR;PST;PROSP;3;SG;NEG;DECL
ortak	ortaklar	N;ARGNO3P;SG;PRS
öfkelendirmek	öfkelendirmez miydin	V;IND;PST;HAB;2;SG;NEG;INTR
toplamak	topluyor olmalıydık	V;OBLIG;PST;PROG;1;PL;POS;DECL
dedikodu yapmak	dedikodu yapıyor olacak mıydık	V;IND;PST;PROSP+PROG;1;PL;INTR;POS
büktürülmek	büktürülmediydin	V;IND;PST;PFV;2;SG;NEG;DECL
fakirleştirmek	fakirleştirmiş olacak mıydık	V;INFR;PST;PROSP;1;PL;INTR;POS
eğitmek	eğitiyormuşsunuz	V;INFR;PRS;PROG;2;PL;POS;DECL
başarmak	başarmayacak mıymış	V;INFR;FUT;3;SG;NEG;INTR
seçme	seçmenizden	N;ABL;SG;PSS2P
bekletmek	bekletiyor olmamalı mıymışsınız	V;OBLIG;INFR;PRS;PROG;2;PL;NEG;INTR
kurutmak	kurutmuş olmayacak mıydı	V;INFR;PST;PROSP;3;SG;NEG;INTR
savunmak	savunmamalı mıydı	V;OBLIG;PST;3;SG;NEG;INTR
gebermek	gebermiyor muyuz	V;IND;PRS;PROG;1;PL;NEG;INTR
şaşırttırmak	şaşırttırmaz mıydın	V;IND;PST;HAB;2;SG;NEG;INTR
azmak	azmazmışsın	V;INFR;PRS;HAB;2;SG;NEG;DECL
sararmak	sararmıştım	V;INFR;PST;PFV;1;SG;POS;DECL
tepmek	tepiyor olmayacaktı	V;IND;PST;PROSP+PROG;3;SG;NEG;DECL
akrep	akreplerinden	N;ABL;PL;PSS2S
tayfa	tayfalarmışsınız	N;ARGNO2P;PL;LGSPEC2
alet	aletlerinde	N;LOC;PL;PSS3S
deyn	deynlerden	N;ABL;PL
verdirmek	verdirecekmişsin	V;INFR;FUT;2;SG;POS;DECL
bilemek	biliyor olmamalı mısın	V;OBLIG;PRS;PROG;2;SG;NEG;INTR
balık	balığın	N;NOM;SG;PSS2S
yonga	yongalarınızdan	N;ABL;PL;PSS2P
cevap vermek	cevap veriyor olmamalısınız	V;OBLIG;PRS;PROG;2;PL;NEG;DECL
fil	fillerinden	N;ABL;PL;PSS3S
deli	delinizde	N;LOC;SG;PSS2P
buharlaşmak	buharlaşıyor olmazdım	V;IND;PST;HAB+PROG;1;SG;NEG;DECL
spam	spamının	N;GEN;SG;PSS2S
seks yapmak	seks yapıyor olmayacak mıymışım	V;INFR;FUT;PROG;1;SG;NEG;INTR
kara tahta	kara tahtalarının	N;GEN;PL;PSS2S
yummak	yumdu muydum	V;IND;PST;PFV;1;SG;INTR;POS
dönüş	dönüşlerin	N;GEN;PL
örmek	örmeyecekler miydi	V;IND;PST;PROSP;3;PL;NEG;INTR
sattırmak	sattırır olacakmış	V;INFR;FUT;HAB;3;SG;POS;DECL
nefes aldırmak	nefes aldıracak olmayacakmışsınız	V;INFR;FUT;PROSP;2;PL;NEG;DECL
yıkmak	yıkıyorsunuz	V;IND;PRS;PROG;2;PL;POS;DECL
getirmek	getirir olmayacaklarmış	V;INFR;FUT;HAB;3;PL;NEG;DECL
can vermek	can veriyor olmalıymışım	V;OBLIG;INFR;PRS;PROG;1;SG;POS;DECL
zürafa	zürafalara	N;DAT;PL
atletik	atletik değildiler	ADJ;LGSPEC1;PST;3;PL;NEG;DECL
rahatsızlanmak	rahatsızlanmıyormuşuz	V;INFR;PRS;PROG;1;PL;NEG;DECL
fakülte	fakülteler	N;NOM;PL
kullanmak	kullanmış olacak mıyız	V;INFR;FUT;PFV;1;PL;INTR;POS
sayfa	sayfaların	N;NOM;PL;PSS2S
üstesinden gelmek	üstesinden geliyor olurdunuz	V;IND;PST;HAB+PROG;2;PL;POS;DECL
kerpeten	kerpetenini	N;ACC;SG;PSS2S
kullanmak	kullanıyor olacak mısınız	V;IND;FUT;PROG;2;PL;INTR;POS
bilemek	biliyor olmayacağım	V;IND;FUT;PROG;1;SG;NEG;DECL
kalamar	kalamardılar	N;ARGNO3P;SG;PST
öpmek	öper miydi	V;IND;PST;HAB;3;SG;INTR;POS
kızmak	kızıyor muydu	V;IND;PST;PROG;3;SG;INTR;POS
havlu atmak	havlu atıyor olmalılar mıydı	V;OBLIG;PST;PROG;3;PL;INTR;POS
yalamak	yalamamalıydık	V;OBLIG;PST;1;PL;NEG;DECL
tarihçi	tarihçilerdik	N;ARGNO1P;PL;PST
utandırmak	utandıracak mıymışız	V;INFR;FUT;1;PL;INTR;POS
dürmek	dürmemelisiniz	V;OBLIG;PRS;2;PL;NEG;DECL
bakir	bakirlerimizi	N;ACC;PL;PSS1P
sürtmek	sürtmüş olacaktık	V;INFR;PST;PROSP;1;PL;POS;DECL
uyarmak	uyarmayacaktın	V;IND;PST;PROSP;2;SG;NEG;DECL
ateşe vermek	ateşe verecek olacak mıymışız	V;INFR;FUT;PROSP;1;PL;INTR;POS
gönül	gönlünün	N;GEN;SG;PSS3S
yendirmek	yendirmiyor musun	V;IND;PRS;PROG;2;SG;NEG;INTR
ilklendirmek	ilklendirmiş olmayacağız	V;INFR;FUT;PFV;1;PL;NEG;DECL
kist	kistlerdin	N;ARGNO2S;PL;PST
saklamak	saklaacak olacaklarmış	V;INFR;FUT;PROSP;3;PL;POS;DECL
tanıtmak	tanıtmamalılarmış	V;OBLIG;INFR;PST;3;PL;NEG;DECL
içmek	içmelilerdi	V;OBLIG;PST;3;PL;POS;DECL
eşik	eşiklerimize	N;DAT;PL;PSS1P
yedirmek	yedirmiş olacaklardı	V;INFR;PST;PROSP;3;PL;POS;DECL
bitirmek	bitirmez miymişsin	V;INFR;PRS;HAB;2;SG;NEG;INTR
kaşımak	kaşıdıydım	V;IND;PST;PFV;1;SG;POS;DECL
sermek	sermez	V;IND;PRS;HAB;3;SG;NEG;DECL
kalkmak	kalkmış olmayacak mıydık	V;INFR;PST;PROSP;1;PL;NEG;INTR
taklit	taklidinden	N;ABL;SG;PSS3S
sabit disk	sabit diskimizi	N;ACC;SG;PSS1P
atışmak	atışıyor olmayacak mıymışsın	V;INFR;FUT;PROG;2;SG;NEG;INTR
germek	gerer olmayacakmışım	V;INFR;FUT;HAB;1;SG;NEG;DECL
tasarım	tasarıma	N;DAT;SG
kapamak	kapıyor olmamalıymış	V;OBLIG;INFR;PRS;PROG;3;SG;NEG;DECL
yedek	yedekler	N;ARGNO3P;SG;PRS
büyük	büyük değilmişler	ADJ;LGSPEC1;LGSPEC2;3;PL;NEG;DECL
uymak	uyar mıydınız	V;IND;PST;HAB;2;PL;INTR;POS
sığmak	sığıyor olmamalı mıydınız	V;OBLIG;PST;PROG;2;PL;NEG;INTR
türü	türün	N;NOM;SG;PSS2S
küsmek	küsüyor olmayacak mıymış	V;INFR;FUT;PROG;3;SG;NEG;INTR
boy ölçüşmek	boy ölçüşmüyorlar mıydı	V;IND;PST;PROG;3;PL;NEG;INTR
onamak	onamamışsınız	V;INFR;PST;2;PL;NEG;DECL
ayarlatmak	ayarlatmıyorduk	V;IND;PST;PROG;1;PL;NEG;DECL
aldırtmak	aldırtıyor olacak mıyız	V;IND;FUT;PROG;1;PL;INTR;POS
puan	puanında	N;LOC;SG;PSS3S
kaynaşmak	kaynaşıyor olmayacaktık	V;IND;PST;PROSP+PROG;1;PL;NEG;DECL
dizmek	dizmeyecekler miydi	V;IND;PST;PROSP;3;PL;NEG;INTR
kovmamak	kovayacak olacak	V;IND;FUT;PROSP;3;SG;POS;DECL
hülya	hülyadan	N;ABL;SG
katmak	katmış mıymışım	V;INFR;LGSPEC1;PST;1;SG;INTR;POS
doğramak	doğramak	V;NFIN
ekşimek	ekşimeli miydik	V;OBLIG;PST;1;PL;INTR;POS
sürüngen	sürüngenlerinde	N;LOC;PL;PSS3S
büyümek	büyümüyor muydunuz	V;IND;PST;PROG;2;PL;NEG;INTR
sığmak	sığıyor olmamalılar mıymış	V;OBLIG;INFR;PRS;PROG;3;PL;NEG;INTR
canlandırtılmak	canlandırtılacak mıyım	V;IND;FUT;1;SG;INTR;POS
içermek	içeriyor olacak mısınız	V;IND;FUT;PROG;2;PL;INTR;POS
vermek	verdiniz	V;IND;PST;2;PL;POS;DECL
yendirtmek	yendirtecekmişiz	V;INFR;FUT;1;PL;POS;DECL
eğitmek	eğitecektik	V;IND;PST;PROSP;1;PL;POS;DECL
gözden kaybolmak	gözden kayboluyor olmamalı mıydınız	V;OBLIG;PST;PROG;2;PL;NEG;INTR
geciktirmek	geciktirmez miyiz	V;IND;PRS;HAB;1;PL;NEG;INTR
şikâyet etmek	şikâyet edecek olmayacaksınız	V;IND;FUT;PROSP;2;PL;NEG;DECL
aynasız	aynasızı	N;NOM;SG;PSS3S
bayılmak	bayılıyor olmamalı mıyım	V;OBLIG;PRS;PROG;1;SG;NEG;INTR
açılmak	açılmadık	V;IND;PST;1;PL;NEG;DECL
bilemek	biler olacak mıymışız	V;INFR;FUT;HAB;1;PL;INTR;POS
üşümek	üşümüş olmayacak mısın	V;INFR;FUT;PFV;2;SG;NEG;INTR
birleştirtmek	birleştirtmemiş miydin	V;INFR;PST;PFV;2;SG;NEG;INTR
bıçaklamak	bıçaklıyor olmalı mıydık	V;OBLIG;PST;PROG;1;PL;INTR;POS
katılaşmak	katılaşacak olacaklar mı	V;IND;FUT;PROSP;3;PL;INTR;POS
teori	teorilerinizin	N;GEN;PL;PSS2P
gütmek	gütmüş olmayacak mısın	V;INFR;FUT;PFV;2;SG;NEG;INTR
nal	nalından	N;ABL;SG;PSS2S
kırıtmak	kırıtır olacakmışım	V;INFR;FUT;HAB;1;SG;POS;DECL
ip	iplerinin	N;GEN;PL;PSS3S
gözlemek	gözlememiş mi	V;INFR;PST;3;SG;NEG;INTR
kulağını bükmek	kulağını bükmüş olacaklardı	V;INFR;PST;PROSP;3;PL;POS;DECL
açılmak	açılıyordun	V;IND;PST;PROG;2;SG;POS;DECL
yanıt vermek	yanıt vermiş olacaklar mı	V;INFR;FUT;PFV;3;PL;INTR;POS
ortam	ortammışsınız	N;ARGNO2P;SG;LGSPEC2
uyarmak	uyarıyor olur muydum	V;IND;PST;HAB+PROG;1;SG;INTR;POS
peri	peri	N;ARGNO3S;SG;PRS
süsmek	süsmediydi	V;IND;PST;PFV;3;SG;NEG;DECL
bükülmek	bükülür müymüş	V;INFR;PRS;HAB;3;SG;INTR;POS
tepmek	tepiyor olur muyduk	V;IND;PST;HAB+PROG;1;PL;INTR;POS
karadul	karadullarda	N;LOC;PL
kaynaştırtılmak	kaynaştırtılmış olmayacak mıydım	V;INFR;PST;PROSP;1;SG;NEG;INTR
götten bacaklı	götten bacaklıları	N;ACC;PL
karar vermek	karar vermez miydik	V;IND;PST;HAB;1;PL;NEG;INTR
ellemek	elliyor olmalı	V;OBLIG;PRS;PROG;3;SG;POS;DECL
volkanizma	volkanizmanı	N;ACC;SG;PSS2S
şaşırmak	şaşırmış olmayacak mı	V;INFR;FUT;PFV;3;SG;NEG;INTR
öğretmek	öğretir olmayacakmış	V;INFR;FUT;HAB;3;SG;NEG;DECL
ölçtürtmek	ölçtürtüyor olacaksın	V;IND;FUT;PROG;2;SG;POS;DECL
dilmek	diliyor olmamalı mıymışsınız	V;OBLIG;INFR;PRS;PROG;2;PL;NEG;INTR
dövüşmek	dövüşmüşlermiş	V;INFR;LGSPEC1;PST;3;PL;POS;DECL
çiçe	çiçelermişsiniz	N;ARGNO2P;PL;LGSPEC2
kovulmak	kovuluyor olacak mıymışsın	V;INFR;FUT;PROG;2;SG;INTR;POS
el sıkışmak	el sıkıştıydım	V;IND;PST;PFV;1;SG;POS;DECL
inmek	iner miydim	V;IND;PST;HAB;1;SG;INTR;POS
köpürtmek	köpürtmüşmüş	V;INFR;LGSPEC1;PST;3;SG;POS;DECL
taşımak	taşıyor olmalı mısınız	V;OBLIG;PRS;PROG;2;PL;INTR;POS
şaşırttırmak	şaşırttırmazlar	V;IND;PRS;HAB;3;PL;NEG;DECL
tekfur	tekfurlarında	N;LOC;PL;PSS3S
dağılmak	dağılıyorsun	V;IND;PRS;PROG;2;SG;POS;DECL
birleşme	birleşmelerin	N;NOM;PL;PSS2S
dövmek	dövmemişsin	V;INFR;PST;2;SG;NEG;DECL
göbek dansı	göbek danslarında	N;LOC;PL
final	finallerinden	N;ABL;PL;PSS2S
deli	deliyim	N;ARGNO1S;SG;PRS
utandırmak	utandırmazdım	V;IND;PST;HAB;1;SG;NEG;DECL
yapılmak	yapılmış olmayacağız	V;INFR;FUT;PFV;1;PL;NEG;DECL
kusmak	kusuyor olacak mıyız	V;IND;FUT;PROG;1;PL;INTR;POS
seçilmek	seçiliyor olmalı mıyım	V;OBLIG;PRS;PROG;1;SG;INTR;POS
ölümsüzleştirmek	ölümsüzleştirecekler	V;IND;FUT;3;PL;POS;DECL
birleştirmek	birleştiriyor olmayacakmışsın	V;INFR;FUT;PROG;2;SG;NEG;DECL
şaşırttırmak	şaşırttırmalıydınız	V;OBLIG;PST;2;PL;POS;DECL
değirmen	değirmeninizde	N;LOC;SG;PSS2P
öfkelendirmek	öfkelendiriyorlardı	V;IND;PST;PROG;3;PL;POS;DECL
gebermek	geberiyor olmazdık	V;IND;PST;HAB+PROG;1;PL;NEG;DECL
imrenmek	imreniyor olacaktınız	V;IND;PST;PROSP+PROG;2;PL;POS;DECL
çap	çapından	N;ABL;SG;PSS3S
acıktırmak	acıktırmıyormuş	V;INFR;PRS;PROG;3;SG;NEG;DECL
donatım	donatıma	N;DAT;SG
oturmak	oturmazdık	V;IND;PST;HAB;1;PL;NEG;DECL
bürümek	bürümeyecek miydin	V;IND;PST;PROSP;2;SG;NEG;INTR
solumak	solumuştunuz	V;INFR;PST;PFV;2;PL;POS;DECL
erimek	erir olmayacak mıymışsın	V;INFR;FUT;HAB;2;SG;NEG;INTR
öldürtmek	öldürtmüş müymüşsün	V;INFR;LGSPEC1;PST;2;SG;INTR;POS
ateş	ateşlerimizden	N;ABL;PL;PSS1P
ispatlamak	ispatlamadım mı	V;IND;PST;1;SG;NEG;INTR
heyecanlandırtmak	heyecanlandırtmayacaklar	V;IND;FUT;3;PL;NEG;DECL
vurmak	vurmamalı mıymışım	V;OBLIG;INFR;PST;1;SG;NEG;INTR
serpmek	serpecek olmayacakmışsınız	V;INFR;FUT;PROSP;2;PL;NEG;DECL
termometre	termometrelerini	N;ACC;PL;PSS3S
getirmek	getiriyor muydun	V;IND;PST;PROG;2;SG;INTR;POS
gülmek	gülmüştü	V;INFR;PST;PFV;3;SG;POS;DECL
tanışmak	tanışmalı mıymışsınız	V;OBLIG;INFR;PST;2;PL;INTR;POS
kirletmek	kirletiyor olmalıyım	V;OBLIG;PRS;PROG;1;SG;POS;DECL
kazmak	kazmamış mıydı	V;INFR;PST;PFV;3;SG;NEG;INTR
kulağını bükmek	kulağını bükmeli miydi	V;OBLIG;PST;3;SG;INTR;POS
varmak	varıyor olmazdınız	V;IND;PST;HAB+PROG;2;PL;NEG;DECL
arınmak	arınırdın	V;IND;PST;HAB;2;SG;POS;DECL
seksi	seksiydim	ADJ;LGSPEC1;PST;1;SG;POS;DECL
giymek	giymediydi	V;IND;PST;PFV;3;SG;NEG;DECL
dilmek	diliyor olacaklar mıymış	V;INFR;FUT;PROG;3;PL;INTR;POS
final sınıf	final sınıfı	N;NOM;SG;PSS3S
yenici deyim	yenici deyimleri	N;NOM;PL;PSS3S
süzgeç	süzgecimizden	N;ABL;SG;PSS1P
kırılmak	kırılırdım	V;IND;PST;HAB;1;SG;POS;DECL
dehşet	dehşetlerinizde	N;LOC;PL;PSS2P
ikizkenar yamuk	ikizkenar yamuklara	N;DAT;PL
gizlenmek	gizleniyor olacaktınız	V;IND;PST;PROSP+PROG;2;PL;POS;DECL
eğilmek	eğilir miymişsin	V;INFR;PRS;HAB;2;SG;INTR;POS
makyaj yapmak	makyaj yapmış olacaktık	V;INFR;PST;PROSP;1;PL;POS;DECL
çan	çanmışız	N;ARGNO1P;SG;LGSPEC2
yıkmak	yıkacaksınız	V;IND;FUT;2;PL;POS;DECL
bekletmek	bekletmeliydin	V;OBLIG;PST;2;SG;POS;DECL
uç	uç	N;ARGNO3S;SG;PRS
koca	kocaydınız	N;ARGNO2P;SG;PST
çimke	çimkelerde	N;LOC;PL
kırılmak	kırılıyor olmalılar	V;OBLIG;PRS;PROG;3;PL;POS;DECL
kullanıcı	kullanıcılar	N;NOM;PL
durmak	durmayacaktınız	V;IND;PST;PROSP;2;PL;NEG;DECL
dilmek	dilmeyecekmiş	V;INFR;FUT;3;SG;NEG;DECL
mortoyu çekmek	mortoyu çekmiş olmayacak mısın	V;INFR;FUT;PFV;2;SG;NEG;INTR
sanat	sanatlar	N;NOM;PL
verdirtmek	verdirtiyor olurdunuz	V;IND;PST;HAB+PROG;2;PL;POS;DECL
yolmak	yolmuyor muyduk	V;IND;PST;PROG;1;PL;NEG;INTR
ölmek	ölüyor musun	V;IND;PRS;PROG;2;SG;INTR;POS
deşmek	deşmeli misin	V;OBLIG;PRS;2;SG;INTR;POS
bölmek	bölmüyor muyduk	V;IND;PST;PROG;1;PL;NEG;INTR
kehribar	kehribarımız	N;NOM;SG;PSS1P
binek	bineklerinden	N;ABL;PL;PSS3S
küçülmek	küçülmedim	V;IND;PST;1;SG;NEG;DECL
programlanmak	programlanıyor olmalı mıymışız	V;OBLIG;INFR;PRS;PROG;1;PL;INTR;POS
dizmek	dizmeyecekmişim	V;INFR;FUT;1;SG;NEG;DECL
seks yapmak	seks yaptı mıydım	V;IND;PST;PFV;1;SG;INTR;POS
ölçmek	ölçmüş olacak mıydım	V;INFR;PST;PROSP;1;SG;INTR;POS
pusmak	pusuyor olmamalıyız	V;OBLIG;PRS;PROG;1;PL;NEG;DECL
canlandırmak	canlandırmış olacak mıyız	V;INFR;FUT;PFV;1;PL;INTR;POS
kötüleştirmek	kötüleştirecek olacaklar mı	V;IND;FUT;PROSP;3;PL;INTR;POS
sınırlı integral	sınırlı integralleri	N;NOM;PL;PSS3S
süt sağmak	süt sağmış olmayacak mı	V;INFR;FUT;PFV;3;SG;NEG;INTR
utanmak	utanmayın	V;IMP;2;PL;NEG;DECL
hindi	hindiyim	N;ARGNO1S;SG;PRS
fındık kırmak	fındık kırdım	V;IND;PST;1;SG;POS;DECL
erimek	erimemiş miymişim	V;INFR;LGSPEC1;PST;1;SG;NEG;INTR
birleşmek	birleşmeliydin	V;OBLIG;PST;2;SG;POS;DECL
manti	mantilerinizden	N;ABL;PL;PSS2P
katılaşmak	katılaşır mıydı	V;IND;PST;HAB;3;SG;INTR;POS
satılmak	satılmayacağım	V;IND;FUT;1;SG;NEG;DECL
bubi tuzağı	bubi tuzağı	N;NOM;SG
boşanmak	boşanıyor olacakmışsın	V;INFR;FUT;PROG;2;SG;POS;DECL
mefhum	mefhumlarınızdan	N;ABL;PL;PSS2P
düzeltmek	düzeltiyor olacaktın	V;IND;PST;PROSP+PROG;2;SG;POS;DECL
geciktirtmek	geciktirtmemiş miydim	V;INFR;PST;PFV;1;SG;NEG;INTR
bok	boklarından	N;ABL;PL;PSS2S
banliyö	banliyölerde	N;LOC;PL
kapamak	kapıyor olurdun	V;IND;PST;HAB+PROG;2;SG;POS;DECL
kuyumcu	kuyumcuda	N;LOC;SG
aşık olmak	aşık oluyor olmayacaklardı	V;IND;PST;PROSP+PROG;3;PL;NEG;DECL
rahatsızlanmak	rahatsızlanmıyor musun	V;IND;PRS;PROG;2;SG;NEG;INTR
kanıtlamak	kanıtlarlardı	V;IND;PST;HAB;3;PL;POS;DECL
toprak olmak	toprak oluyor olmalılarmış	V;OBLIG;INFR;PRS;PROG;3;PL;POS;DECL
açılmak	açılmış olacaksınız	V;INFR;FUT;PFV;2;PL;POS;DECL
entrika	entrikanda	N;LOC;SG;PSS2S
dağıtmak	dağıtıyor olmamalı mıydı	V;OBLIG;PST;PROG;3;SG;NEG;INTR
torun	torunun	N;GEN;SG
yöre	yöremizde	N;LOC;SG;PSS1P
cemaat	cemaatine	N;DAT;SG;PSS2S
heyecanlanmak	heyecanlanırlardı	V;IND;PST;HAB;3;PL;POS;DECL
saldırmak	saldırırdım	V;IND;PST;HAB;1;SG;POS;DECL
çökerti	çökertimizin	N;GEN;SG;PSS1P
dize gelmek	dize gelirmiş	V;INFR;PRS;HAB;3;SG;POS;DECL
istemek	istedim	V;IND;PST;1;SG;POS;DECL
aşmak	aşıyor muyduk	V;IND;PST;PROG;1;PL;INTR;POS
nalları dikmek	nalları dikmeli miyiz	V;OBLIG;PRS;1;PL;INTR;POS
dalgalandırmak	dalgalandırmazmışız	V;INFR;PRS;HAB;1;PL;NEG;DECL
yol	yolundan	N;ABL;SG;PSS2S
karpuz	karpuzundan	N;ABL;SG;PSS2S
mükemmel	mükemmel değil miymişsin?	ADJ;LGSPEC1;LGSPEC2;2;SG;NEG;INTR
yayıncılık	yayıncılığından	N;ABL;SG;PSS2S
yüzüncü	yüzüncülerin	N;NOM;PL;PSS2S
küçülmek	küçülmemeli miydiniz	V;OBLIG;PST;2;PL;NEG;INTR
canlandırtılmak	canlandırtılıyor olmayacak mıymışız	V;INFR;FUT;PROG;1;PL;NEG;INTR
korse	korsemizin	N;GEN;SG;PSS1P
albüm	albümün	N;GEN;SG
kuyan	kuyanlarını	N;ACC;PL;PSS2S
sararmak	sararmalı mıydın	V;OBLIG;PST;2;SG;INTR;POS
bilmek	biliyor mu	V;IND;PRS;PROG;3;SG;INTR;POS
canlanılmak	canlanılmış olacağız	V;INFR;FUT;PFV;1;PL;POS;DECL
hatır	hatırımız	N;NOM;SG;PSS1P
kötüleştirmek	kötüleştirmediydi	V;IND;PST;PFV;3;SG;NEG;DECL
öğütmek	öğütmezmişim	V;INFR;PRS;HAB;1;SG;NEG;DECL
açılır liste	açılır listemizi	N;ACC;SG;PSS1P
dirsek	dirsek	N;NOM;SG
alışmak	alışıyor olmayacak mıymışız	V;INFR;FUT;PROG;1;PL;NEG;INTR
deli	delilerinden	N;ABL;PL;PSS2S
boyamak	boyuyor olacakmışım	V;INFR;FUT;PROG;1;SG;POS;DECL
kanmak	kanmayacaktık	V;IND;PST;PROSP;1;PL;NEG;DECL
kurtarmak	kurtarmayacak mıymış	V;INFR;FUT;3;SG;NEG;INTR
inmek	inmeliydi	V;OBLIG;PST;3;SG;POS;DECL
süpürmek	süpürüyor olmalı mıymışım	V;OBLIG;INFR;PRS;PROG;1;SG;INTR;POS
akbaba	akbabanızın	N;GEN;SG;PSS2P
çubuk	çubuklarının	N;GEN;PL;PSS3S
bıkmak	bıktı mıydık	V;IND;PST;PFV;1;PL;INTR;POS
olay güdümlü programlama	olay güdümlü programlamanızı	N;ACC;SG;PSS2P
dolap çevirmek	dolap çevirir	V;IND;PRS;HAB;3;SG;POS;DECL
taşmak	taşacaktınız	V;IND;PST;PROSP;2;PL;POS;DECL
hapis	hapsinden	N;ABL;SG;PSS3S
düdük	düdük	N;NOM;SG
fındık kırmak	fındık kırıyor musunuz	V;IND;PRS;PROG;2;PL;INTR;POS
ellemek	ellemedi mi	V;IND;PST;3;SG;NEG;INTR
birleştirmek	birleştirdim	V;IND;PST;1;SG;POS;DECL
seyretmek	seyretir misiniz	V;IND;PRS;HAB;2;PL;INTR;POS
kaşımak	kaşımalı mıydık	V;OBLIG;PST;1;PL;INTR;POS
köpük bellek	köpük bellekleriniz	N;NOM;PL;PSS2P
kaçırmak	kaçırmış olacak	V;INFR;FUT;PFV;3;SG;POS;DECL
ombudsman	ombudsmanlardan	N;ABL;PL
tandır	tandırlardan	N;ABL;PL
şaşılmak	şaşılmış olmayacak mıyız	V;INFR;FUT;PFV;1;PL;NEG;INTR
yanardağ	yanardağımızda	N;LOC;SG;PSS1P
kovmamak	kovmamış olmayacaksınız	V;INFR;FUT;PFV;2;PL;NEG;DECL
buharlaşmak	buharlaşmış mıymışsın	V;INFR;LGSPEC1;PST;2;SG;INTR;POS
öküz	öküzünden	N;ABL;SG;PSS2S
dilmek	dilmedi miydi	V;IND;PST;PFV;3;SG;NEG;INTR
eğitmek	eğitmemeli miymişsin	V;OBLIG;INFR;PST;2;SG;NEG;INTR
ispatlamak	ispatlaacak olmayacakmışsın	V;INFR;FUT;PROSP;2;SG;NEG;DECL
orospu	orospuydular	N;ARGNO3P;SG;PST
çizmek	çizecekti	V;IND;PST;PROSP;3;SG;POS;DECL
dürmek	dürüyor muymuşsunuz	V;INFR;PRS;PROG;2;PL;INTR;POS
saldırmak	saldırmış olmayacak mısın	V;INFR;FUT;PFV;2;SG;NEG;INTR
cavlağı çekmek	cavlağı çekmemişlerdi	V;INFR;PST;PFV;3;PL;NEG;DECL
alev	alevimize	N;DAT;SG;PSS1P
halk	halklarınız	N;NOM;PL;PSS2P
getirmek	getiriyor olmalıymışız	V;OBLIG;INFR;PRS;PROG;1;PL;POS;DECL
savaşmak	savaşıyor olmazdı	V;IND;PST;HAB+PROG;3;SG;NEG;DECL
bürümek	bürüyor olmalı mıydın	V;OBLIG;PST;PROG;2;SG;INTR;POS
ebediyet	ebediyetlerimizin	N;GEN;PL;PSS1P
boyamak	boyamıyorsun	V;IND;PRS;PROG;2;SG;NEG;DECL
yağmak	yağmış olmayacak mıydın	V;INFR;PST;PROSP;2;SG;NEG;INTR
maşa	maşalarını	N;ACC;PL;PSS3S
öpüşmek	öpüşmemeliydik	V;OBLIG;PST;1;PL;NEG;DECL
pelikan	pelikanlarının	N;GEN;PL;PSS2S
kızlık	kızlıkları	N;ACC;PL
çarpmak	çarpıyor olmayacağız	V;IND;FUT;PROG;1;PL;NEG;DECL
dolamak	dolamışlar mıymış	V;INFR;LGSPEC1;PST;3;PL;INTR;POS
kalmak	kalacak mıymışsın	V;INFR;FUT;2;SG;INTR;POS
ayırmak	ayırmış olacaktım	V;INFR;PST;PROSP;1;SG;POS;DECL
düşmek	düşer olacak mıymış	V;INFR;FUT;HAB;3;SG;INTR;POS
savunmak	savunuyor olmayacaksın	V;IND;FUT;PROG;2;SG;NEG;DECL
güvenmek	güvenecek	V;IND;FUT;3;SG;POS;DECL
saymak	saymayacak mıydım	V;IND;PST;PROSP;1;SG;NEG;INTR
kusmak	kusacak olacak mıyım	V;IND;FUT;PROSP;1;SG;INTR;POS
zartayı çekmek	zartayı çekiyor olmalı mıymış	V;OBLIG;INFR;PRS;PROG;3;SG;INTR;POS
rüya	rüyalardık	N;ARGNO1P;PL;PST
cimcime	cimcimelerimizin	N;GEN;PL;PSS1P
helak olmak	helak olmeli miyim	V;OBLIG;PRS;1;SG;INTR;POS
vernikleme	verniklememizi	N;ACC;SG;PSS1P
atmamak	atmameliler	V;OBLIG;PRS;3;PL;POS;DECL
nokta	noktamıza	N;DAT;SG;PSS1P
kuyu	kuyumuzdan	N;ABL;SG;PSS1P
kıskanmak	kıskanıyor olacaktım	V;IND;PST;PROSP+PROG;1;SG;POS;DECL
güvenmek	güvenecek misin	V;IND;FUT;2;SG;INTR;POS
kötüleşmek	kötüleşmişler mi	V;INFR;PST;3;PL;INTR;POS
kaynamak	kaynaacak olmayacaklar mıymış	V;INFR;FUT;PROSP;3;PL;NEG;INTR
götürmek	götürmeyecektik	V;IND;PST;PROSP;1;PL;NEG;DECL
göçmek	göçmeyecek miymiş	V;INFR;FUT;3;SG;NEG;INTR
boğmak	boğmayacak mıymışım	V;INFR;FUT;1;SG;NEG;INTR
kısmak	kısmalı mıydık	V;OBLIG;PST;1;PL;INTR;POS
erimek	eriecek olacakmışsın	V;INFR;FUT;PROSP;2;SG;POS;DECL
boşalmak	boşalıyor muymuşum	V;INFR;PRS;PROG;1;SG;INTR;POS
etkilemek	etkileyecek olmayacaklar	V;IND;FUT;PROSP;3;PL;NEG;DECL
kullanmak	kullanmeliyiz	V;OBLIG;PRS;1;PL;POS;DECL
mikroişlemci	mikroişlemcilerinden	N;ABL;PL;PSS3S
serpmek	serpecek miyiz	V;IND;FUT;1;PL;INTR;POS
ülke	ülkenizi	N;ACC;SG;PSS2P
makarna	makarnanın	N;GEN;SG;PSS2S
binmek	biniyor olmamalı mıymış	V;OBLIG;INFR;PRS;PROG;3;SG;NEG;INTR
dövüşmek	dövüşmüş olmayacak mıydın	V;INFR;PST;PROSP;2;SG;NEG;INTR
örtmek	örtecek olacaksınız	V;IND;FUT;PROSP;2;PL;POS;DECL
susmak	susuyor olmayacaklar mıymış	V;INFR;FUT;PROG;3;PL;NEG;INTR
güvenmek	güvenmeyecek miymişsin	V;INFR;FUT;2;SG;NEG;INTR
kovmak	kovuyor olmamalıydın	V;OBLIG;PST;PROG;2;SG;NEG;DECL
çatmak	çatmayacak mıymışsın	V;INFR;FUT;2;SG;NEG;INTR
mucize	mucizelerinde	N;LOC;PL;PSS3S
Duşanbeli	Duşanbelisini	N;ACC;SG;PSS3S
seyretmek	seyretmiş mi	V;INFR;PST;3;SG;INTR;POS
yetişmek	yetişiyor muymuşsunuz	V;INFR;PRS;PROG;2;PL;INTR;POS
erkecel	erkecellermiş	N;ARGNO3S;PL;LGSPEC2
kötüleştirmek	kötüleştirmemiş miydim	V;INFR;PST;PFV;1;SG;NEG;INTR
keşfetmek	keşfediyor olur muydunuz	V;IND;PST;HAB+PROG;2;PL;INTR;POS
gözlemek	gözlerler	V;IND;PRS;HAB;3;PL;POS;DECL
yummak	yummuyordunuz	V;IND;PST;PROG;2;PL;NEG;DECL
katmak	katıyormuşum	V;INFR;PRS;PROG;1;SG;POS;DECL
kurtarmak	kurtarmamışlar mı	V;INFR;PST;3;PL;NEG;INTR
kovdurtmak	kovdurtuyor olacak	V;IND;FUT;PROG;3;SG;POS;DECL
dolap çevirmek	dolap çevirmeyeceksin	V;IND;FUT;2;SG;NEG;DECL
dua	duaların	N;GEN;PL
ermek	erdik mi	V;IND;PST;1;PL;INTR;POS
kaçmak	kaçıyor olmayacak mıyım	V;IND;FUT;PROG;1;SG;NEG;INTR
doymak	doyduk mu	V;IND;PST;1;PL;INTR;POS
kazanmak	kazanmıyor muydu	V;IND;PST;PROG;3;SG;NEG;INTR
atmamak	atmamalıymışsın	V;OBLIG;INFR;PST;2;SG;POS;DECL
üstesinden gelmek	üstesinden geliyor olmamalıymışım	V;OBLIG;INFR;PRS;PROG;1;SG;NEG;DECL
atmamak	atmamayacaksın	V;IND;FUT;2;SG;NEG;DECL
tavan	tavanımız	N;NOM;SG;PSS1P
kısmak	kısıyor olacak mıydı	V;IND;PST;PROSP+PROG;3;SG;INTR;POS
memleket	memleketiniz	N;NOM;SG;PSS2P
devinmek	deviniyor olmamalıydık	V;OBLIG;PST;PROG;1;PL;NEG;DECL
pop	popun	N;NOM;SG;PSS2S
ummak	ummuşlar mı	V;INFR;PST;3;PL;INTR;POS
fortlamak	fortluyor olmaz mıydınız	V;IND;PST;HAB+PROG;2;PL;NEG;INTR
düzeltmek	düzeltmişiz	V;INFR;PST;1;PL;POS;DECL
yedirtmek	yedirtmiş miydiniz	V;INFR;PST;PFV;2;PL;INTR;POS
dökmek	döktü müydünüz	V;IND;PST;PFV;2;PL;INTR;POS
çökelek	çökelekler	N;ARGNO3S;PL;PRS
acıktırtmak	acıktırtmıyorduk	V;IND;PST;PROG;1;PL;NEG;DECL
düşünmek	düşünmemeli misiniz	V;OBLIG;PRS;2;PL;NEG;INTR
sağmak	sağdın	V;IND;PST;2;SG;POS;DECL
cin	cindim	N;ARGNO1S;SG;PST
dağıtmak	dağıtır mıydı	V;IND;PST;HAB;3;SG;INTR;POS
bütünleşmek	bütünleşiyor muymuşsunuz	V;INFR;PRS;PROG;2;PL;INTR;POS
ısırmak	ısırdı mıydın	V;IND;PST;PFV;2;SG;INTR;POS
hıçkırık	hıçkırığının	N;GEN;SG;PSS2S
ilerletmek	ilerletmez miyiz	V;IND;PRS;HAB;1;PL;NEG;INTR
ortak	ortaklarım	N;ARGNO1S;PL;PRS
Hakk'ın rahmetine kavuşmak	Hakk'ın rahmetine kavuşmeliler	V;OBLIG;PRS;3;PL;POS;DECL
açmak	açıyor olur muyduk	V;IND;PST;HAB+PROG;1;PL;INTR;POS
ana fikir	ana fikirlerinin	N;GEN;PL;PSS2S
işitmek	işitiyor olurdum	V;IND;PST;HAB+PROG;1;SG;POS;DECL
onamak	onamayacak mıydı	V;IND;PST;PROSP;3;SG;NEG;INTR
kopmak	koptum mu	V;IND;PST;1;SG;INTR;POS
ders	derslerin	N;GEN;PL
kulağını bükmek	büküyor olur muydunuz	V;IND;PST;HAB+PROG;2;PL;INTR;POS
onarmak	onarıyor olmayacak mısın	V;IND;FUT;PROG;2;SG;NEG;INTR
doymak	doyar olacak mıymışım	V;INFR;FUT;HAB;1;SG;INTR;POS
diferansiyel denklem	diferansiyel denklemimizde	N;LOC;SG;PSS1P
içecek	içeceklerinde	N;LOC;PL;PSS3S
ateş	ateşinize	N;DAT;SG;PSS2P
üçlü	üçlüsünden	N;ABL;SG;PSS3S
kovdurtmak	kovdurtuyor olmamalı mıydı	V;OBLIG;PST;PROG;3;SG;NEG;INTR
çalar saat	çalar saatlerinizin	N;GEN;PL;PSS2P
çevirmek	çeviriyor olur muydum	V;IND;PST;HAB+PROG;1;SG;INTR;POS
ulumak	ulurlarmış	V;INFR;PRS;HAB;3;PL;POS;DECL
susmak	susmuş olacağız	V;INFR;FUT;PFV;1;PL;POS;DECL
acıtmak	acıtmış olacaktım	V;INFR;PST;PROSP;1;SG;POS;DECL
mevsim	mevsimlerin	N;GEN;PL
Türkçeleştirmek	Türkçeleştirmeliymiş	V;OBLIG;INFR;PST;3;SG;POS;DECL
süründürtmek	süründürtmemişim	V;INFR;PST;1;SG;NEG;DECL
kulağını bükmek	büküyor olmamalısınız	V;OBLIG;PRS;PROG;2;PL;NEG;DECL
battaniye	battaniyenin	N;GEN;SG;PSS2S
yolmak	yolmuşuz	V;INFR;PST;1;PL;POS;DECL
nedime	nedimenize	N;DAT;SG;PSS2P
Türkçeleştirmek	Türkçeleştiriyordun	V;IND;PST;PROG;2;SG;POS;DECL
yetişmek	yetişiyordu	V;IND;PST;PROG;3;SG;POS;DECL
uçmak	uçmayacak mıydın	V;IND;PST;PROSP;2;SG;NEG;INTR
minber	minberlerinde	N;LOC;PL;PSS2S
köpürmek	köpürmem	V;IND;PRS;HAB;1;SG;NEG;DECL
kanal	kanal	N;NOM;SG
sendrom	sendromda	N;LOC;SG
final	finalinden	N;ABL;SG;PSS3S
similya	similyalarına	N;DAT;PL;PSS3S
sikmek	sikmemiş miymişsiniz	V;INFR;LGSPEC1;PST;2;PL;NEG;INTR
taramak	tarıyor olacaktık	V;IND;PST;PROSP+PROG;1;PL;POS;DECL
yaklaşmak	yaklaştık	V;IND;PST;1;PL;POS;DECL
onarmak	onarmış olmayacak mıydım	V;INFR;PST;PROSP;1;SG;NEG;INTR
olmak	olmamış mısın	V;INFR;PST;2;SG;NEG;INTR
bitirtmek	bitirtmemeli	V;OBLIG;PRS;3;SG;NEG;DECL
alındırtmak	alındırtıyor olmamalı mıymışım	V;OBLIG;INFR;PRS;PROG;1;SG;NEG;INTR
askı	askınızdan	N;ABL;SG;PSS2P
dayamak	dayamamalı mıymışız	V;OBLIG;INFR;PST;1;PL;NEG;INTR
buharlaşmak	buharlaşacakmışız	V;INFR;FUT;1;PL;POS;DECL
final sınıf	final sınıfımızı	N;ACC;SG;PSS1P
parabol	parabollerinize	N;DAT;PL;PSS2P
saçmak	saçıyor olmamalı mısınız	V;OBLIG;PRS;PROG;2;PL;NEG;INTR
gidilmek	gidilmeyeceklermiş	V;INFR;FUT;3;PL;NEG;DECL
artmak	artmayacak mıydın	V;IND;PST;PROSP;2;SG;NEG;INTR
bitmek	bitecek olacak mıyım	V;IND;FUT;PROSP;1;SG;INTR;POS
savaş	savaşlara	N;DAT;PL
kırdırmak	kırdırmaz mıymışız	V;INFR;PRS;HAB;1;PL;NEG;INTR
doymak	doymuş muydunuz	V;INFR;PST;PFV;2;PL;INTR;POS
çar	çarının	N;GEN;SG;PSS2S
laço	laçolarında	N;LOC;PL;PSS2S
kurbağa	kurbağalarından	N;ABL;PL;PSS3S
el sıkışmak	el sıkıştın mı	V;IND;PST;2;SG;INTR;POS
uzunluk	uzunluğunuzdan	N;ABL;SG;PSS2P
salmak	salacaklar mıymış	V;INFR;FUT;3;PL;INTR;POS
öfkelendirmek	öfkelendirmiyordu	V;IND;PST;PROG;3;SG;NEG;DECL
birleştirmek	birleştirirlermiş	V;INFR;PRS;HAB;3;PL;POS;DECL
heyecanlandırmak	heyecanlandırır olacakmış	V;INFR;FUT;HAB;3;SG;POS;DECL
kırmak	kırmamıştı	V;INFR;PST;PFV;3;SG;NEG;DECL
bitirttirmek	bitirttirmezler mi	V;IND;PRS;HAB;3;PL;NEG;INTR
hiper bağ	hiper bağı	N;ACC;SG
sevişmek	sevişiyor olacak mı	V;IND;FUT;PROG;3;SG;INTR;POS
acıktırmak	acıktırmışmış	V;INFR;LGSPEC1;PST;3;SG;POS;DECL
el sıkışmak	el sıkışıyor olmalıydım	V;OBLIG;PST;PROG;1;SG;POS;DECL
programlatmak	programlatmış olacaktın	V;INFR;PST;PROSP;2;SG;POS;DECL
saydırtmak	saydırtıyor musun	V;IND;PRS;PROG;2;SG;INTR;POS
bitirttirmek	bitirttirmeyecek misin	V;IND;FUT;2;SG;NEG;INTR
aldırtmamak	aldırtmamamalı mıydın	V;OBLIG;PST;2;SG;NEG;INTR
kovulmak	kovulacak olacaklarmış	V;INFR;FUT;PROSP;3;PL;POS;DECL
itmek	itmiyorsun	V;IND;PRS;PROG;2;SG;NEG;DECL
onarmak	onarır olmayacakmışsınız	V;INFR;FUT;HAB;2;PL;NEG;DECL
kaşımak	kaşımamış mıyım	V;INFR;PST;1;SG;NEG;INTR
büktürtülmek	büktürtülecek olmayacak mıyım	V;IND;FUT;PROSP;1;SG;NEG;INTR
ayarlanmak	ayarlanmış olmayacaktık	V;INFR;PST;PROSP;1;PL;NEG;DECL
kontakt lens	kontakt lenslerimizde	N;LOC;PL;PSS1P
deşmek	deşiyorsun	V;IND;PRS;PROG;2;SG;POS;DECL
izlemek	izlemiş olmayacaktı	V;INFR;PST;PROSP;3;SG;NEG;DECL
sürünmek	sürünmez mi	V;IND;PRS;HAB;3;SG;NEG;INTR
havadan havaya füze	havadan havaya füzenin	N;GEN;SG;PSS2S
barışmak	barışmış olmayacak	V;INFR;FUT;PFV;3;SG;NEG;DECL
kanıtlamak	kanıtlar olacaklarmış	V;INFR;FUT;HAB;3;PL;POS;DECL
kıymet	kıymetin	N;NOM;SG;PSS2S
süt sağmak	süt sağacak olmayacak mıymışsınız	V;INFR;FUT;PROSP;2;PL;NEG;INTR
geciktirtmek	geciktirtiyor olmayacak mıyım	V;IND;FUT;PROG;1;SG;NEG;INTR
izlence	izlenceye	N;DAT;SG
bitirtmek	bitirtecekmişim	V;INFR;FUT;1;SG;POS;DECL
tabut	tabutlarını	N;ACC;PL;PSS2S
bir avuç toprak olmak	bir avuç toprak olmadı mıydık	V;IND;PST;PFV;1;PL;NEG;INTR
salmak	salıyor olacaklar mı	V;IND;FUT;PROG;3;PL;INTR;POS
âlem	âlemin	N;NOM;SG;PSS2S
özlem	özlemimizde	N;LOC;SG;PSS1P
vurmak	vuruyor olmalıydık	V;OBLIG;PST;PROG;1;PL;POS;DECL
doğmak	doğmuş olacak mıyım	V;INFR;FUT;PFV;1;SG;INTR;POS
soymak	soymazmışsınız	V;INFR;PRS;HAB;2;PL;NEG;DECL
itilmek	itilmiş olacak mıydı	V;INFR;PST;PROSP;3;SG;INTR;POS
tütmek	tütmediler miydi	V;IND;PST;PFV;3;PL;NEG;INTR
evlenmek	evlenirler miydi	V;IND;PST;HAB;3;PL;INTR;POS
açmak	açmamış mı	V;INFR;PST;3;SG;NEG;INTR
kararmak	kararacak olacaklar mı	V;IND;FUT;PROSP;3;PL;INTR;POS
kalkmak	kalkar mıymışız	V;INFR;PRS;HAB;1;PL;INTR;POS
ayarlatmak	ayarlatıyor olmamalı mıydınız	V;OBLIG;PST;PROG;2;PL;NEG;INTR
fındık kırmak	fındık kırıyor olmalı mıydın	V;OBLIG;PST;PROG;2;SG;INTR;POS
tıraş olmak	tıraş oldunuz	V;IND;PST;2;PL;POS;DECL
altını çizmek	altını çiziyor olur muydun	V;IND;PST;HAB+PROG;2;SG;INTR;POS
imrenmek	imrenmedik mi	V;IND;PST;1;PL;NEG;INTR
durmak	duruyor olmalı mıymışız	V;OBLIG;INFR;PRS;PROG;1;PL;INTR;POS
yalvarmak	yalvardı mıydın	V;IND;PST;PFV;2;SG;INTR;POS
şaşırtmak	şaşırtıyor olmamalısın	V;OBLIG;PRS;PROG;2;SG;NEG;DECL
bilgisayar korsanı	bilgisayar korsanlarını	N;ACC;PL
süt sağmak	süt sağıyor olmayacak mıymış	V;INFR;FUT;PROG;3;SG;NEG;INTR
yalamak	yalaacak olmayacakmışsınız	V;INFR;FUT;PROSP;2;PL;NEG;DECL
saydırtmak	saydırtmameli miyim	V;OBLIG;PRS;1;SG;NEG;INTR
bacanak	bacanaklarını	N;ACC;PL;PSS2S
programlatmak	programlatıyor olmamalı mıymışsınız	V;OBLIG;INFR;PRS;PROG;2;PL;NEG;INTR
savaşmak	savaşmaz mıymışım	V;INFR;PRS;HAB;1;SG;NEG;INTR
kurutmak	kurutmuyorlardı	V;IND;PST;PROG;3;PL;NEG;DECL
temsilci	temsilcilerdik	N;ARGNO1P;PL;PST
şamarlamak	şamarlayacak mı	V;IND;FUT;3;SG;INTR;POS
tıraş olmak	tıraş oluyor olmamalı mıymışsınız	V;OBLIG;INFR;PRS;PROG;2;PL;NEG;INTR
engizisyon	engizisyonlara	N;DAT;PL
sorumsuzluk	sorumsuzluklarınızın	N;GEN;PL;PSS2P
süt sağmak	süt sağmamışmış	V;INFR;LGSPEC1;PST;3;SG;NEG;DECL
sikişmek	sikişmeyecek miymişiz	V;INFR;FUT;1;PL;NEG;INTR
bağlamak	bağlıyor olmayacak mıyız	V;IND;FUT;PROG;1;PL;NEG;INTR
huzurlu	huzurlu değil miydim?	ADJ;LGSPEC1;PST;1;SG;NEG;INTR
yaratma	yaratmanızdan	N;ABL;SG;PSS2P
büktürülmek	büktürülmemişti	V;INFR;PST;PFV;3;SG;NEG;DECL
sağmak	sağıyor olmayacak mıydınız	V;IND;PST;PROSP+PROG;2;PL;NEG;INTR
yapışmak	yapışıyor olacaklardı	V;IND;PST;PROSP+PROG;3;PL;POS;DECL
sövmek	sövmeyecekler mi	V;IND;FUT;3;PL;NEG;INTR
dalgalandırmak	dalgalandıracak mısın	V;IND;FUT;2;SG;INTR;POS
aşık olmak	aşık oluyor olmazdı	V;IND;PST;HAB+PROG;3;SG;NEG;DECL
yerleşmek	yerleşmemeliymişsin	V;OBLIG;INFR;PST;2;SG;NEG;DECL
şive	şivemizin	N;GEN;SG;PSS1P
uyarmak	uyarıyor olmamalılar mıydı	V;OBLIG;PST;PROG;3;PL;NEG;INTR
bıkmak	bıkacak olmayacakmışız	V;INFR;FUT;PROSP;1;PL;NEG;DECL
yıkamak	yıkamamalılardı	V;OBLIG;PST;3;PL;NEG;DECL
yitmek	yitiyor olmamalısınız	V;OBLIG;PRS;PROG;2;PL;NEG;DECL
katılaşmak	katılaşacak olacakmışsın	V;INFR;FUT;PROSP;2;SG;POS;DECL
atıştırmak	atıştırmak	V;NFIN
kese	keselerimize	N;DAT;PL;PSS1P
batmak	batar olacak mıymışım	V;INFR;FUT;HAB;1;SG;INTR;POS
sıkmak	sıkacakmışsınız	V;INFR;FUT;2;PL;POS;DECL
dolmuş	dolmuşlardı	N;ARGNO3S;PL;PST
yıkamak	yıkıyor olmaz mıydık	V;IND;PST;HAB+PROG;1;PL;NEG;INTR
sızmak	sızacak olacak mıyım	V;IND;FUT;PROSP;1;SG;INTR;POS
hareket etmek	hareket etmedi miydik	V;IND;PST;PFV;1;PL;NEG;INTR
övmek	övüyor olacaklar	V;IND;FUT;PROG;3;PL;POS;DECL
hava atmak	hava atmadıydınız	V;IND;PST;PFV;2;PL;NEG;DECL
ölçmek	ölçmüştük	V;INFR;PST;PFV;1;PL;POS;DECL
dalgalanmak	dalgalanmayacaksınız	V;IND;FUT;2;PL;NEG;DECL
sekmek	sekmiştin	V;INFR;PST;PFV;2;SG;POS;DECL
sözcü	sözcülerimizi	N;ACC;PL;PSS1P
yoksullaştırmak	yoksullaştırıyorlar mıymış	V;INFR;PRS;PROG;3;PL;INTR;POS
kirletmek	kirletecek misin	V;IND;FUT;2;SG;INTR;POS
dağıtmak	dağıtacak olacak	V;IND;FUT;PROSP;3;SG;POS;DECL
bağlamak	bağlamamalı mıymışsınız	V;OBLIG;INFR;PST;2;PL;NEG;INTR
seks yapmak	seks yapıyor olacaklar	V;IND;FUT;PROG;3;PL;POS;DECL
yaklaşmak	yaklaştıydık	V;IND;PST;PFV;1;PL;POS;DECL
işemek	işiyor olacaktınız	V;IND;PST;PROSP+PROG;2;PL;POS;DECL
kesmek	kesiyor olmalılardı	V;OBLIG;PST;PROG;3;PL;POS;DECL
solumak	solumuyor musun	V;IND;PRS;PROG;2;SG;NEG;INTR
heyecanlanmak	heyecanlanıyor olacaklar mı	V;IND;FUT;PROG;3;PL;INTR;POS
yaymak	yaymamıştı	V;INFR;PST;PFV;3;SG;NEG;DECL
yarmak	yarıyor olacaktı	V;IND;PST;PROSP+PROG;3;SG;POS;DECL
similya	similyanı	N;ACC;SG;PSS2S
kopmak	kopar mıymışsın	V;INFR;PRS;HAB;2;SG;INTR;POS
kılmak	kılıyor olmalılar mıymış	V;OBLIG;INFR;PRS;PROG;3;PL;INTR;POS
bir avuç toprak olmak	bir avuç toprak oluyor olmaz mıydım	V;IND;PST;HAB+PROG;1;SG;NEG;INTR
tan	tanların	N;NOM;PL;PSS2S
Belgratlı	Belgratlılarmışsınız	N;ARGNO2P;PL;LGSPEC2
aramak	aramalılar mıymış	V;OBLIG;INFR;PST;3;PL;INTR;POS
altın	altını	N;NOM;SG;PSS3S
ilklendirmek	ilklendirdi mi	V;IND;PST;3;SG;INTR;POS
mekik	mekiklerinden	N;ABL;PL;PSS2S
vurmak	vuruyor olmalı mıydın	V;OBLIG;PST;PROG;2;SG;INTR;POS
yaklaşmak	yaklaşıyor olacakmışsın	V;INFR;FUT;PROG;2;SG;POS;DECL
meşrubat	meşrubatından	N;ABL;SG;PSS2S
yağlayıcı	yağlayıcımıza	N;DAT;SG;PSS1P
sikişmek	sikişiyordunuz	V;IND;PST;PROG;2;PL;POS;DECL
alem	alemimiz	N;NOM;SG;PSS1P
eskimek	eskimez miymişiz	V;INFR;PRS;HAB;1;PL;NEG;INTR
evlenmek	evlenir miydi	V;IND;PST;HAB;3;SG;INTR;POS
geliştirmek	geliştirmiş olacak	V;INFR;FUT;PFV;3;SG;POS;DECL
toplamak	toplamalıymışım	V;OBLIG;INFR;PST;1;SG;POS;DECL
onamak	onamayacaktınız	V;IND;PST;PROSP;2;PL;NEG;DECL
sinmek	sinmemiş miydik	V;INFR;PST;PFV;1;PL;NEG;INTR
katılaştırmak	katılaştırmamalı mıydım	V;OBLIG;PST;1;SG;NEG;INTR
heyecanlanmak	heyecanlanıyorlardı	V;IND;PST;PROG;3;PL;POS;DECL
süründürmek	süründürmelilerdi	V;OBLIG;PST;3;PL;POS;DECL
asmak	asmaz mıydın	V;IND;PST;HAB;2;SG;NEG;INTR
makyaj yapmak	makyaj yapmamalıydım	V;OBLIG;PST;1;SG;NEG;DECL
şaşılmak	şaşılıyor olmalı mıymışsınız	V;OBLIG;INFR;PRS;PROG;2;PL;INTR;POS
eskimek	eskimemiş misin	V;INFR;PST;2;SG;NEG;INTR
verdirtmek	verdirtecek olacakmışsın	V;INFR;FUT;PROSP;2;SG;POS;DECL
bıkmak	bıkacak olacak mıymışız	V;INFR;FUT;PROSP;1;PL;INTR;POS
bitirmek	bitirecek olacaklar mı	V;IND;FUT;PROSP;3;PL;INTR;POS
cibinlik	cibinliklerin	N;GEN;PL
kalıbı dinlendirmek	kalıbı dinlendirmeyecek miydin	V;IND;PST;PROSP;2;SG;NEG;INTR
kaside	kasidelerden	N;ABL;PL
kimlik	kimliğini	N;ACC;SG;PSS2S
kıl	kıllar	N;NOM;PL
irdelemek	irdeleyecek olmayacak mı	V;IND;FUT;PROSP;3;SG;NEG;INTR
uçmak	uçuyor olacaktık	V;IND;PST;PROSP+PROG;1;PL;POS;DECL
üşümek	üşüyor olmalısınız	V;OBLIG;PRS;PROG;2;PL;POS;DECL
değiştirmek	değiştirmediler miydi	V;IND;PST;PFV;3;PL;NEG;INTR
varmak	varmamalılarmış	V;OBLIG;INFR;PST;3;PL;NEG;DECL
acıktırmak	yaptırıyor olmayacağız	V;IND;FUT;PROG;1;PL;NEG;DECL
imrenmek	imrenmemiş miydi	V;INFR;PST;PFV;3;SG;NEG;INTR
damlamak	damlamıyor muymuş	V;INFR;PRS;PROG;3;SG;NEG;INTR
kızmak	kızmıyor muymuşsun	V;INFR;PRS;PROG;2;SG;NEG;INTR
hastalanmak	hastalanıyorlar	V;IND;PRS;PROG;3;PL;POS;DECL
aldırtmamak	aldırtmamıyorlar mıymış	V;INFR;PRS;PROG;3;PL;NEG;INTR
izlemek	izlemeli miydik	V;OBLIG;PST;1;PL;INTR;POS
kakmak	kakmıyormuş	V;INFR;PRS;PROG;3;SG;NEG;DECL
boşalmak	boşalıyor muydun	V;IND;PST;PROG;2;SG;INTR;POS
işlemek	işledi miydik	V;IND;PST;PFV;1;PL;INTR;POS
âşık olmak	âşık olmuş muymuş	V;INFR;LGSPEC1;PST;3;SG;INTR;POS
şamarlamak	şamarlamamış mıyız	V;INFR;PST;1;PL;NEG;INTR
büktürmek	büktürecekmişim	V;INFR;FUT;1;SG;POS;DECL
diri	diri değil miydiler?	ADJ;LGSPEC1;PST;3;PL;NEG;INTR
dövmek	dövüyor olmamalı mıymışsınız	V;OBLIG;INFR;PRS;PROG;2;PL;NEG;INTR
yazanak	yazanağımızda	N;LOC;SG;PSS1P
sevişmek	sevişir olacakmışsınız	V;INFR;FUT;HAB;2;PL;POS;DECL
mikrofiber	mikrofiberinden	N;ABL;SG;PSS3S
fotoğraf çekmek	fotoğraf çekecek olacak mısınız	V;IND;FUT;PROSP;2;PL;INTR;POS
çarmıha germek	çarmıha gerermiş	V;INFR;PRS;HAB;3;SG;POS;DECL
fizikçi	fizikçilerde	N;LOC;PL
öldürtmek	öldürtmemiş	V;INFR;PST;3;SG;NEG;DECL
titremek	titriyor olmamalılar mıydı	V;OBLIG;PST;PROG;3;PL;NEG;INTR
dinamit	dinamitlerin	N;GEN;PL
mortoyu çekmek	mortoyu çekmeyecek miydiniz	V;IND;PST;PROSP;2;PL;NEG;INTR
biseksüel	biseksüelinizden	N;ABL;SG;PSS2P
programlattırmak	programlattırıyor olmamalısın	V;OBLIG;PRS;PROG;2;SG;NEG;DECL
ölçüşmek	ölçüşecekmişsin	V;INFR;FUT;2;SG;POS;DECL
bürümek	bürümüyormuşum	V;INFR;PRS;PROG;1;SG;NEG;DECL
sövmek	sövecek olmayacak mıymışsınız	V;INFR;FUT;PROSP;2;PL;NEG;INTR
çıldırtmak	çıldırtmışmışsınız	V;INFR;LGSPEC1;PST;2;PL;POS;DECL
artmak	artmıyorlar mıydı	V;IND;PST;PROG;3;PL;NEG;INTR
ayrılmak	ayrılacak mıymışız	V;INFR;FUT;1;PL;INTR;POS
varış	varıştan	N;ABL;SG
solmak	solarlar mıydı	V;IND;PST;HAB;3;PL;INTR;POS
inmek	iner miymişiz	V;INFR;PRS;HAB;1;PL;INTR;POS
kurumak	kurumuyorlardı	V;IND;PST;PROG;3;PL;NEG;DECL
canlanmamak	canlanmıyor muymuşsun	V;INFR;PRS;PROG;2;SG;INTR;POS
yontulmak	yontulacak mıydın	V;IND;PST;PROSP;2;SG;INTR;POS
yitmek	yiterim	V;IND;PRS;HAB;1;SG;POS;DECL
âşık olmak	âşık oluyormuşsunuz	V;INFR;PRS;PROG;2;PL;POS;DECL
polinom	polinomlarından	N;ABL;PL;PSS3S
sözlük	sözlüklerin	N;NOM;PL;PSS2S
devinim	devinimlere	N;DAT;PL
vazo	vazolarız	N;ARGNO1P;PL;PRS
oyalamak	oyalamış olacak	V;INFR;FUT;PFV;3;SG;POS;DECL
bas	basını	N;ACC;SG;PSS2S
sökmek	söküyor olmayacak mıydınız	V;IND;PST;PROSP+PROG;2;PL;NEG;INTR
kurbağalama	kurbağalamanızın	N;GEN;SG;PSS2P
acıktırtmak	acıktırtmış olacaklar mı	V;INFR;FUT;PFV;3;PL;INTR;POS
klitoris	klitorislerimizi	N;ACC;PL;PSS1P
serpmek	serpmeliler	V;OBLIG;PRS;3;PL;POS;DECL
evlenmek	evleniyor olmalı mıymış	V;OBLIG;INFR;PRS;PROG;3;SG;INTR;POS
kanamak	kanayacak mıymış	V;INFR;FUT;3;SG;INTR;POS
karıştırmak	karıştırmadı	V;IND;PST;3;SG;NEG;DECL
puro	purolarından	N;ABL;PL;PSS3S
heyecanlandırtmak	heyecanlandırtmazsın	V;IND;PRS;HAB;2;SG;NEG;DECL
silkmek	silkiyor olmamalı mısınız	V;OBLIG;PRS;PROG;2;PL;NEG;INTR
kokmak	kokacak olmayacak mıyım	V;IND;FUT;PROSP;1;SG;NEG;INTR
dövmek	dövmeli miydim	V;OBLIG;PST;1;SG;INTR;POS
sanmak	sanırsınız	V;IND;PRS;HAB;2;PL;POS;DECL
cevap vermek	cevap veriyor olmayacak mıyım	V;IND;FUT;PROG;1;SG;NEG;INTR
dönem	dönemleriniz	N;NOM;PL;PSS2P
germek	gerecek olacakmışım	V;INFR;FUT;PROSP;1;SG;POS;DECL
silmek	siliyormuşsun	V;INFR;PRS;PROG;2;SG;POS;DECL
yoldurmak	yoldurmuş olmayacaklardı	V;INFR;PST;PROSP;3;PL;NEG;DECL
dizmek	dizmemeliymişsiniz	V;OBLIG;INFR;PST;2;PL;NEG;DECL
kötüleşmek	kötüleşmeyecekmişiz	V;INFR;FUT;1;PL;NEG;DECL
ilerletmek	ilerletecekmişsin	V;INFR;FUT;2;SG;POS;DECL
başvuru	başvurun	N;NOM;SG;PSS2S
ulam	ulamını	N;ACC;SG;PSS3S
sürünmek	sürünmeyeceksiniz	V;IND;FUT;2;PL;NEG;DECL
fakirleştirmek	fakirleştirmezlermiş	V;INFR;PRS;HAB;3;PL;NEG;DECL
ramazan	ramazandan	N;ABL;SG
getirmek	getiriyor olmalı mıymışsın	V;OBLIG;INFR;PRS;PROG;2;SG;INTR;POS
havlu atmak	havlu atıyor muyum	V;IND;PRS;PROG;1;SG;INTR;POS
coşmak	coşmuş olmayacaktınız	V;INFR;PST;PROSP;2;PL;NEG;DECL
ölçülmek	ölçülüyor olmayacak mıymış	V;INFR;FUT;PROG;3;SG;NEG;INTR
ittirtilmek	ittirtiliyor olurdum	V;IND;PST;HAB+PROG;1;SG;POS;DECL
bir avuç toprak olmak	bir avuç toprak olur olmayacak mıymış	V;INFR;FUT;HAB;3;SG;NEG;INTR
gözlemek	gözlüyor olur muydu	V;IND;PST;HAB+PROG;3;SG;INTR;POS
taşımak	taşıyor olmaz mıydı	V;IND;PST;HAB+PROG;3;SG;NEG;INTR
nene	nenesini	N;ACC;SG;PSS3S
uğratılmak	uğratılır mıyız	V;IND;PRS;HAB;1;PL;INTR;POS
serpmek	serpiyor muydunuz	V;IND;PST;PROG;2;PL;INTR;POS
asteroit	asteroitleri	N;NOM;PL;PSS3S
kaynaştırılmak	kaynaştırılmalılar mıymış	V;OBLIG;INFR;PST;3;PL;INTR;POS
değiştirmek	değiştirmemişlermiş	V;INFR;LGSPEC1;PST;3;PL;NEG;DECL
saklamak	saklamamalılar mıymış	V;OBLIG;INFR;PST;3;PL;NEG;INTR
çerçi	çerçimizden	N;ABL;SG;PSS1P
ön derleyici	ön derleyicilerine	N;DAT;PL;PSS3S
çar	çarları	N;NOM;PL;PSS3S
gülmek	gülmemiş miyim	V;INFR;PST;1;SG;NEG;INTR
