katakulli	katakulliye	N;DAT;SG
çalmak	çalmamalı mıydım	V;OBLIG;PST;1;SG;NEG;INTR
yalvarmak	yalvarırlar mıymış	V;INFR;PRS;HAB;3;PL;INTR;POS
volkan	volkana	N;DAT;SG
yapışmak	yapışıyor olacak mısınız	V;IND;FUT;PROG;2;PL;INTR;POS
kaynaştırılmak	kaynaştırılmışmışım	V;INFR;LGSPEC1;PST;1;SG;POS;DECL
hayırsever	hayırseverlerdim	N;ARGNO1S;PL;PST
kullanılmak	kullanılmamalıymışsınız	V;OBLIG;INFR;PST;2;PL;NEG;DECL
kovdurtmak	kovdurtmuyorlardı	V;IND;PST;PROG;3;PL;NEG;DECL
saksocu	saksocunun	N;GEN;SG;PSS2S
fahişe	fahişelerini	N;ACC;PL;PSS3S
utandırmak	utandırmeliyim	V;OBLIG;PRS;1;SG;POS;DECL
canlandırılmak	canlandırılır mıyım	V;IND;PRS;HAB;1;SG;INTR;POS
sonbahar	sonbaharların	N;GEN;PL
kazanmak	kazanmamalıymışım	V;OBLIG;INFR;PST;1;SG;NEG;DECL
döndürmek	döndürüyor olacak mıydın	V;IND;PST;PROSP+PROG;2;SG;INTR;POS
temizlemek	temizleyecektik	V;IND;PST;PROSP;1;PL;POS;DECL
kullanmak	kullanmış mısınız	V;INFR;PST;2;PL;INTR;POS
tutmak	tutacaksın	V;IND;FUT;2;SG;POS;DECL
ağaç çivi	ağaç çividim	N;ARGNO1S;SG;PST
duymak	duymamış mıymışım	V;INFR;LGSPEC1;PST;1;SG;NEG;INTR
satmak	satmamalıydı	V;OBLIG;PST;3;SG;NEG;DECL
makyaj yapmak	makyaj yapmışsın	V;INFR;PST;2;SG;POS;DECL
canlanmamak	canlanmamamıştı	V;INFR;PST;PFV;3;SG;NEG;DECL
İngilizceleştirmek	İngilizceleştirmezmişim	V;INFR;PRS;HAB;1;SG;NEG;DECL
ayvaz	ayvaz	N;ARGNO3S;SG;PRS
kovulmak	kovulmadın mı	V;IND;PST;2;SG;NEG;INTR
yedirmek	yedirmiyor	V;IND;PRS;PROG;3;SG;NEG;DECL
patlamak	patlıyor olmalı mı	V;OBLIG;PRS;PROG;3;SG;INTR;POS
onarmak	onarmayacak mıymışsın	V;INFR;FUT;2;SG;NEG;INTR
zartayı çekmek	zartayı çekmeli miydin	V;OBLIG;PST;2;SG;INTR;POS
fotoğraf çekmek	fotoğraf çektiydiniz	V;IND;PST;PFV;2;PL;POS;DECL
bükülmek	bükülmedin mi	V;IND;PST;2;SG;NEG;INTR
enişte	enişteyiz	N;ARGNO1P;SG;PRS
süzmek	süzmüyormuşum	V;INFR;PRS;PROG;1;SG;NEG;DECL
yalın durum	yalın durumunu	N;ACC;SG;PSS2S
psikoterapi	psikoterapimizin	N;GEN;SG;PSS1P
anahtarlık	anahtarlıklarda	N;LOC;PL
imam	imamlarını	N;ACC;PL;PSS3S
uyarmak	uyarmışmış	V;INFR;LGSPEC1;PST;3;SG;POS;DECL
kokmak	kokarsınız	V;IND;PRS;HAB;2;PL;POS;DECL
zibidi	zibidilerinin	N;GEN;PL;PSS2S
bay	baylarım	N;ARGNO1S;PL;PRS
ayarlattırmak	ayarlattırmayacak mıymışız	V;INFR;FUT;1;PL;NEG;INTR
adale	adalelerinde	N;LOC;PL;PSS2S
çalışmak	çalışmamalı mıymışsınız	V;OBLIG;INFR;PST;2;PL;NEG;INTR
boşanmak	boşanacak olmayacak mıymışız	V;INFR;FUT;PROSP;1;PL;NEG;INTR
görmek	görmemişmişsin	V;INFR;LGSPEC1;PST;2;SG;NEG;DECL
kaynaşmak	kaynaşıyorlar mıydı	V;IND;PST;PROG;3;PL;INTR;POS
kılmak	kılıyor olmayacakmışım	V;INFR;FUT;PROG;1;SG;NEG;DECL
öldürtülmemek	öldürtülür müydü	V;IND;PST;HAB;3;SG;INTR;POS
bilmek	bilir olacak mıymışsın	V;INFR;FUT;HAB;2;SG;INTR;POS
boy ölçüşmek	boy ölçüşürler mi	V;IND;PRS;HAB;3;PL;INTR;POS
doğurmak	doğurmuş olacaktık	V;INFR;PST;PROSP;1;PL;POS;DECL
küllük	küllüğü	N;NOM;SG;PSS3S
kurtarmak	kurtaracak mıymışsınız	V;INFR;FUT;2;PL;INTR;POS
dondurmak	donduruyor olmamalı mıymışsınız	V;OBLIG;INFR;PRS;PROG;2;PL;NEG;INTR
büyümek	büyüyecek misiniz	V;IND;FUT;2;PL;INTR;POS
bükmeme	bükmemelerden	N;ABL;PL
sunmak	sunmadın mı	V;IND;PST;2;SG;NEG;INTR
ayarlatmak	ayarlat	V;IMP;2;SG;POS;DECL
gübre	gübrelermişiz	N;ARGNO1P;PL;LGSPEC2
kaynaşmak	kaynaşmazmışsınız	V;INFR;PRS;HAB;2;PL;NEG;DECL
tren	treninin	N;GEN;SG;PSS2S
evlenmek	evleniyor olmamalılar mı	V;OBLIG;PRS;PROG;3;PL;NEG;INTR
irdelemek	irdelemiş miymişim	V;INFR;LGSPEC1;PST;1;SG;INTR;POS
küçülmek	küçülür müymüşüz	V;INFR;PRS;HAB;1;PL;INTR;POS
gülmek	gülüyor olmalıydınız	V;OBLIG;PST;PROG;2;PL;POS;DECL
terapist	terapistleri	N;ACC;PL
kovdurtmak	kovdurtuyormuşuz	V;INFR;PRS;PROG;1;PL;POS;DECL
kibutz	kibutzına	N;DAT;SG;PSS2S
barbar	barbar mıydın?	ADJ;LGSPEC1;PST;2;SG;POS;INTR
yolunmak	yolunacak olmayacaklar	V;IND;FUT;PROSP;3;PL;NEG;DECL
kıymak	kıymamış mıydın	V;INFR;PST;PFV;2;SG;NEG;INTR
kararmak	kararıyor olmalıydınız	V;OBLIG;PST;PROG;2;PL;POS;DECL
nefes aldırtmak	nefes aldırtmış mıymışız	V;INFR;LGSPEC1;PST;1;PL;INTR;POS
değişken	değişkenlerin	N;NOM;PL;PSS2S
konveks dörtgen	konveks dörtgene	N;DAT;SG
yıpranmak	yıpranıyor muymuşsunuz	V;INFR;PRS;PROG;2;PL;INTR;POS
üşümek	üşüyor olmamalıyım	V;OBLIG;PRS;PROG;1;SG;NEG;DECL
öğütmek	öğütmezlerdi	V;IND;PST;HAB;3;PL;NEG;DECL
çatmak	çatmaz mıydık	V;IND;PST;HAB;1;PL;NEG;INTR
göndermek	göndermemeli miymişsin	V;OBLIG;INFR;PST;2;SG;NEG;INTR
yaratmak	yaratmıyordum	V;IND;PST;PROG;1;SG;NEG;DECL
kovdurtmak	kovdurtacak olmayacaklar mı	V;IND;FUT;PROSP;3;PL;NEG;INTR
üşenmek	üşenmemeliydik	V;OBLIG;PST;1;PL;NEG;DECL
delirmek	deliriyor olmalı mıymışsın	V;OBLIG;INFR;PRS;PROG;2;SG;INTR;POS
binmek	biniyor olur muydun	V;IND;PST;HAB+PROG;2;SG;INTR;POS
küçülmek	küçülmüş olmayacaktık	V;INFR;PST;PROSP;1;PL;NEG;DECL
getirmek	getirir olmayacak mıymışım	V;INFR;FUT;HAB;1;SG;NEG;INTR
tıraş olmak	tıraş olmalı mıydı	V;OBLIG;PST;3;SG;INTR;POS
kanlılık	kanlılığınızın	N;GEN;SG;PSS2P
süsmek	süsüyor olmayacaktım	V;IND;PST;PROSP+PROG;1;SG;NEG;DECL
dize gelmek	dize gelmeyecek miydin	V;IND;PST;PROSP;2;SG;NEG;INTR
kirletmek	kirletmeli miymişsiniz	V;OBLIG;INFR;PST;2;PL;INTR;POS
kurumak	kurumamış mıydım	V;INFR;PST;PFV;1;SG;NEG;INTR
izlemek	izleyecek olacak mısınız	V;IND;FUT;PROSP;2;PL;INTR;POS
altuni iskete	altuni isketeye	N;DAT;SG
çevirmek	çevirmiş miyiz	V;INFR;PST;1;PL;INTR;POS
yenilmek	yeniliyor olacaktın	V;IND;PST;PROSP+PROG;2;SG;POS;DECL
uçmak	uçmamalıymış	V;OBLIG;INFR;PST;3;SG;NEG;DECL
canlandırtmak	canlandırtmış olacaktınız	V;INFR;PST;PROSP;2;PL;POS;DECL
kullanmak	kullanmayacak mıymışız	V;INFR;FUT;1;PL;NEG;INTR
saydırtmak	saydırtmıyordum	V;IND;PST;PROG;1;SG;NEG;DECL
öldürmek	öldürüyor olur muydu	V;IND;PST;HAB+PROG;3;SG;INTR;POS
kaynamak	kaynamameli miyim	V;OBLIG;PRS;1;SG;NEG;INTR
optimizasyon	optimizasyonlarına	N;DAT;PL;PSS2S
yazmak	yazıyor olmazdı	V;IND;PST;HAB+PROG;3;SG;NEG;DECL
bencillik	bencilliğin	N;GEN;SG
güzelleştirmek	güzelleştirmiş miydi	V;INFR;PST;PFV;3;SG;INTR;POS
öldürtülmek	öldürtülüyor olmalıydım	V;OBLIG;PST;PROG;1;SG;POS;DECL
kaynamak	kaynayacak olacaklar	V;IND;FUT;PROSP;3;PL;POS;DECL
büktürülmek	büktürülmüştüm	V;INFR;PST;PFV;1;SG;POS;DECL
dayamak	dayamaz mıymış	V;INFR;PRS;HAB;3;SG;NEG;INTR
sürücü	sürücünüzün	N;GEN;SG;PSS2P
heyecanlandırtmak	heyecanlandırtmayacak mıyız	V;IND;FUT;1;PL;NEG;INTR
taverna	tavernasını	N;ACC;SG;PSS3S
sugeçirmez yapmak	sugeçirmez yapar mıymış	V;INFR;PRS;HAB;3;SG;INTR;POS
dokumak	dokumayacaklar	V;IND;FUT;3;PL;NEG;DECL
sıvılaştırmak	sıvılaştırmalıydık	V;OBLIG;PST;1;PL;POS;DECL
aşiret	aşiretinizin	N;GEN;SG;PSS2P
cin	cinlerimize	N;DAT;PL;PSS1P
dilmek	dilmeyecek mi	V;IND;FUT;3;SG;NEG;INTR
karınca yuvası	karınca yuvasını	N;ACC;SG
salam	salamlarına	N;DAT;PL;PSS3S
üremek	üremeliymişsin	V;OBLIG;INFR;PST;2;SG;POS;DECL
işlev	işlev	N;NOM;SG
osurmak	osuracaktım	V;IND;PST;PROSP;1;SG;POS;DECL
eskimek	eskimedi miydi	V;IND;PST;PFV;3;SG;NEG;INTR
demirci	demirciyi	N;ACC;SG
jenerasyon	jenerasyonunu	N;ACC;SG;PSS3S
hukuk	hukukların	N;GEN;PL
ikaz	ikazlarda	N;LOC;PL
yırtmak	yırtmadın	V;IND;PST;2;SG;NEG;DECL
hareket etmek	hareket etmez misin	V;IND;PRS;HAB;2;SG;NEG;INTR
satın almak	satın alıyor olmayacaklar mıymış	V;INFR;FUT;PROG;3;PL;NEG;INTR
dalgıç	dalgıçtım	N;ARGNO1S;SG;PST
düzmek	düzerim	V;IND;PRS;HAB;1;SG;POS;DECL
kaybolmak	kayboluyor olacaklar	V;IND;FUT;PROG;3;PL;POS;DECL
blogcu	blogcuların	N;GEN;PL
bitirttirmek	bitirttirmiyorum	V;IND;PRS;PROG;1;SG;NEG;DECL
yaratma	yaratmalarınızda	N;LOC;PL;PSS2P
hareketlilik	hareketliliklerinize	N;DAT;PL;PSS2P
yapmak	yapıyor olmamalıydınız	V;OBLIG;PST;PROG;2;PL;NEG;DECL
denilmek	deniliyor olacak mısınız	V;IND;FUT;PROG;2;PL;INTR;POS
şikâyet etmek	şikâyet etmiş olacak mıydı	V;INFR;PST;PROSP;3;SG;INTR;POS
almak	almayacak mıydın	V;IND;PST;PROSP;2;SG;NEG;INTR
çoğul	çoğullarımızdan	N;ABL;PL;PSS1P
etkilemek	etkilemedik	V;IND;PST;1;PL;NEG;DECL
ayrımcılık	ayrımcılığınızı	N;ACC;SG;PSS2P
karıştırmak	karıştırmamışız	V;INFR;PST;1;PL;NEG;DECL
temizlemek	temizliyor olmalı mıymışsınız	V;OBLIG;INFR;PRS;PROG;2;PL;INTR;POS
dolamak	dolayacaktın	V;IND;PST;PROSP;2;SG;POS;DECL
ceylan	ceylandık	N;ARGNO1P;SG;PST
sövmek	sövecekler miydi	V;IND;PST;PROSP;3;PL;INTR;POS
bitmek	bitmiyor muydunuz	V;IND;PST;PROG;2;PL;NEG;INTR
kalmak	kalmıyorum	V;IND;PRS;PROG;1;SG;NEG;DECL
seçmek	seçmiş miydi	V;INFR;PST;PFV;3;SG;INTR;POS
canlandırmamak	canlandırıacak olmayacak mıymışız	V;INFR;FUT;PROSP;1;PL;NEG;INTR
müdür	müdürlerinden	N;ABL;PL;PSS2S
Lefkoşalı	Lefkoşalıları	N;NOM;PL;PSS3S
kullanım	kullanımımızı	N;ACC;SG;PSS1P
kurutmak	kurutmayacakmışsın	V;INFR;FUT;2;SG;NEG;DECL
katılmak	katılmak	V;NFIN
gelinmek	gelinmiyormuşsunuz	V;INFR;PRS;PROG;2;PL;NEG;DECL
neşriyat	neşriyatı	N;NOM;SG;PSS3S
ölçmek	ölçüyor olmamalısın	V;OBLIG;PRS;PROG;2;SG;NEG;DECL
üretmek	üretiyor olmalı mıymışım	V;OBLIG;INFR;PRS;PROG;1;SG;INTR;POS
dizmek	dizmiyorsun	V;IND;PRS;PROG;2;SG;NEG;DECL
yoksullaştırmak	yoksullaştırmış olmayacaktın	V;INFR;PST;PROSP;2;SG;NEG;DECL
göndermek	gönderiyor musun	V;IND;PRS;PROG;2;SG;INTR;POS
ilerletmek	ilerletmediler mi	V;IND;PST;3;PL;NEG;INTR
pisletmek	pisletmeyecekmiş	V;INFR;FUT;3;SG;NEG;DECL
kovdurtmak	kovdurtacak olacak mı	V;IND;FUT;PROSP;3;SG;INTR;POS
yakışıklı	yakışıklıymış	ADJ;LGSPEC1;LGSPEC2;3;SG;POS;DECL
canlandırılmak	canlandırılıyor olmamalı mı	V;OBLIG;PRS;PROG;3;SG;NEG;INTR
vermek	verecek olacak mıymış	V;INFR;FUT;PROSP;3;SG;INTR;POS
dirim bilimci	dirim bilimci	N;NOM;SG
yardımcı	yardımcılarınızdan	N;ABL;PL;PSS2P
ekşitmek	ekşitirim	V;IND;PRS;HAB;1;SG;POS;DECL
eğilmek	eğilmiyor muymuşum	V;INFR;PRS;PROG;1;SG;NEG;INTR
fortlamak	fortluyor olmalıydı	V;OBLIG;PST;PROG;3;SG;POS;DECL
yapmak	yapıyor muydum	V;IND;PST;PROG;1;SG;INTR;POS
ayırmak	ayırır mısın	V;IND;PRS;HAB;2;SG;INTR;POS
uzay	uzayınızda	N;LOC;SG;PSS2P
külah	külahınızda	N;LOC;SG;PSS2P
kasmak	kasmamalı mıydım	V;OBLIG;PST;1;SG;NEG;INTR
ısınmak	ısınmadılardı	V;IND;PST;PFV;3;PL;NEG;DECL
pusmak	pusar olmayacak mıymış	V;INFR;FUT;HAB;3;SG;NEG;INTR
kapı yapmak	kapı yapıyor olmamalıymışsın	V;OBLIG;INFR;PRS;PROG;2;SG;NEG;DECL
beyit	beytimiz	N;NOM;SG;PSS1P
söyleşi	söyleşileriniz	N;NOM;PL;PSS2P
düzeltmek	düzeltmedi mi	V;IND;PST;3;SG;NEG;INTR
utanmak	utanıyor olmamalı	V;OBLIG;PRS;PROG;3;SG;NEG;DECL
kırmak	kırıyor olmaz mıydın	V;IND;PST;HAB+PROG;2;SG;NEG;INTR
ürkmek	ürküyor olacaklar mıydı	V;IND;PST;PROSP+PROG;3;PL;INTR;POS
sermek	serecek olacakmışsın	V;INFR;FUT;PROSP;2;SG;POS;DECL
dalgalanmak	dalgalanmıştı	V;INFR;PST;PFV;3;SG;POS;DECL
yaptırtmak	yaptırtıyor olmalı mıydın	V;OBLIG;PST;PROG;2;SG;INTR;POS
alındırmak	alındırmalı mıymışız	V;OBLIG;INFR;PST;1;PL;INTR;POS
korsan	korsanımız	N;NOM;SG;PSS1P
şikâyet etmek	şikâyet ediyor olacak mıyız	V;IND;FUT;PROG;1;PL;INTR;POS
ateş	ateşinde	N;LOC;SG;PSS2S
yaramak	yarayacaklardı	V;IND;PST;PROSP;3;PL;POS;DECL
yanardağ	yanardağlarımız	N;NOM;PL;PSS1P
okumak	okumuyorsun	V;IND;PRS;PROG;2;SG;NEG;DECL
bir avuç toprak olmak	bir avuç toprak olmameliyiz	V;OBLIG;PRS;1;PL;NEG;DECL
semerci	semercilerden	N;ABL;PL
çarpmak	çarparlar mıymış	V;INFR;PRS;HAB;3;PL;INTR;POS
satılmak	satılmıyor muydunuz	V;IND;PST;PROG;2;PL;NEG;INTR
tanıtmak	tanıttınız	V;IND;PST;2;PL;POS;DECL
makta	maktalara	N;DAT;PL
kızmak	kızmalı mıydın	V;OBLIG;PST;2;SG;INTR;POS
güzelleştirmek	güzelleştirmiş olacak mıydınız	V;INFR;PST;PROSP;2;PL;INTR;POS
kulağını bükmek	kulağını bükmüyor muydun	V;IND;PST;PROG;2;SG;NEG;INTR
kanıtlamak	kanıtlayacak mısın	V;IND;FUT;2;SG;INTR;POS
kanlılık	kanlılığın	N;GEN;SG
ölçülmek	ölçülmüş olacaksınız	V;INFR;FUT;PFV;2;PL;POS;DECL
erimek	erir miyiz	V;IND;PRS;HAB;1;PL;INTR;POS
taht	tahtlardan	N;ABL;PL
doymak	doymalı mıymış	V;OBLIG;INFR;PST;3;SG;INTR;POS
taşımak	taşıyorduk	V;IND;PST;PROG;1;PL;POS;DECL
pandeist	pandeistmişsiniz	N;ARGNO2P;SG;LGSPEC2
ağlamak	ağlıyor olmalıyım	V;OBLIG;PRS;PROG;1;SG;POS;DECL
işitmek	işitmeliymişiz	V;OBLIG;INFR;PST;1;PL;POS;DECL
daldırmak	daldırıyor olacak mıydın	V;IND;PST;PROSP+PROG;2;SG;INTR;POS
unutmak	unutmuş olmayacak mıydın	V;INFR;PST;PROSP;2;SG;NEG;INTR
silkmek	silktiydik	V;IND;PST;PFV;1;PL;POS;DECL
marul	marullarınızı	N;ACC;PL;PSS2P
bilemek	bilemezlermiş	V;INFR;PRS;HAB;3;PL;NEG;DECL
haberleşmek	haberleşecek olacak mısınız	V;IND;FUT;PROSP;2;PL;INTR;POS
yalamak	yalamayacakmışım	V;INFR;FUT;1;SG;NEG;DECL
işletim	işletiminizden	N;ABL;SG;PSS2P
kıskanmak	kıskanmadıydık	V;IND;PST;PFV;1;PL;NEG;DECL
yuva	yuvalarının	N;GEN;PL;PSS2S
çıpa	çıpasında	N;LOC;SG;PSS3S
düzmek	düzer olacakmışsınız	V;INFR;FUT;HAB;2;PL;POS;DECL
büktürtmek	büktürtmez miymişsiniz	V;INFR;PRS;HAB;2;PL;NEG;INTR
eklemeli	eklemeliyiz	ADJ;LGSPEC1;PRS;1;PL;POS;DECL
komikleşmek	komikleşiyor olmalıydın	V;OBLIG;PST;PROG;2;SG;POS;DECL
silkmek	silkiyor olmazdı	V;IND;PST;HAB+PROG;3;SG;NEG;DECL
parlatmak	parlatıyor olmalı mıydın	V;OBLIG;PST;PROG;2;SG;INTR;POS
götürmek	götürür müydünüz	V;IND;PST;HAB;2;PL;INTR;POS
haberleşmek	haberleşiyor olacak mıydık	V;IND;PST;PROSP+PROG;1;PL;INTR;POS
derece	derecesi	N;NOM;SG;PSS3S
silgi	silgiymişsiniz	N;ARGNO2P;SG;LGSPEC2
boşalmak	boşalmamışsınız	V;INFR;PST;2;PL;NEG;DECL
kullanılmak	kullanılırsınız	V;IND;PRS;HAB;2;PL;POS;DECL
mümessil	mümessile	N;DAT;SG
öğretmen	öğretmenlerinin	N;GEN;PL;PSS3S
hızlı	hızlıyım	ADJ;LGSPEC1;PRS;1;SG;POS;DECL
haberleşmek	haberleşmedi miydi	V;IND;PST;PFV;3;SG;NEG;INTR
sapmak	sapmış olacaklar mı	V;INFR;FUT;PFV;3;PL;INTR;POS
yolundurmak	yolundurmaz mıymış	V;INFR;PRS;HAB;3;SG;NEG;INTR
çevirmek	çevirmiş olacak mıydınız	V;INFR;PST;PROSP;2;PL;INTR;POS
nokta	noktaydı	N;ARGNO3S;SG;PST
içmek	içmez misin	V;IND;PRS;HAB;2;SG;NEG;INTR
basın konferansı	basın konferansı	N;NOM;SG
üzülmek	üzülmemişmiş	V;INFR;LGSPEC1;PST;3;SG;NEG;DECL
arınmak	arınmıyordu	V;IND;PST;PROG;3;SG;NEG;DECL
kırdırtmak	kırdırtmış olacak mıydınız	V;INFR;PST;PROSP;2;PL;INTR;POS
küçülmek	küçülmüş olmayacak mıydık	V;INFR;PST;PROSP;1;PL;NEG;INTR
buluşmak	buluşuyor olmayacaksın	V;IND;FUT;PROG;2;SG;NEG;DECL
dikkat	dikkatlerinden	N;ABL;PL;PSS2S
terörizm	terörizme	N;DAT;SG
baz	bazını	N;ACC;SG;PSS2S
lord	lordlarınızın	N;GEN;PL;PSS2P
makine	makinesinde	N;LOC;SG;PSS3S
yağmak	yağmalıymışız	V;OBLIG;INFR;PST;1;PL;POS;DECL
çökmek	çökmeyecek mi	V;IND;FUT;3;SG;NEG;INTR
bamya	bamyaları	N;ACC;PL
daldırmak	daldırmış olacaktım	V;INFR;PST;PROSP;1;SG;POS;DECL
takısız isim tamlaması	takısız isim tamlamasının	N;GEN;SG
sikişmek	sikişir olmayacakmışsınız	V;INFR;FUT;HAB;2;PL;NEG;DECL
gerinmek	gerinmeyeceğiz	V;IND;FUT;1;PL;NEG;DECL
süründürmek	süründürüyoruz	V;IND;PRS;PROG;1;PL;POS;DECL
kuvvet	kuvvetiz	N;ARGNO1P;SG;PRS
yatak	yatağına	N;DAT;SG;PSS3S
heyecanlandırtmak	heyecanlandırtacak olmayacak mı	V;IND;FUT;PROSP;3;SG;NEG;INTR
kızmak	kızmış olmayacaktı	V;INFR;PST;PROSP;3;SG;NEG;DECL
parlatmak	parlatır olmayacak mıymış	V;INFR;FUT;HAB;3;SG;NEG;INTR
sikişmek	sikişmiş miydim	V;INFR;PST;PFV;1;SG;INTR;POS
sıvılaştırmak	sıvılaştırır olmayacak mıymışsın	V;INFR;FUT;HAB;2;SG;NEG;INTR
merdiven	merdivenlere	N;DAT;PL
müge	mügeydi	N;ARGNO3S;SG;PST
yetersizlik	yetersizliklerdi	N;ARGNO3S;PL;PST
öğrenmek	öğrenir	V;IND;PRS;HAB;3;SG;POS;DECL
kalıbı dinlendirmek	kalıbı dinlendirmiş miydi	V;INFR;PST;PFV;3;SG;INTR;POS
büktürtmemek	büktürtmemeyecekmişim	V;INFR;FUT;1;SG;NEG;DECL
atılmak	atılmıştı	V;INFR;PST;PFV;3;SG;POS;DECL
otuz bir çekmek	otuz bir çekiyorlar mı	V;IND;PRS;PROG;3;PL;INTR;POS
oyuncak	oyuncaklar	N;NOM;PL
büktürtülmek	büktürtülmüyor muymuşsun	V;INFR;PRS;PROG;2;SG;NEG;INTR
soğumak	soğuyacakmışsınız	V;INFR;FUT;2;PL;POS;DECL
çıkarmak	çıkarmıyor musunuz	V;IND;PRS;PROG;2;PL;NEG;INTR
avukat	avukatımıza	N;DAT;SG;PSS1P
masör	masörümüzde	N;LOC;SG;PSS1P
brokoli	brokolisinin	N;GEN;SG;PSS3S
ışık	ışıklarında	N;LOC;PL;PSS3S
sönmek	sönüyor olmayacak	V;IND;FUT;PROG;3;SG;NEG;DECL
öpücük	öpücüklerinizi	N;ACC;PL;PSS2P
eskimek	eskimemiş miymişiz	V;INFR;LGSPEC1;PST;1;PL;NEG;INTR
uğratılmak	uğratılır olacaklar mıymış	V;INFR;FUT;HAB;3;PL;INTR;POS
örmek	örmemeliydin	V;OBLIG;PST;2;SG;NEG;DECL
kırdırmak	kırdırır olmayacak mıymışsınız	V;INFR;FUT;HAB;2;PL;NEG;INTR
altını çizmek	altını çizmez miydik	V;IND;PST;HAB;1;PL;NEG;INTR
göndermek	göndermiş olmayacak mıydım	V;INFR;PST;PROSP;1;SG;NEG;INTR
yıkamak	yıkamış olacaktın	V;INFR;PST;PROSP;2;SG;POS;DECL
nutuk	nutuklarının	N;GEN;PL;PSS2S
şaşırtmak	şaşırtacak mıydın	V;IND;PST;PROSP;2;SG;INTR;POS
kaynaştırılmak	kaynaştırılırlar mı	V;IND;PRS;HAB;3;PL;INTR;POS
sinirlendirmek	sinirlendirmediler	V;IND;PST;3;PL;NEG;DECL
cızlamı çekmek	cızlamı çekmiş misiniz	V;INFR;PST;2;PL;INTR;POS
korkmak	korkmuşlar	V;INFR;PST;3;PL;POS;DECL
tane	tanesi	N;NOM;SG;PSS3S
sağmak	sağmış mıydınız	V;INFR;PST;PFV;2;PL;INTR;POS
kalıbı dinlendirmek	kalıbı dinlendirmemişler miydi	V;INFR;PST;PFV;3;PL;NEG;INTR
gülmek	gülmüş olacaklar	V;INFR;FUT;PFV;3;PL;POS;DECL
anlatmak	anlatıyor olmalıydınız	V;OBLIG;PST;PROG;2;PL;POS;DECL
vurmak	vuruyorsun	V;IND;PRS;PROG;2;SG;POS;DECL
anket	anketinizde	N;LOC;SG;PSS2P
aşık olmak	aşık olmuyorduk	V;IND;PST;PROG;1;PL;NEG;DECL
basmak	basıyor muyuz	V;IND;PRS;PROG;1;PL;INTR;POS
paylaştırma	paylaştırmada	N;LOC;SG
gaf	gaflarını	N;ACC;PL;PSS2S
arınmak	arınmıyorlar mı	V;IND;PRS;PROG;3;PL;NEG;INTR
sikmek	sikiyor olacaklar mı	V;IND;FUT;PROG;3;PL;INTR;POS
vernikleme	verniklemeye	N;DAT;SG
eğilmek	eğilir misin	V;IND;PRS;HAB;2;SG;INTR;POS
yetmek	yetmiş olmayacaklardı	V;INFR;PST;PROSP;3;PL;NEG;DECL
iyileşmek	iyileşecek misin	V;IND;FUT;2;SG;INTR;POS
kararmak	kararacak olmayacak mıyım	V;IND;FUT;PROSP;1;SG;NEG;INTR
çökermek	çökeriyor olmamalıymışız	V;OBLIG;INFR;PRS;PROG;1;PL;NEG;DECL
geçinmek	geçinmeli miydin	V;OBLIG;PST;2;SG;INTR;POS
azmak	azmayacaktı	V;IND;PST;PROSP;3;SG;NEG;DECL
gizlemek	gizlememeli miymiş	V;OBLIG;INFR;PST;3;SG;NEG;INTR
fal	falları	N;NOM;PL;PSS3S
hastane	hastanelerimizin	N;GEN;PL;PSS1P
oturmak	oturur muydu	V;IND;PST;HAB;3;SG;INTR;POS
haşefe	haşefenin	N;GEN;SG;PSS2S
krep	krepi	N;NOM;SG;PSS3S
çakıl	çakıl	N;NOM;SG
ettirtmek	ettirtmiş olmayacak mıydık	V;INFR;PST;PROSP;1;PL;NEG;INTR
sökmek	söktüler miydi	V;IND;PST;PFV;3;PL;INTR;POS
delmek	delecek olmayacak mıyız	V;IND;FUT;PROSP;1;PL;NEG;INTR
darılmak	darılacak mıymışız	V;INFR;FUT;1;PL;INTR;POS
gelmek	gelmemişiz	V;INFR;PST;1;PL;NEG;DECL
çevirmek	çevirmemelilermiş	V;OBLIG;INFR;PST;3;PL;NEG;DECL
göçmek	göçüyor olmayacaklar mıydı	V;IND;PST;PROSP+PROG;3;PL;NEG;INTR
canlanmamak	canlanmıyor olmalı mıydı	V;OBLIG;PST;PROG;3;SG;INTR;POS
çökertici	çökerticilerinde	N;LOC;PL;PSS2S
sönmek	sönmemiş miyiz	V;INFR;PST;1;PL;NEG;INTR
yalvarış	yalvarışın	N;GEN;SG
kovdurtmak	kovdurtacak olacak mıyız	V;IND;FUT;PROSP;1;PL;INTR;POS
geçmek	geçer mi	V;IND;PRS;HAB;3;SG;INTR;POS
sinmek	siniyor olmayacak mıydın	V;IND;PST;PROSP+PROG;2;SG;NEG;INTR
aşık atmak	aşık atacak olmayacakmışız	V;INFR;FUT;PROSP;1;PL;NEG;DECL
eğmek	eğiyor muymuş	V;INFR;PRS;PROG;3;SG;INTR;POS
mutluluk	mutluluklarının	N;GEN;PL;PSS2S
pisletmek	pisletmedik mi	V;IND;PST;1;PL;NEG;INTR
küremek	küremiş olacak mıydın	V;INFR;PST;PROSP;2;SG;INTR;POS
ezmek	eziyor muydum	V;IND;PST;PROG;1;SG;INTR;POS
nefes almak	nefes almazdın	V;IND;PST;HAB;2;SG;NEG;DECL
deyim	deyimlerde	N;LOC;PL
sürtük	sürtüğünüzden	N;ABL;SG;PSS2P
yalvarmak	yalvaracak olacak mıyız	V;IND;FUT;PROSP;1;PL;INTR;POS
parçalanmak	parçalanıyor olmamalıydın	V;OBLIG;PST;PROG;2;SG;NEG;DECL
kaynamak	kaynamayacak	V;IND;FUT;3;SG;NEG;DECL
ittirmek	ittirmiş olacaklardı	V;INFR;PST;PROSP;3;PL;POS;DECL
dedikodu yapmak	dedikodu yapıyor olurdunuz	V;IND;PST;HAB+PROG;2;PL;POS;DECL
sille	sillenin	N;GEN;SG;PSS2S
koyu sırtlı saka	koyu sırtlı sakalarda	N;LOC;PL
kavak	kavağa	N;DAT;SG
buluşmak	buluşacak olacakmışım	V;INFR;FUT;PROSP;1;SG;POS;DECL
havlu atmak	havlu atar mıymışsınız	V;INFR;PRS;HAB;2;PL;INTR;POS
sinirlendirmek	sinirlendiriyor olacağım	V;IND;FUT;PROG;1;SG;POS;DECL
kazmak	kazmışmışız	V;INFR;LGSPEC1;PST;1;PL;POS;DECL
bürümek	bürüyor olurdu	V;IND;PST;HAB+PROG;3;SG;POS;DECL
dağılmak	dağılıyor olacaklarmış	V;INFR;FUT;PROG;3;PL;POS;DECL
çığlık	çığlıklardan	N;ABL;PL
sıvılaşmak	sıvılaşıyor olmalıymışım	V;OBLIG;INFR;PRS;PROG;1;SG;POS;DECL
gönül	gönlün	N;NOM;SG;PSS2S
fortlamak	fortluyor olacaksınız	V;IND;FUT;PROG;2;PL;POS;DECL
fişek	fişekleri	N;ACC;PL
okumak	okuyor olmamalıydık	V;OBLIG;PST;PROG;1;PL;NEG;DECL
yarış	yarış	N;NOM;SG
verilmek	verilecektin	V;IND;PST;PROSP;2;SG;POS;DECL
taramak	tarıyor olmayacaktık	V;IND;PST;PROSP+PROG;1;PL;NEG;DECL
dizmek	dizdik	V;IND;PST;1;PL;POS;DECL
dalgalanmak	dalgalanmayacaklarmış	V;INFR;FUT;3;PL;NEG;DECL
ıslık çalmak	ıslık çalmadın	V;IND;PST;2;SG;NEG;DECL
küremek	kürüyor olmamalı mıydı	V;OBLIG;PST;PROG;3;SG;NEG;INTR
koklamak	koklamamış mısın	V;INFR;PST;2;SG;NEG;INTR
yabancı	yabancılarmışsın	N;ARGNO2S;PL;LGSPEC2
yerleşmek	yerleşmeliyiz	V;OBLIG;PRS;1;PL;POS;DECL
küremek	küremedi	V;IND;PST;3;SG;NEG;DECL
güvensizlik	güvensizliğimizi	N;ACC;SG;PSS1P
gücenmek	gücenir olacakmışım	V;INFR;FUT;HAB;1;SG;POS;DECL
uçan halı	uçan halılar	N;NOM;PL
boğmak	boğacak olacakmışım	V;INFR;FUT;PROSP;1;SG;POS;DECL
götürmek	götürmeyecektim	V;IND;PST;PROSP;1;SG;NEG;DECL
iletmek	iletecek olacaklarmış	V;INFR;FUT;PROSP;3;PL;POS;DECL
üremek	üreyecek olacağız	V;IND;FUT;PROSP;1;PL;POS;DECL
postu deldirmek	postu deldirmiş miyiz	V;INFR;PST;1;PL;INTR;POS
kalemtıraş	kalemtıraşımız	N;NOM;SG;PSS1P
fortlamak	fortladım	V;IND;PST;1;SG;POS;DECL
kötüleştirmek	kötüleştirmeyecekmişsin	V;INFR;FUT;2;SG;NEG;DECL
başkan	başkanları	N;ACC;PL
emmek	emiyor olmamalı mıymışsın	V;OBLIG;INFR;PRS;PROG;2;SG;NEG;INTR
akrobat	akrobatlarından	N;ABL;PL;PSS3S
açmak	açacak mıymışız	V;INFR;FUT;1;PL;INTR;POS
evlat	evladında	N;LOC;SG;PSS2S
oynamak	oynuyorlar mıymış	V;INFR;PRS;PROG;3;PL;INTR;POS
kıllık	kıllıklarımıza	N;DAT;PL;PSS1P
baz	baz	N;NOM;SG
yerleşmek	yerleşiyor olacaklar mıydı	V;IND;PST;PROSP+PROG;3;PL;INTR;POS
sapmak	sapar mıydınız	V;IND;PST;HAB;2;PL;INTR;POS
binmek	bineceksin	V;IND;FUT;2;SG;POS;DECL
umutlu	umutlu musunuz?	ADJ;LGSPEC1;PRS;2;PL;POS;INTR
koklamak	koklayacak olacağız	V;IND;FUT;PROSP;1;PL;POS;DECL
heyecanlandırmak	heyecanlandırıyor muymuşsun	V;INFR;PRS;PROG;2;SG;INTR;POS
kuğu	kuğunuzdan	N;ABL;SG;PSS2P
kovulmak	kovulmuyor muydunuz	V;IND;PST;PROG;2;PL;NEG;INTR
küçülmek	küçülmeliler miymiş	V;OBLIG;INFR;PST;3;PL;INTR;POS
şaşılmak	şaşılıyor olmamalı mıymışız	V;OBLIG;INFR;PRS;PROG;1;PL;NEG;INTR
öpüşmek	öpüşüyorlar mıydı	V;IND;PST;PROG;3;PL;INTR;POS
bitki	bitkiydi	N;ARGNO3S;SG;PST
alkış	alkışlarına	N;DAT;PL;PSS3S
örnek	örneklerimize	N;DAT;PL;PSS1P
yüzey	yüzeyleri	N;NOM;PL;PSS3S
kuram	kuramları	N;ACC;PL
yenilmek	yeniliyor olacak mıydınız	V;IND;PST;PROSP+PROG;2;PL;INTR;POS
istemek	istiyor olmamalı mıymışız	V;OBLIG;INFR;PRS;PROG;1;PL;NEG;INTR
kunduz	kunduzu	N;ACC;SG
büktürtmek	büktürtüyor olacak mıyız	V;IND;FUT;PROG;1;PL;INTR;POS
dolmak	dolmamalılar mıydı	V;OBLIG;PST;3;PL;NEG;INTR
sürünmek	sürünmemişiz	V;INFR;PST;1;PL;NEG;DECL
geciktirmek	geciktiriyoruz	V;IND;PRS;PROG;1;PL;POS;DECL
satın almak	satın alacak mı	V;IND;FUT;3;SG;INTR;POS
içmek	içer olmayacakmışız	V;INFR;FUT;HAB;1;PL;NEG;DECL
Yahudi	Yahudisini	N;ACC;SG;PSS3S
haberleşmek	haberleşiyor olmayacaktık	V;IND;PST;PROSP+PROG;1;PL;NEG;DECL
parçalanmak	parçalanmış olmayacaklardı	V;INFR;PST;PROSP;3;PL;NEG;DECL
sikişmek	sikişecek olmayacak mıyım	V;IND;FUT;PROSP;1;SG;NEG;INTR
bildirmek	bildirecek olmayacaklarmış	V;INFR;FUT;PROSP;3;PL;NEG;DECL
tanımak	tanıyacaktık	V;IND;PST;PROSP;1;PL;POS;DECL
birleştirtmek	birleştirtecek miyiz	V;IND;FUT;1;PL;INTR;POS
küçülmek	küçülmeyecek miymiş	V;INFR;FUT;3;SG;NEG;INTR
kul	kuldular	N;ARGNO3P;SG;PST
sürülmek	sürülecek olacaklarmış	V;INFR;FUT;PROSP;3;PL;POS;DECL
bitirmek	bitiriyorsunuz	V;IND;PRS;PROG;2;PL;POS;DECL
kelek	keleklerini	N;ACC;PL;PSS3S
yitmek	yitmezdim	V;IND;PST;HAB;1;SG;NEG;DECL
verdirtmek	verdirtmemişlerdi	V;INFR;PST;PFV;3;PL;NEG;DECL
girmek	girmiş	V;INFR;PST;3;SG;POS;DECL
saydırtmak	saydırtıyor olmayacak mıydık	V;IND;PST;PROSP+PROG;1;PL;NEG;INTR
umman	ummanlarız	N;ARGNO1P;PL;PRS
soymak	soymaz mısın	V;IND;PRS;HAB;2;SG;NEG;INTR
ağlaşmak	ağlaşmıyorsun	V;IND;PRS;PROG;2;SG;NEG;DECL
çığırtkan	çığırtkanlarmışsın	N;ARGNO2S;PL;LGSPEC2
tıklamak	tıklayacak olacak mıyız	V;IND;FUT;PROSP;1;PL;INTR;POS
el sıkışmak	el sıkışmış olacak mıyım	V;INFR;FUT;PFV;1;SG;INTR;POS
kazak	kazaklardan	N;ABL;PL
kırılmak	kırılmalı mıymış	V;OBLIG;INFR;PST;3;SG;INTR;POS
ayrılmak	ayrılmalıydım	V;OBLIG;PST;1;SG;POS;DECL
ölçülmek	ölçülür olacaklarmış	V;INFR;FUT;HAB;3;PL;POS;DECL
vapur	vapurundan	N;ABL;SG;PSS3S
sökmek	sökecektin	V;IND;PST;PROSP;2;SG;POS;DECL
keşfetmek	keşfetmişmişsin	V;INFR;LGSPEC1;PST;2;SG;POS;DECL
bilmek	biliyor olmayacağız	V;IND;FUT;PROG;1;PL;NEG;DECL
şaşırtmak	şaşırtmalılar mıydı	V;OBLIG;PST;3;PL;INTR;POS
düzeltmek	düzeltiyor olmamalı mısınız	V;OBLIG;PRS;PROG;2;PL;NEG;INTR
bombacı	bombacılar	N;NOM;PL
silah	silahlarımızı	N;ACC;PL;PSS1P
demlemek	demledi miydik	V;IND;PST;PFV;1;PL;INTR;POS
cevap vermek	cevap veriyor olmayacak mıyız	V;IND;FUT;PROG;1;PL;NEG;INTR
bükmek	bükmüş olmayacak mıydın	V;INFR;PST;PROSP;2;SG;NEG;INTR
otomobil	otomobilsiniz	N;ARGNO2P;SG;PRS
ut	utları	N;NOM;PL;PSS3S
sövmek	sövüyor olurdum	V;IND;PST;HAB+PROG;1;SG;POS;DECL
makyaj yapmak	makyaj yapmazdım	V;IND;PST;HAB;1;SG;NEG;DECL
canlandırmak	canlandırır mıymışım	V;INFR;PRS;HAB;1;SG;INTR;POS
ağda yapmak	ağda yapmamalı mıymışım	V;OBLIG;INFR;PST;1;SG;NEG;INTR
korkutmak	korkuttu muydum	V;IND;PST;PFV;1;SG;INTR;POS
açılmak	açılmamış mıydım	V;INFR;PST;PFV;1;SG;NEG;INTR
kızmak	kızmameli mi	V;OBLIG;PRS;3;SG;NEG;INTR
bükmemek	bükmememiş miydim	V;INFR;PST;PFV;1;SG;NEG;INTR
kibutz	kibutzlarımızda	N;LOC;PL;PSS1P
dayamak	dayayacak mıymış	V;INFR;FUT;3;SG;INTR;POS
büyümek	büyümemeliymişiz	V;OBLIG;INFR;PST;1;PL;NEG;DECL
böğürtlen	böğürtlenlerinin	N;GEN;PL;PSS3S
kovmak	kovacak olmayacaksın	V;IND;FUT;PROSP;2;SG;NEG;DECL
pisletmek	pisletmiyordunuz	V;IND;PST;PROG;2;PL;NEG;DECL
tükürmek	tükürmüyor muydunuz	V;IND;PST;PROG;2;PL;NEG;INTR
ışın	ışınlarmışsın	N;ARGNO2S;PL;LGSPEC2
korkmak	korkmuş olacak mı	V;INFR;FUT;PFV;3;SG;INTR;POS
katmak	kattın	V;IND;PST;2;SG;POS;DECL
sapan	sapanlarmış	N;ARGNO3P;PL;LGSPEC2
terlik	terliğin	N;GEN;SG
uzanmak	uzanıyor olmaz mıydı	V;IND;PST;HAB+PROG;3;SG;NEG;INTR
damlamak	damlamadı mıydınız	V;IND;PST;PFV;2;PL;NEG;INTR
satmak	satmış olacaktınız	V;INFR;PST;PROSP;2;PL;POS;DECL
evlenmek	evlenmiş miyim	V;INFR;PST;1;SG;INTR;POS
ürkmek	ürker olacakmışım	V;INFR;FUT;HAB;1;SG;POS;DECL
ümitli	ümitli değilmişler	ADJ;LGSPEC1;LGSPEC2;3;PL;NEG;DECL
yazmak	yazar mı	V;IND;PRS;HAB;3;SG;INTR;POS
şaşmak	şaşmayacaktınız	V;IND;PST;PROSP;2;PL;NEG;DECL
çalışmak	çalıştı mı	V;IND;PST;3;SG;INTR;POS
ittirilmek	ittirilir miymişsin	V;INFR;PRS;HAB;2;SG;INTR;POS
boy ölçüşmek	boy ölçüşmeli misin	V;OBLIG;PRS;2;SG;INTR;POS
canlanılmak	canlanılmıştık	V;INFR;PST;PFV;1;PL;POS;DECL
kıymet	kıymetinizin	N;GEN;SG;PSS2P
etkilemek	etkilememiş miymişsin	V;INFR;LGSPEC1;PST;2;SG;NEG;INTR
tercih	tercihinizden	N;ABL;SG;PSS2P
yapışık ikiz	yapışık ikizlermiş	N;ARGNO3S;PL;LGSPEC2
denilmek	denilmişmişim	V;INFR;LGSPEC1;PST;1;SG;POS;DECL
sakal	sakalı	N;NOM;SG;PSS3S
satmak	satıyor olmalıydım	V;OBLIG;PST;PROG;1;SG;POS;DECL
kanıtlamak	kanıtlayacaklar	V;IND;FUT;3;PL;POS;DECL
şaşılmak	şaşılacak olmayacağız	V;IND;FUT;PROSP;1;PL;NEG;DECL
kovdurtmak	kovdurtmuş olmayacaklar	V;INFR;FUT;PFV;3;PL;NEG;DECL
armağan	armağanların	N;GEN;PL
değişmek	değişecek olacak mısın	V;IND;FUT;PROSP;2;SG;INTR;POS
aşık	aşıklarınızdan	N;ABL;PL;PSS2P
yedirtmek	yedirtmeyecekmişsiniz	V;INFR;FUT;2;PL;NEG;DECL
saklamak	saklayacağım	V;IND;FUT;1;SG;POS;DECL
dizmek	diziyor olmayacak mıydınız	V;IND;PST;PROSP+PROG;2;PL;NEG;INTR
coşmak	coşuyor olmamalı mıymışım	V;OBLIG;INFR;PRS;PROG;1;SG;NEG;INTR
parlatmak	parlatmalıymış	V;OBLIG;INFR;PST;3;SG;POS;DECL
dağıtmak	dağıtmış olmayacak	V;INFR;FUT;PFV;3;SG;NEG;DECL
temsil	temsilleriniz	N;NOM;PL;PSS2P
yanmak	yanmamalıymış	V;OBLIG;INFR;PST;3;SG;NEG;DECL
bölmek	bölecektik	V;IND;PST;PROSP;1;PL;POS;DECL
yendirtmek	yendirtmezdin	V;IND;PST;HAB;2;SG;NEG;DECL
yendirmek	yendirmez miymişiz	V;INFR;PRS;HAB;1;PL;NEG;INTR
glasnost	glasnostlarınızdan	N;ABL;PL;PSS2P
uyumak	uyumuş olacağım	V;INFR;FUT;PFV;1;SG;POS;DECL
dadanmak	dadanacak mıyım	V;IND;FUT;1;SG;INTR;POS
birleştirmek	birleştirecek olmayacak mıyız	V;IND;FUT;PROSP;1;PL;NEG;INTR
tıklamak	tıklıyor olmayacaklardı	V;IND;PST;PROSP+PROG;3;PL;NEG;DECL
atmamak	atmamalılar mıydı	V;OBLIG;PST;3;PL;INTR;POS
kötüleşmek	kötüleşiyor olacak mıydınız	V;IND;PST;PROSP+PROG;2;PL;INTR;POS
vurmak	vuruyor olacakmışsınız	V;INFR;FUT;PROG;2;PL;POS;DECL
ezmek	eziyor olmalıymışsınız	V;OBLIG;INFR;PRS;PROG;2;PL;POS;DECL
fındık kırmak	fındık kırmayacaklardı	V;IND;PST;PROSP;3;PL;NEG;DECL
otostop çekmek	otostop çekmemiştim	V;INFR;PST;PFV;1;SG;NEG;DECL
kapatmak	kapatmış olacak mıydı	V;INFR;PST;PROSP;3;SG;INTR;POS
koleksiyon	koleksiyonlarına	N;DAT;PL;PSS3S
turşu	turşuydular	N;ARGNO3P;SG;PST
programlanmak	programlanıyor olmalıydın	V;OBLIG;PST;PROG;2;SG;POS;DECL
devinmek	devinmemişim	V;INFR;PST;1;SG;NEG;DECL
beklemek	bekler miydin	V;IND;PST;HAB;2;SG;INTR;POS
perde	perdelere	N;DAT;PL
bitmek	biteceklerdi	V;IND;PST;PROSP;3;PL;POS;DECL
yuvarlamak	yuvarlamış olacaklar mıydı	V;INFR;PST;PROSP;3;PL;INTR;POS
ekşimek	ekşimiş olacak mıyız	V;INFR;FUT;PFV;1;PL;INTR;POS
yaymak	yaymış olacak mıyım	V;INFR;FUT;PFV;1;SG;INTR;POS
sporcu	sporcularım	N;ARGNO1S;PL;PRS
sahife	sahifelerinize	N;DAT;PL;PSS2P
nefes almak	nefes alıyor olmamalı mıydı	V;OBLIG;PST;PROG;3;SG;NEG;INTR
gürz	gürzü	N;NOM;SG;PSS3S
geçinmek	geçiniyor olurdun	V;IND;PST;HAB+PROG;2;SG;POS;DECL
çiftlik	çiftliği	N;NOM;SG;PSS3S
etkilemek	etkilemişsin	V;INFR;PST;2;SG;POS;DECL
kırdırmak	kırdırmelisiniz	V;OBLIG;PRS;2;PL;POS;DECL
sevişmek	sevişiyor olmamalı mı	V;OBLIG;PRS;PROG;3;SG;NEG;INTR
yapışık ikiz	yapışık ikizden	N;ABL;SG
dul	dulmuş	N;ARGNO3S;SG;LGSPEC2
vurmak	vurmazmışsın	V;INFR;PRS;HAB;2;SG;NEG;DECL
kalmak	kalmayacaktık	V;IND;PST;PROSP;1;PL;NEG;DECL
aşık attırmak	aşık attırıyor olmayacak mısınız	V;IND;FUT;PROG;2;PL;NEG;INTR
ipek	ipeklerinde	N;LOC;PL;PSS3S
alem	aleminizden	N;ABL;SG;PSS2P
kanamak	kanamayınız	V;IMP;2;PL;LGSPEC2;NEG;DECL
yolmak	yolmuş olmayacak mıyız	V;INFR;FUT;PFV;1;PL;NEG;INTR
heyecanlanmak	heyecanlanacaklar mıymış	V;INFR;FUT;3;PL;INTR;POS
silkmek	silkiyor olacak	V;IND;FUT;PROG;3;SG;POS;DECL
pipet	pipetlerin	N;NOM;PL;PSS2S
figüran	figüranlarınız	N;NOM;PL;PSS2P
acıkmak	acıkmış mıydınız	V;INFR;PST;PFV;2;PL;INTR;POS
çarmıha germek	çarmıha germedi miydik	V;IND;PST;PFV;1;PL;NEG;INTR
düdük	düdüklerinizde	N;LOC;PL;PSS2P
büktürülmek	büktürülmeliymişim	V;OBLIG;INFR;PST;1;SG;POS;DECL
rahip	rahibinizde	N;LOC;SG;PSS2P
canlandırtılmak	canlandırtılmayacak mıymışsınız	V;INFR;FUT;2;PL;NEG;INTR
balamoz	balamozların	N;NOM;PL;PSS2S
durmak	durmazlar mıymış	V;INFR;PRS;HAB;3;PL;NEG;INTR
tıraş olmak	tıraş olmayacak mı	V;IND;FUT;3;SG;NEG;INTR
üyelik	üyeliklerinize	N;DAT;PL;PSS2P
âlim	âlimmişiz	N;ARGNO1P;SG;LGSPEC2
birleştirmek	birleştirmemeli miyiz	V;OBLIG;PRS;1;PL;NEG;INTR
büktürülmek	büktürülmemiş miymişsin	V;INFR;LGSPEC1;PST;2;SG;NEG;INTR
gücenmek	gücenecek olacak mıymışım	V;INFR;FUT;PROSP;1;SG;INTR;POS
toplamak	toplaacak olmayacakmış	V;INFR;FUT;PROSP;3;SG;NEG;DECL
erkenek	erkeneklersiniz	N;ARGNO2P;PL;PRS
peri	perin	N;NOM;SG;PSS2S
frizbi	frizbilerinden	N;ABL;PL;PSS3S
satın almak	satın alacak olmayacak mısınız	V;IND;FUT;PROSP;2;PL;NEG;INTR
dövüşmek	dövüşür olmayacak mıymışım	V;INFR;FUT;HAB;1;SG;NEG;INTR
büktürtmemek	büktürtüyecek olacağım	V;IND;FUT;PROSP;1;SG;POS;DECL
sıyırmak	sıyırmayacaklarmış	V;INFR;FUT;3;PL;NEG;DECL
yanmak	yanıyor olmaz mıydı	V;IND;PST;HAB+PROG;3;SG;NEG;INTR
ummak	umdum mu	V;IND;PST;1;SG;INTR;POS
kip	kipi	N;ACC;SG
geciktirmek	geciktirmişmişsin	V;INFR;LGSPEC1;PST;2;SG;POS;DECL
izolasyon	izolasyonumuzu	N;ACC;SG;PSS1P
diremek	direyeceklerdi	V;IND;PST;PROSP;3;PL;POS;DECL
ürümek	ürüyor olmalıymışım	V;OBLIG;INFR;PRS;PROG;1;SG;POS;DECL
dolmak	dolmamışlar mı	V;INFR;PST;3;PL;NEG;INTR
geliştirmek	geliştiriyorlar mıydı	V;IND;PST;PROG;3;PL;INTR;POS
ettirmek	ettirir miyiz	V;IND;PRS;HAB;1;PL;INTR;POS
bütünleşmek	bütünleşecek olacak mısın	V;IND;FUT;PROSP;2;SG;INTR;POS
korkmak	korkacak olmayacaklar	V;IND;FUT;PROSP;3;PL;NEG;DECL
soğumak	soğumazsınız	V;IND;PRS;HAB;2;PL;NEG;DECL
götürmek	götürecek olacağız	V;IND;FUT;PROSP;1;PL;POS;DECL
sıvılaşmak	sıvılaşmalı mıydınız	V;OBLIG;PST;2;PL;INTR;POS
sirk	sirklerinde	N;LOC;PL;PSS3S
tükenmek	tükenecek olmayacak mı	V;IND;FUT;PROSP;3;SG;NEG;INTR
çarmıh	çarmıhlarının	N;GEN;PL;PSS3S
smiley	smileyimizde	N;LOC;SG;PSS1P
donatım	donatımlarına	N;DAT;PL;PSS3S
sikilmek	sikiliyor olmayacak mıydınız	V;IND;PST;PROSP+PROG;2;PL;NEG;INTR
uğratmak	uğratmış olmayacak mısın	V;INFR;FUT;PFV;2;SG;NEG;INTR
bayılmak	bayılıyor olacaklar	V;IND;FUT;PROG;3;PL;POS;DECL
kılmak	kılmıyorlar	V;IND;PRS;PROG;3;PL;NEG;DECL
ayarlattırmak	ayarlattırmış olmayacak mısınız	V;INFR;FUT;PFV;2;PL;NEG;INTR
gidilmek	gidilecek olmayacaklar mıymış	V;INFR;FUT;PROSP;3;PL;NEG;INTR
katılmak	katılıyor olmayacakmışız	V;INFR;FUT;PROG;1;PL;NEG;DECL
kıskanmak	kıskanıyor olur muydum	V;IND;PST;HAB+PROG;1;SG;INTR;POS
heyecanlandırmak	heyecanlandırmamışmış	V;INFR;LGSPEC1;PST;3;SG;NEG;DECL
uyumak	uyuyor olmamalı mıydım	V;OBLIG;PST;PROG;1;SG;NEG;INTR
kızan	kızanlarınızda	N;LOC;PL;PSS2P
sevişmek	sevişmiyoruz	V;IND;PRS;PROG;1;PL;NEG;DECL
dikkat	dikkatine	N;DAT;SG;PSS2S
yetişmek	yetişmişler	V;INFR;PST;3;PL;POS;DECL
saldırmak	saldırmıyorduk	V;IND;PST;PROG;1;PL;NEG;DECL
yanıt vermek	yanıt veriyor olmalı mıymış	V;OBLIG;INFR;PRS;PROG;3;SG;INTR;POS
tanımak	tanıyor olmalı mısınız	V;OBLIG;PRS;PROG;2;PL;INTR;POS
rehine	rehineymişsin	N;ARGNO2S;SG;LGSPEC2
İngilizceleştirmek	İngilizceleştiriyor olacaklar mıydı	V;IND;PST;PROSP+PROG;3;PL;INTR;POS
görmek	görecek olmayacakmışsın	V;INFR;FUT;PROSP;2;SG;NEG;DECL
döndürmek	döndürdüm mü	V;IND;PST;1;SG;INTR;POS
kovulmak	kovulur olacakmışız	V;INFR;FUT;HAB;1;PL;POS;DECL
koz	kozlarmış	N;ARGNO3P;PL;LGSPEC2
misafir	misafire	N;DAT;SG
dirilmemek	dirilmez miyiz	V;IND;PRS;HAB;1;PL;INTR;POS
zam	zamda	N;LOC;SG
yalamak	yalardık	V;IND;PST;HAB;1;PL;POS;DECL
şelale	şelalesini	N;ACC;SG;PSS3S
acıkmak	acıkıyor olmalıydık	V;OBLIG;PST;PROG;1;PL;POS;DECL
basmak	basmış olmayacak mısınız	V;INFR;FUT;PFV;2;PL;NEG;INTR
klişe	klişelerinizde	N;LOC;PL;PSS2P
aldırmak	aldırmamışmış	V;INFR;LGSPEC1;PST;3;SG;NEG;DECL
soğumak	soğumaz mıymış	V;INFR;PRS;HAB;3;SG;NEG;INTR
saklanmak	saklanmamalıymışız	V;OBLIG;INFR;PST;1;PL;NEG;DECL
peygamber devesi	peygamber develerinde	N;LOC;PL
olay ufku	olay ufkunda	N;LOC;SG
yırtmak	yırtmamışlar	V;INFR;PST;3;PL;NEG;DECL
onamak	onar mıyım	V;IND;PRS;HAB;1;SG;INTR;POS
ölçülmek	ölçülüyor olacaktık	V;IND;PST;PROSP+PROG;1;PL;POS;DECL
sezmek	seziyor olmazlar mıydı	V;IND;PST;HAB+PROG;3;PL;NEG;INTR
katılaşmak	katılaştı mı	V;IND;PST;3;SG;INTR;POS
kaynaştırtılmak	kaynaştırtılacak olacakmışım	V;INFR;FUT;PROSP;1;SG;POS;DECL
geri	gerimize	N;DAT;SG;PSS1P
ispatlamak	ispatladı mıydım	V;IND;PST;PFV;1;SG;INTR;POS
ısınmak	ısınmışmışsın	V;INFR;LGSPEC1;PST;2;SG;POS;DECL
acıktırtmak	acıktırtır olacaklarmış	V;INFR;FUT;HAB;3;PL;POS;DECL
rahatsızlanmak	rahatsızlanmayacaklar mı	V;IND;FUT;3;PL;NEG;INTR
yaptırmak	yaptırmış olacak	V;INFR;FUT;PFV;3;SG;POS;DECL
yumurtalık	yumurtalığının	N;GEN;SG;PSS3S
tanıtmak	tanıtıyor olmamalı mısınız	V;OBLIG;PRS;PROG;2;PL;NEG;INTR
tıraş olmak	tıraş olacak olacağız	V;IND;FUT;PROSP;1;PL;POS;DECL
bölmek	bölmeyeceklerdi	V;IND;PST;PROSP;3;PL;NEG;DECL
güvenmek	güvenecekler miydi	V;IND;PST;PROSP;3;PL;INTR;POS
blogcu	blogcularımıza	N;DAT;PL;PSS1P
duymak	duyar mıydın	V;IND;PST;HAB;2;SG;INTR;POS
susmak	susar mıyız	V;IND;PRS;HAB;1;PL;INTR;POS
yarmak	yarmış olacak mıydım	V;INFR;PST;PROSP;1;SG;INTR;POS
yermek	yeriyor olmalılarmış	V;OBLIG;INFR;PRS;PROG;3;PL;POS;DECL
magma	magmamızı	N;ACC;SG;PSS1P
bulmak	buluyor olacakmış	V;INFR;FUT;PROG;3;SG;POS;DECL
saymak	sayıyor muyduk	V;IND;PST;PROG;1;PL;INTR;POS
kapamak	kapamış olacaksınız	V;INFR;FUT;PFV;2;PL;POS;DECL
sanmak	sanmamelisin	V;OBLIG;PRS;2;SG;NEG;DECL
bozmak	bozmuşmuşuz	V;INFR;LGSPEC1;PST;1;PL;POS;DECL
eldiven	eldivene	N;DAT;SG
nefes aldırmak	nefes aldırıyor olmamalı mısınız	V;OBLIG;PRS;PROG;2;PL;NEG;INTR
kerpiç	kerpiçleriniz	N;NOM;PL;PSS2P
demek	der olacakmışsın	V;INFR;FUT;HAB;2;SG;POS;DECL
gizemli	gizemliydiler	ADJ;LGSPEC1;PST;3;PL;POS;DECL
batmak	batmış mıymışım	V;INFR;LGSPEC1;PST;1;SG;INTR;POS
kazanmak	kazanmamış mıyım	V;INFR;PST;1;SG;NEG;INTR
can vermek	can veriyor olmalı mısınız	V;OBLIG;PRS;PROG;2;PL;INTR;POS
gidilmek	gidilmemiş	V;INFR;PST;3;SG;NEG;DECL
alfabe	alfabede	N;ABL;SG
unutmak	unutacaktın	V;IND;PST;PROSP;2;SG;POS;DECL
ölçüşmek	ölçüşecek olmayacak mısın	V;IND;FUT;PROSP;2;SG;NEG;INTR
ernek	erneklerdin	N;ARGNO2S;PL;PST
tanışmak	tanışıyor muymuşsunuz	V;INFR;PRS;PROG;2;PL;INTR;POS
parasızlık	parasızlıkların	N;NOM;PL;PSS2S
boyamak	boyamazmışız	V;INFR;PRS;HAB;1;PL;NEG;DECL
düzeltmek	düzeltmez misin	V;IND;PRS;HAB;2;SG;NEG;INTR
bezmek	beziyor olmayacaklar mı	V;IND;FUT;PROG;3;PL;NEG;INTR
bulunmak	bulunun	V;IMP;2;PL;POS;DECL
saydırtmak	saydırtmamalıymışım	V;OBLIG;INFR;PST;1;SG;NEG;DECL
emmek	emiyor olmaz mıydı	V;IND;PST;HAB+PROG;3;SG;NEG;INTR
kırdırmak	kırdırıyor muydunuz	V;IND;PST;PROG;2;PL;INTR;POS
kullanılmak	kullanılmışmışız	V;INFR;LGSPEC1;PST;1;PL;POS;DECL
götürmek	götürüyor olacaktım	V;IND;PST;PROSP+PROG;1;SG;POS;DECL
mezuniyet	mezuniyetler	N;NOM;PL
sevmek	seviyor olacak mısınız	V;IND;FUT;PROG;2;PL;INTR;POS
işemek	işiyor olmamalılar mı	V;OBLIG;PRS;PROG;3;PL;NEG;INTR
benzemek	benzeyecekler miymiş	V;INFR;FUT;3;PL;INTR;POS
saymak	sayar olacakmışız	V;INFR;FUT;HAB;1;PL;POS;DECL
kamera	kamerasında	N;LOC;SG;PSS3S
yapıncak	yapıncaklarımıza	N;DAT;PL;PSS1P
sıvılaştırmak	sıvılaştırıyor olmalı mıymışsın	V;OBLIG;INFR;PRS;PROG;2;SG;INTR;POS
kalmak	kalır mı	V;IND;PRS;HAB;3;SG;INTR;POS
fotoğraf çekmek	fotoğraf çekiyor olurdum	V;IND;PST;HAB+PROG;1;SG;POS;DECL
tutku	tutku	N;NOM;SG
Hakk'ın rahmetine kavuşmak	Hakk'ın rahmetine kavuşmalılar mıydı	V;OBLIG;PST;3;PL;INTR;POS
koyulaşmak	koyulaşıyor olmamalı mıymışsın	V;OBLIG;INFR;PRS;PROG;2;SG;NEG;INTR
yaklaşmak	yaklaşmazlar mıymış	V;INFR;PRS;HAB;3;PL;NEG;INTR
bilmek	bilmiş olmayacaklar mı	V;INFR;FUT;PFV;3;PL;NEG;INTR
yontmak	yontmuyor muydunuz	V;IND;PST;PROG;2;PL;NEG;INTR
ayin	ayinin	N;GEN;SG
savaşmak	savaşıyor olmalı mıyız	V;OBLIG;PRS;PROG;1;PL;INTR;POS
tabansız	tabansızmış	N;ARGNO3S;SG;LGSPEC2
astronot	astronotlarımızda	N;LOC;PL;PSS1P
cezalandırmak	cezalandırır mıymışım	V;INFR;PRS;HAB;1;SG;INTR;POS
dalgalandırmak	dalgalandırıyor olmalıymışsın	V;OBLIG;INFR;PRS;PROG;2;SG;POS;DECL
düşman	düşmanlarının	N;GEN;PL;PSS2S
göçmen kampı	göçmen kamplarından	N;ABL;PL
çedar	çedarlarmışız	N;ARGNO1P;PL;LGSPEC2
kalp	kalplerinin	N;GEN;PL;PSS3S
ulus	uluslarımızda	N;LOC;PL;PSS1P
dirilmek	dirilmeyeceksiniz	V;IND;FUT;2;PL;NEG;DECL
uğratmak	uğratıyor olmalıydınız	V;OBLIG;PST;PROG;2;PL;POS;DECL
dokumak	dokumameli	V;OBLIG;PRS;3;SG;NEG;DECL
işitmek	işitiyor olmalı mısın	V;OBLIG;PRS;PROG;2;SG;INTR;POS
coşmak	coşuyor olmamalıymış	V;OBLIG;INFR;PRS;PROG;3;SG;NEG;DECL
şaşırtmak	şaşırtmış olacak mıyız	V;INFR;FUT;PFV;1;PL;INTR;POS
kırmak	kırıyor olacak mıymışsınız	V;INFR;FUT;PROG;2;PL;INTR;POS
dolamak	dolar olmayacak mıymışsın	V;INFR;FUT;HAB;2;SG;NEG;INTR
oynamak	oynuyor olmayacaklar mıydı	V;IND;PST;PROSP+PROG;3;PL;NEG;INTR
başarılı	başarılı mıymışız?	ADJ;LGSPEC1;LGSPEC2;1;PL;POS;INTR
sevişmek	sevişmiyor musun	V;IND;PRS;PROG;2;SG;NEG;INTR
sökmek	sökmemeliyim	V;OBLIG;PRS;1;SG;NEG;DECL
kadayıf	kadayıflar	N;NOM;PL
hastalanmak	hastalanıyor olmayacaklar mıymış	V;INFR;FUT;PROG;3;PL;NEG;INTR
güzelleştirmek	güzelleştiriyordunuz	V;IND;PST;PROG;2;PL;POS;DECL
işitmek	işitiyor muyuz	V;IND;PRS;PROG;1;PL;INTR;POS
çan	çanımızdan	N;ABL;SG;PSS1P
katılaşmak	katılaşmamışmışım	V;INFR;LGSPEC1;PST;1;SG;NEG;DECL
ananas	ananaslarımız	N;NOM;PL;PSS1P
orta parmak	orta parmağımızdan	N;ABL;SG;PSS1P
eğlenmek	eğleniyor olacaktınız	V;IND;PST;PROSP+PROG;2;PL;POS;DECL
delmek	delecek miyiz	V;IND;FUT;1;PL;INTR;POS
tıraş olmak	tıraş oluyor olurlardı	V;IND;PST;HAB+PROG;3;PL;POS;DECL
burun	burunlarını	N;ACC;PL;PSS2S
yolunmak	yolunmalı mıydık	V;OBLIG;PST;1;PL;INTR;POS
germek	germeli miydik	V;OBLIG;PST;1;PL;INTR;POS
uğratmak	uğratacak olmayacak mıymış	V;INFR;FUT;PROSP;3;SG;NEG;INTR
eğilmek	eğilmiyormuşsunuz	V;INFR;PRS;PROG;2;PL;NEG;DECL
ölçüşmek	ölçüşecek olacak mıyım	V;IND;FUT;PROSP;1;SG;INTR;POS
molekül	molekülünü	N;ACC;SG;PSS2S
sıyırmak	sıyırdı mı	V;IND;PST;3;SG;INTR;POS
çarşaf	çarşafımızdan	N;ABL;SG;PSS1P
denilmek	deniliyor muydun	V;IND;PST;PROG;2;SG;INTR;POS
deşmek	deşmedilerdi	V;IND;PST;PFV;3;PL;NEG;DECL
ayarlanmak	ayarlanacak olacağım	V;IND;FUT;PROSP;1;SG;POS;DECL
sünnet derisi	sünnet derisinin	N;GEN;SG
onamak	onuyor olmayacakmışız	V;INFR;FUT;PROG;1;PL;NEG;DECL
taramak	taramalıydım	V;OBLIG;PST;1;SG;POS;DECL
damat	damatların	N;GEN;PL
lügat	lügatin	N;GEN;SG
nefes aldırmak	nefes aldırmayacaksın	V;IND;FUT;2;SG;NEG;DECL
abartmak	abartacak olacak mıymışsın	V;INFR;FUT;PROSP;2;SG;INTR;POS
kaynaştırtılmak	kaynaştırtılmış olacak mıyız	V;INFR;FUT;PFV;1;PL;INTR;POS
sağmak	sağmamışlardı	V;INFR;PST;PFV;3;PL;NEG;DECL
savaşmak	savaşmayacaklar mı	V;IND;FUT;3;PL;NEG;INTR
kırılmak	kırılmamalı mıydın	V;OBLIG;PST;2;SG;NEG;INTR
değişmek	değişiyor olmalılar mı	V;OBLIG;PRS;PROG;3;PL;INTR;POS
fotoğraf	fotoğrafınızı	N;ACC;SG;PSS2P
asmak	asmeliler mi	V;OBLIG;PRS;3;PL;INTR;POS
sürünmek	sürünmüyor musun	V;IND;PRS;PROG;2;SG;NEG;INTR
daldırtmak	daldırtacak mıymışız	V;INFR;FUT;1;PL;INTR;POS
boyamak	boyamış mıydı	V;INFR;PST;PFV;3;SG;INTR;POS
izlek	izleği	N;NOM;SG;PSS3S
heyecanlandırtmak	heyecanlandırtır mıydınız	V;IND;PST;HAB;2;PL;INTR;POS
kaynaştırtılmak	kaynaştırtılıyor olmayacaksınız	V;IND;FUT;PROG;2;PL;NEG;DECL
ayarlattırmak	ayarlattırmadıydım	V;IND;PST;PFV;1;SG;NEG;DECL
görmek	görmüşüz	V;INFR;PST;1;PL;POS;DECL
Türkçeleştirmek	Türkçeleştirmeyiniz	V;IMP;2;PL;LGSPEC2;NEG;DECL
kaçırmak	kaçırıyor olacak mıydım	V;IND;PST;PROSP+PROG;1;SG;INTR;POS
kırbaç	kırbacın	N;GEN;SG
süt sağmak	süt sağıyor olacaklardı	V;IND;PST;PROSP+PROG;3;PL;POS;DECL
şişmek	şişecektik	V;IND;PST;PROSP;1;PL;POS;DECL
artmak	artacak olmayacak mısınız	V;IND;FUT;PROSP;2;PL;NEG;INTR
abazan	abazan mıydılar?	ADJ;LGSPEC1;PST;3;PL;POS;INTR
yormak	yormuş olacaklardı	V;INFR;PST;PROSP;3;PL;POS;DECL
anmak	anmıştınız	V;INFR;PST;PFV;2;PL;POS;DECL
ermek	eriyor olacak mıyız	V;IND;FUT;PROG;1;PL;INTR;POS
görmek	görüyor olmamalı mıydım	V;OBLIG;PST;PROG;1;SG;NEG;INTR
analitik geometri	analitik geometrisinden	N;ABL;SG;PSS3S
ürkmek	ürküyor olmalılar mıydı	V;OBLIG;PST;PROG;3;PL;INTR;POS
gürz	gürzlerde	N;LOC;PL
salmak	salmışmışım	V;INFR;LGSPEC1;PST;1;SG;POS;DECL
solumak	solursunuz	V;IND;PRS;HAB;2;PL;POS;DECL
canlandırmamak	canlandırmamamış mı	V;INFR;PST;3;SG;NEG;INTR
işlemek	işlemişler miydi	V;INFR;PST;PFV;3;PL;INTR;POS
ekşimek	ekşimemeliydi	V;OBLIG;PST;3;SG;NEG;DECL
bulamak	bulamalı mıydım	V;OBLIG;PST;1;SG;INTR;POS
yormak	yormuyordun	V;IND;PST;PROG;2;SG;NEG;DECL
süründürmek	süründürmez miymişsin	V;INFR;PRS;HAB;2;SG;NEG;INTR
yolunmak	yolunacak olmayacakmış	V;INFR;FUT;PROSP;3;SG;NEG;DECL
sürtmek	sürtüyor olmazdın	V;IND;PST;HAB+PROG;2;SG;NEG;DECL
atmamak	atmıyor musun	V;IND;PRS;PROG;2;SG;INTR;POS
ayırmak	ayırıyor olmalı mıyım	V;OBLIG;PRS;PROG;1;SG;INTR;POS
üzülmek	üzülüyor olacak mıydım	V;IND;PST;PROSP+PROG;1;SG;INTR;POS
güneş gözlüğü	güneş gözlüğünün	N;GEN;SG
şeriat	şeriatlerden	N;ABL;PL
darılmak	darılmıyor muymuşsun	V;INFR;PRS;PROG;2;SG;NEG;INTR
dağılmak	dağılacakmışız	V;INFR;FUT;1;PL;POS;DECL
izlemek	izliyor olurdum	V;IND;PST;HAB+PROG;1;SG;POS;DECL
örmek	örüyor olmayacak mı	V;IND;FUT;PROG;3;SG;NEG;INTR
tekila	tekilasında	N;LOC;SG;PSS3S
ezmek	eziyor olacak mıyız	V;IND;FUT;PROG;1;PL;INTR;POS
açmak	açıyor olacaktınız	V;IND;PST;PROSP+PROG;2;PL;POS;DECL
dalgalandırmak	dalgalandırmameli misiniz	V;OBLIG;PRS;2;PL;NEG;INTR
gerinmek	gerindim mi	V;IND;PST;1;SG;INTR;POS
hareket etmek	hareket etmiş miymişim	V;INFR;LGSPEC1;PST;1;SG;INTR;POS
takmak	takmıyor muymuş	V;INFR;PRS;PROG;3;SG;NEG;INTR
kesmek	kesmemişler miymiş	V;INFR;LGSPEC1;PST;3;PL;NEG;INTR
kılık	kılıklarımızın	N;GEN;PL;PSS1P
cızlamı çekmek	cızlamı çekiyor olmaz mıydın	V;IND;PST;HAB+PROG;2;SG;NEG;INTR
bütün	bütünlerinizi	N;ACC;PL;PSS2P
desen	desenimizden	N;ABL;SG;PSS1P
neden	nedenlermiş	N;ARGNO3P;PL;LGSPEC2
şirket	şirketimizin	N;GEN;SG;PSS1P
bükmemek	büküyor olmamalı mıymışız	V;OBLIG;INFR;PRS;PROG;1;PL;NEG;INTR
tensör	tensörümüze	N;DAT;SG;PSS1P
ölçtürmek	ölçtürüyor olmamalıymışsın	V;OBLIG;INFR;PRS;PROG;2;SG;NEG;DECL
dönmek	dönmüyordum	V;IND;PST;PROG;1;SG;NEG;DECL
bozmak	bozar mıydık	V;IND;PST;HAB;1;PL;INTR;POS
delmek	delmeyecek miymişsin	V;INFR;FUT;2;SG;NEG;INTR
giymek	giyiyor olacak	V;IND;FUT;PROG;3;SG;POS;DECL
kaçırmak	kaçırmış olmayacaklar mıydı	V;INFR;PST;PROSP;3;PL;NEG;INTR
reaktör	reaktörün	N;GEN;SG
hülya	hülyalarının	N;GEN;PL;PSS3S
utandırmak	utandırmış olacak mısınız	V;INFR;FUT;PFV;2;PL;INTR;POS
barışmak	barışmamış mıyım	V;INFR;PST;1;SG;NEG;INTR
silmek	silerdiniz	V;IND;PST;HAB;2;PL;POS;DECL
Yahudi	Yahudinden	N;ABL;SG;PSS2S
kovdurtmak	kovdurtmadı mı	V;IND;PST;3;SG;NEG;INTR
süpürmek	süpürecek olmayacakmışsın	V;INFR;FUT;PROSP;2;SG;NEG;DECL
dolamak	doluyor olmalı mıymışım	V;OBLIG;INFR;PRS;PROG;1;SG;INTR;POS
ılımak	ılıyorsun	V;IND;PRS;PROG;2;SG;POS;DECL
katılaşmak	katılaşacak olmayacaklar mıymış	V;INFR;FUT;PROSP;3;PL;NEG;INTR
kaza	kazanı	N;ACC;SG;PSS2S
germek	geriyor olmalısınız	V;OBLIG;PRS;PROG;2;PL;POS;DECL
gerinmek	gerinmiştin	V;INFR;PST;PFV;2;SG;POS;DECL
kapamak	kapıyor muymuşum	V;INFR;PRS;PROG;1;SG;INTR;POS
taklitçi olmak	taklitçi olurmuşsunuz	V;INFR;PRS;HAB;2;PL;POS;DECL
sümürmek	sümürecekti	V;IND;PST;PROSP;3;SG;POS;DECL
yazmak	yazmamışmışsın	V;INFR;LGSPEC1;PST;2;SG;NEG;DECL
belirsiz integral	belirsiz integralleriniz	N;NOM;PL;PSS2P
gütmek	gütmüş olmayacaklar	V;INFR;FUT;PFV;3;PL;NEG;DECL
susmak	susarsın	V;IND;PRS;HAB;2;SG;POS;DECL
dağıtmak	dağıtmış olmayacaksın	V;INFR;FUT;PFV;2;SG;NEG;DECL
onamak	onuyor mu	V;IND;PRS;PROG;3;SG;INTR;POS
kulağını bükmek	büküyor olacaktık	V;IND;PST;PROSP+PROG;1;PL;POS;DECL
sattırtmak	sattırtıyor olacaklar mı	V;IND;FUT;PROG;3;PL;INTR;POS
ılımak	ılımıyor muydun	V;IND;PST;PROG;2;SG;NEG;INTR
bulamak	buluyor olacak mıydınız	V;IND;PST;PROSP+PROG;2;PL;INTR;POS
şaşırmak	şaşırmıyordun	V;IND;PST;PROG;2;SG;NEG;DECL
zağar	zağarımızda	N;LOC;SG;PSS1P
bilgisayarlı	bilgisayarlıymış	ADJ;LGSPEC1;LGSPEC2;3;SG;POS;DECL
fanus	fanusundan	N;ABL;SG;PSS3S
cevap vermek	cevap vermemeli miyiz	V;OBLIG;PRS;1;PL;NEG;INTR
seks yapmak	seks yapacak olacak	V;IND;FUT;PROSP;3;SG;POS;DECL
mimari desen	mimari desenimize	N;DAT;SG;PSS1P
makyaj yapmak	makyaj yapıyor olur muyduk	V;IND;PST;HAB+PROG;1;PL;INTR;POS
kurtarmak	kurtarıyor muyum	V;IND;PRS;PROG;1;SG;INTR;POS
amatör	amatörlerinize	N;DAT;PL;PSS2P
koyulaşmak	koyulaşmıyorsun	V;IND;PRS;PROG;2;SG;NEG;DECL
ek	ek	N;NOM;SG
gübre	gübrelerinde	N;LOC;PL;PSS3S
âşık olmak	âşık oluyor olmayacaklar	V;IND;FUT;PROG;3;PL;NEG;DECL
şaşırttırmak	şaşırttırmameli miyiz	V;OBLIG;PRS;1;PL;NEG;INTR
kaynamak	kaynamalı mıymışız	V;OBLIG;INFR;PST;1;PL;INTR;POS
hamak	hamaklardan	N;ABL;PL
yendirmek	yendirmiş olmayacak mıydın	V;INFR;PST;PROSP;2;SG;NEG;INTR
aldatmak	aldatıyor olmayacakmış	V;INFR;FUT;PROG;3;SG;NEG;DECL
ölümsüzleştirmek	ölümsüzleştiriyor olmalıymış	V;OBLIG;INFR;PRS;PROG;3;SG;POS;DECL
sıvılaştırmak	sıvılaştırmazlardı	V;IND;PST;HAB;3;PL;NEG;DECL
garp	garpları	N;ACC;PL
öpüşmek	öpüşmezdim	V;IND;PST;HAB;1;SG;NEG;DECL
havlu atmak	havlu atmamıştınız	V;INFR;PST;PFV;2;PL;NEG;DECL
yendirmek	yendirmeli miydim	V;OBLIG;PST;1;SG;INTR;POS
ölmek	ölecek olacakmışız	V;INFR;FUT;PROSP;1;PL;POS;DECL
mevzu	mevzundan	N;ABL;SG;PSS2S
heyecanlandırmak	heyecanlandırmış	V;INFR;PST;3;SG;POS;DECL
süsmek	süsmemelilermiş	V;OBLIG;INFR;PST;3;PL;NEG;DECL
falcı	falcılardınız	N;ARGNO2P;PL;PST
işlemek	işliyor olacak	V;IND;FUT;PROG;3;SG;POS;DECL
uyanmak	uyanmıyor muyuz	V;IND;PRS;PROG;1;PL;NEG;INTR
kırdırmak	kırdırınız	V;IMP;2;PL;LGSPEC2;POS;DECL
bitirttirmek	bitirttirmişmişiz	V;INFR;LGSPEC1;PST;1;PL;POS;DECL
göstermek	gösteriyor olurduk	V;IND;PST;HAB+PROG;1;PL;POS;DECL
oynamak	oynuyor olacaktı	V;IND;PST;PROSP+PROG;3;SG;POS;DECL
öpüşmek	öpüşür olacakmışsın	V;INFR;FUT;HAB;2;SG;POS;DECL
dolap çevirmek	dolap çeviriyor olmalı mıydınız	V;OBLIG;PST;PROG;2;PL;INTR;POS
oynamak	oynar mıyım	V;IND;PRS;HAB;1;SG;INTR;POS
savunmak	savunuyor olmamalı mıymış	V;OBLIG;INFR;PRS;PROG;3;SG;NEG;INTR
un	unlarınızdan	N;ABL;PL;PSS2P
ucube	ucubeyim	N;ARGNO1S;SG;PRS
aldırtmak	aldırtmayacak mıydık	V;IND;PST;PROSP;1;PL;NEG;INTR
öldürtülmek	öldürtülürüm	V;IND;PRS;HAB;1;SG;POS;DECL
hece	hecelermişiz	N;ARGNO1P;PL;LGSPEC2
sinirlendirmek	sinirlendiriyor olmamalıymışsınız	V;OBLIG;INFR;PRS;PROG;2;PL;NEG;DECL
uçmak	uçmuş olmayacak mısın	V;INFR;FUT;PFV;2;SG;NEG;INTR
evlenmek	evlendiydi	V;IND;PST;PFV;3;SG;POS;DECL
açmak	açacak olacak mı	V;IND;FUT;PROSP;3;SG;INTR;POS
rahatsızlanmak	rahatsızlanmıyor mu	V;IND;PRS;PROG;3;SG;NEG;INTR
saklamak	saklayacak olmayacak mıyız	V;IND;FUT;PROSP;1;PL;NEG;INTR
heyecanlandırtmak	heyecanlandırtıyor olmalıymış	V;OBLIG;INFR;PRS;PROG;3;SG;POS;DECL
haberleşmek	haberleşmeyecek	V;IND;FUT;3;SG;NEG;DECL
üşümek	üşüyorlardı	V;IND;PST;PROG;3;PL;POS;DECL
düğün	düğünümüze	N;DAT;SG;PSS1P
meni	menilerine	N;DAT;PL;PSS2S
öldürtülmek	öldürtülmezmişiz	V;INFR;PRS;HAB;1;PL;NEG;DECL
itmek	itiyor olmamalılar mıymış	V;OBLIG;INFR;PRS;PROG;3;PL;NEG;INTR
üzmek	üzerdim	V;IND;PST;HAB;1;SG;POS;DECL
sığmak	sığacak mıymış	V;INFR;FUT;3;SG;INTR;POS
canlandırtmak	canlandırtacak olmayacak mıymışsın	V;INFR;FUT;PROSP;2;SG;NEG;INTR
hastalanmak	hastalanmış olacaksınız	V;INFR;FUT;PFV;2;PL;POS;DECL
evlenmek	evleniyor olmalıydınız	V;OBLIG;PST;PROG;2;PL;POS;DECL
kapamak	kapamıyor muymuşum	V;INFR;PRS;PROG;1;SG;NEG;INTR
satmak	satıyor olmamalıyım	V;OBLIG;PRS;PROG;1;SG;NEG;DECL
savaşçı	savaşçına	N;DAT;SG;PSS2S
girdap	girdaptan	N;ABL;SG
kalfa	kalfadan	N;ABL;SG
dolap çevirmek	dolap çeviriyor olmayacaklar	V;IND;FUT;PROG;3;PL;NEG;DECL
yaptırtmak	yaptırtmış olmayacaktık	V;INFR;PST;PROSP;1;PL;NEG;DECL
yontmak	yontuyor olacak mıymışsın	V;INFR;FUT;PROG;2;SG;INTR;POS
bilgisayar korsanı	bilgisayar korsanlarından	N;ABL;PL
yüksek fırın	yüksek fırınlarmışız	N;ARGNO1P;PL;LGSPEC2
erimek	erimiş olmayacak mıydın	V;INFR;PST;PROSP;2;SG;NEG;INTR
sürümek	sürümüşler miymiş	V;INFR;LGSPEC1;PST;3;PL;INTR;POS
yalamak	yalamamalı mıydınız	V;OBLIG;PST;2;PL;NEG;INTR
korkmak	korkacak mıyız	V;IND;FUT;1;PL;INTR;POS
yoldurmak	yoldurmadın mı	V;IND;PST;2;SG;NEG;INTR
ilköğretim	ilköğretimimizi	N;ACC;SG;PSS1P
bıkmak	bıkmameli misin	V;OBLIG;PRS;2;SG;NEG;INTR
saklanmak	saklanır mıyım	V;IND;PRS;HAB;1;SG;INTR;POS
kötüleşmek	kötüleşmiş olmayacaklardı	V;INFR;PST;PROSP;3;PL;NEG;DECL
laterna	laternalarda	N;LOC;PL
etkilemek	etkilerdiniz	V;IND;PST;HAB;2;PL;POS;DECL
yoksullaştırmak	yoksullaştıracakmışsınız	V;INFR;FUT;2;PL;POS;DECL
gülünçleşmek	gülünçleşiyor olacaktınız	V;IND;PST;PROSP+PROG;2;PL;POS;DECL
takmak	takıyor olmalı mıymışsın	V;OBLIG;INFR;PRS;PROG;2;SG;INTR;POS
ayırmak	ayıracak olmayacakmışsınız	V;INFR;FUT;PROSP;2;PL;NEG;DECL
bezmek	beziyor olmayacaklar mıydı	V;IND;PST;PROSP+PROG;3;PL;NEG;INTR
şaşırtmak	şaşırtmamalı mıymışım	V;OBLIG;INFR;PST;1;SG;NEG;INTR
nohut	nohutlardınız	N;ARGNO2P;PL;PST
Türkçeleştirmek	Türkçeleştiriyor olurdum	V;IND;PST;HAB+PROG;1;SG;POS;DECL
süt sağmak	süt sağıyor olmayacaklar mıydı	V;IND;PST;PROSP+PROG;3;PL;NEG;INTR
sarmaşık	sarmaşığımıza	N;DAT;SG;PSS1P
yanmak	yanacakmışız	V;INFR;FUT;1;PL;POS;DECL
doğurmak	doğurmuyor muydun	V;IND;PST;PROG;2;SG;NEG;INTR
parçalanmak	parçalanmameli misiniz	V;OBLIG;PRS;2;PL;NEG;INTR
okumak	okumuşlar mıydı	V;INFR;PST;PFV;3;PL;INTR;POS
kazmak	kazmaz mısın	V;IND;PRS;HAB;2;SG;NEG;INTR
keşfetmek	keşfetmemeliymiş	V;OBLIG;INFR;PST;3;SG;NEG;DECL
kakmak	kakmış olmayacak mı	V;INFR;FUT;PFV;3;SG;NEG;INTR
yontulmak	yontuluyor olacakmışız	V;INFR;FUT;PROG;1;PL;POS;DECL
eşcinsel	eşcinselin	N;GEN;SG
yağlamak	yağlayacakmışsın	V;INFR;FUT;2;SG;POS;DECL
bükmek	bükmüş olacak mıydım	V;INFR;PST;PROSP;1;SG;INTR;POS
kaşe	kaşeleri	N;NOM;PL;PSS3S
şüphe	şüphenin	N;GEN;SG;PSS2S
taşmak	taşmıyor muymuşuz	V;INFR;PRS;PROG;1;PL;NEG;INTR
öldürtülmek	öldürtülmüyorlarmış	V;INFR;PRS;PROG;3;PL;NEG;DECL
çatmak	çatıyor olacaktınız	V;IND;PST;PROSP+PROG;2;PL;POS;DECL
kapatmak	kapatmameli	V;OBLIG;PRS;3;SG;NEG;DECL
ağaç çivi	ağaç çivilersin	N;ARGNO2S;PL;PRS
işlemek	işlemiyor mu	V;IND;PRS;PROG;3;SG;NEG;INTR
bulunmak	bulunuyor olmamalı mısınız	V;OBLIG;PRS;PROG;2;PL;NEG;INTR
etkilemek	etkilemişlerdi	V;INFR;PST;PFV;3;PL;POS;DECL
dirilmemek	dirilmemiş miymişsin	V;INFR;LGSPEC1;PST;2;SG;INTR;POS
sermek	sermez miydi	V;IND;PST;HAB;3;SG;NEG;INTR
kıble	kıblelerini	N;ACC;PL;PSS3S
birleştirtmek	birleştirtmez miyim	V;IND;PRS;HAB;1;SG;NEG;INTR
yazıt	yazıtınızın	N;GEN;SG;PSS2P
yanıt vermek	yanıt verirler mi	V;IND;PRS;HAB;3;PL;INTR;POS
öfkelendirmek	öfkelendirmemeliydi	V;OBLIG;PST;3;SG;NEG;DECL
üretmek	üretiyor olacaktın	V;IND;PST;PROSP+PROG;2;SG;POS;DECL
pişirmek	pişiriyorlarmış	V;INFR;PRS;PROG;3;PL;POS;DECL
enjektör	enjektörün	N;GEN;SG
bulunmak	bulunmuşuz	V;INFR;PST;1;PL;POS;DECL
ilklendirme	ilklendirmeydiniz	N;ARGNO2P;SG;PST
oturmak	oturmuşum	V;INFR;PST;1;SG;POS;DECL
ekşimek	ekşimiş olacaktın	V;INFR;PST;PROSP;2;SG;POS;DECL
kurbağacık	kurbağacıklarından	N;ABL;PL;PSS2S
içermek	içermedi mi	V;IND;PST;3;SG;NEG;INTR
kazmak	kazmalıymışız	V;OBLIG;INFR;PST;1;PL;POS;DECL
sıvılaşmak	sıvılaşıyor olmamalısınız	V;OBLIG;PRS;PROG;2;PL;NEG;DECL
kurutmak	kurutur muymuşuz	V;INFR;PRS;HAB;1;PL;INTR;POS
fındık kırmak	fındık kırıyor olacaktı	V;IND;PST;PROSP+PROG;3;SG;POS;DECL
gelinmek	gelinmeliymişiz	V;OBLIG;INFR;PST;1;PL;POS;DECL
ejderha	ejderhana	N;DAT;SG;PSS2S
korkmak	korkacak olacak mıymışsın	V;INFR;FUT;PROSP;2;SG;INTR;POS
ikincil sürüm	ikincil sürümlerinde	N;LOC;PL;PSS2S
öldürmek	öldürmeli miymiş	V;OBLIG;INFR;PST;3;SG;INTR;POS
olmak	olurdu	V;IND;PST;HAB;3;SG;POS;DECL
bayılmak	bayılmayacaksın	V;IND;FUT;2;SG;NEG;DECL
dövüşçü	dövüşçüsü	N;NOM;SG;PSS3S
tepmek	tepmemelisin	V;OBLIG;PRS;2;SG;NEG;DECL
dayamak	dayamış olacaktım	V;INFR;PST;PROSP;1;SG;POS;DECL
yendirmek	yendiriyor olmamalı mıydım	V;OBLIG;PST;PROG;1;SG;NEG;INTR
limonata	limonatasının	N;GEN;SG;PSS3S
canlanmamak	canlanmamış mıydık	V;INFR;PST;PFV;1;PL;INTR;POS
üst kavram	üst kavramımızdan	N;ABL;SG;PSS1P
sikişmek	sikişmemiş miymişsin	V;INFR;LGSPEC1;PST;2;SG;NEG;INTR
valiz	valizlerinde	N;LOC;PL;PSS3S
kimyacı	kimyacıda	N;LOC;SG
emlakçı	emlakçılarımızdan	N;ABL;PL;PSS1P
kuyruk	kuyruklarından	N;ABL;PL;PSS2S
bölüm	bölümden	N;ABL;SG
bulamak	bulamış olmayacağım	V;INFR;FUT;PFV;1;SG;NEG;DECL
küremek	küremiş olacaktınız	V;INFR;PST;PROSP;2;PL;POS;DECL
utandırmak	utandırmıyordunuz	V;IND;PST;PROG;2;PL;NEG;DECL
uyarmak	uyarmadım	V;IND;PST;1;SG;NEG;DECL
striptiz	striptizinizin	N;GEN;SG;PSS2P
makyaj yapmak	makyaj yapıyor olmalıydın	V;OBLIG;PST;PROG;2;SG;POS;DECL
bitirmek	bitiriyor muyuz	V;IND;PRS;PROG;1;PL;INTR;POS
haber	haberlerinde	N;LOC;PL;PSS2S
yedirmek	yedirmemelilerdi	V;OBLIG;PST;3;PL;NEG;DECL
tundra	tundralarmışız	N;ARGNO1P;PL;LGSPEC2
dirilmek	dirilmiş olmayacaktınız	V;INFR;PST;PROSP;2;PL;NEG;DECL
kış uykusuna yatmak	kış uykusuna yatacağım	V;IND;FUT;1;SG;POS;DECL
tepmek	tepmeyecektim	V;IND;PST;PROSP;1;SG;NEG;DECL
saydırmak	saydırmış mı	V;INFR;PST;3;SG;INTR;POS
şişmek	şişmiş olmayacaktın	V;INFR;PST;PROSP;2;SG;NEG;DECL
işçi	işçiler	N;NOM;PL
patlamak	patlamamışmışız	V;INFR;LGSPEC1;PST;1;PL;NEG;DECL
pişman olmak	pişman olurum	V;IND;PRS;HAB;1;SG;POS;DECL
dermek	dermemeliydiniz	V;OBLIG;PST;2;PL;NEG;DECL
mustatil	mustatili	N;ACC;SG
çürümek	çürümemiş misiniz	V;INFR;PST;2;PL;NEG;INTR
utanmak	utanmış olacaktın	V;INFR;PST;PROSP;2;SG;POS;DECL
omlet	omletlerinin	N;GEN;PL;PSS3S
donatım	donatımların	N;NOM;PL;PSS2S
kuzu	kuzular	N;NOM;PL
tıkmak	tıkıyor olmaz mıydık	V;IND;PST;HAB+PROG;1;PL;NEG;INTR
anjiyo	anjiyomuzda	N;LOC;SG;PSS1P
bilgisayarlı	bilgisayarlı değil miymişiz?	ADJ;LGSPEC1;LGSPEC2;1;PL;NEG;INTR
öldürtülmek	öldürtülür müydüm	V;IND;PST;HAB;1;SG;INTR;POS
erkecey	erkeceyiz	N;ARGNO1P;SG;PRS
makina	makinanın	N;GEN;SG;PSS2S
almak	alıyor olurlardı	V;IND;PST;HAB+PROG;3;PL;POS;DECL
paylaştırma	paylaştırmalarını	N;ACC;PL;PSS3S
gütmek	güdecek olmayacaksın	V;IND;FUT;PROSP;2;SG;NEG;DECL
yaymak	yaymadınız mı	V;IND;PST;2;PL;NEG;INTR
öğrenci	öğrencilerde	N;LOC;PL
ittirmek	ittirmemeliyiz	V;OBLIG;PRS;1;PL;NEG;DECL
germek	gerecek	V;IND;FUT;3;SG;POS;DECL
ittirtilmek	ittirtilmeyecek	V;IND;FUT;3;SG;NEG;DECL
ittirmek	ittiriyor olmaz mıydın	V;IND;PST;HAB+PROG;2;SG;NEG;INTR
ortam	ortammışız	N;ARGNO1P;SG;LGSPEC2
burkmak	burkuyor olmalı mıydın	V;OBLIG;PST;PROG;2;SG;INTR;POS
can vermek	can veriyor olmamalı mıymışsınız	V;OBLIG;INFR;PRS;PROG;2;PL;NEG;INTR
tütüncü	tütüncüde	N;LOC;SG
büktürtmemek	büktürtmemezlerdi	V;IND;PST;HAB;3;PL;NEG;DECL
ittirmek	ittiriyor olmazdım	V;IND;PST;HAB+PROG;1;SG;NEG;DECL
saldırmak	saldırmıyormuş	V;INFR;PRS;PROG;3;SG;NEG;DECL
sepet	sepetinden	N;ABL;SG;PSS3S
gebermek	gebermez miydin	V;IND;PST;HAB;2;SG;NEG;INTR
sindirmek	sindirmemiş misiniz	V;INFR;PST;2;PL;NEG;INTR
kuram	kuramlarda	N;LOC;PL
hükûmet	hükûmetsin	N;ARGNO2S;SG;PRS
kaynaştırtılmak	kaynaştırtılmadı mıydık	V;IND;PST;PFV;1;PL;NEG;INTR
çerçi	çerçilermiş	N;ARGNO3S;PL;LGSPEC2
akşamdan kalma	akşamdan kalmaydım	N;ARGNO1S;SG;PST
konmak	konmamalı mıymışsınız	V;OBLIG;INFR;PST;2;PL;NEG;INTR
eşofman	eşofmanının	N;GEN;SG;PSS2S
kaynamak	kaynamadı mıydık	V;IND;PST;PFV;1;PL;NEG;INTR
dolmak	dolmamış mısınız	V;INFR;PST;2;PL;NEG;INTR
birleştirtmek	birleştirtiyor olacaklar mıydı	V;IND;PST;PROSP+PROG;3;PL;INTR;POS
ezmek	ezmiş olacak mıydın	V;INFR;PST;PROSP;2;SG;INTR;POS
kaynaştırılmak	kaynaştırılmeliler mi	V;OBLIG;PRS;3;PL;INTR;POS
ölçtürmek	ölçtürmüşlerdi	V;INFR;PST;PFV;3;PL;POS;DECL
el sıkışmak	el sıkışmadık	V;IND;PST;1;PL;NEG;DECL
kopmak	kopmamışmış	V;INFR;LGSPEC1;PST;3;SG;NEG;DECL
yendirtmek	yendirtmezdi	V;IND;PST;HAB;3;SG;NEG;DECL
katmak	katıyor olmalı mıyım	V;OBLIG;PRS;PROG;1;SG;INTR;POS
itilmek	itilirlermiş	V;INFR;PRS;HAB;3;PL;POS;DECL
geçmek	geçmediydiniz	V;IND;PST;PFV;2;PL;NEG;DECL
kanıtlamak	kanıtlıyor olmamalı mısın	V;OBLIG;PRS;PROG;2;SG;NEG;INTR
sümürmek	sümürecek olmayacakmışsın	V;INFR;FUT;PROSP;2;SG;NEG;DECL
döndürmek	döndürmüş olacak mıydı	V;INFR;PST;PROSP;3;SG;INTR;POS
tükürmek	tükürmeyecek miydi	V;IND;PST;PROSP;3;SG;NEG;INTR
çökmek	çökmüş müymüşüm	V;INFR;LGSPEC1;PST;1;SG;INTR;POS
yığmak	yığıyor olmayacağım	V;IND;FUT;PROG;1;SG;NEG;DECL
papa	papaydın	N;ARGNO2S;SG;PST
dilim	dilimlerinden	N;ABL;PL;PSS3S
peynir	peynirinden	N;ABL;SG;PSS2S
pişman olmak	pişman olmamış mıydınız	V;INFR;PST;PFV;2;PL;NEG;INTR
can vermek	can vermişler miydi	V;INFR;PST;PFV;3;PL;INTR;POS
işlemci	işlemcilere	N;DAT;PL
cavlağı çekmek	cavlağı çekmeli miymişsiniz	V;OBLIG;INFR;PST;2;PL;INTR;POS
pim	pimlerinizde	N;LOC;PL;PSS2P
itmek	itmemeli miymişsiniz	V;OBLIG;INFR;PST;2;PL;NEG;INTR
süründürmek	süründürür müydüm	V;IND;PST;HAB;1;SG;INTR;POS
bölmek	bölmüş olacaksınız	V;INFR;FUT;PFV;2;PL;POS;DECL
sevmek	sevmiyordunuz	V;IND;PST;PROG;2;PL;NEG;DECL
kolaj	kolajlarımızda	N;LOC;PL;PSS1P
fal	fallarınızdan	N;ABL;PL;PSS2P
sınamak	sınar olacakmışsın	V;INFR;FUT;HAB;2;SG;POS;DECL
hastalanmak	hastalanıyor olmamalı	V;OBLIG;PRS;PROG;3;SG;NEG;DECL
yıpranmak	yıpranıyor olmayacak mı	V;IND;FUT;PROG;3;SG;NEG;INTR
öldürtülmek	öldürtülmemeli miymiş	V;OBLIG;INFR;PST;3;SG;NEG;INTR
peder	pederlerden	N;ABL;PL
sahipli yazılım	sahipli yazılımlarınızdan	N;ABL;PL;PSS2P
üremek	üremezsin	V;IND;PRS;HAB;2;SG;NEG;DECL
örtmek	örtmediler miydi	V;IND;PST;PFV;3;PL;NEG;INTR
sanmak	sanıyor olur muydu	V;IND;PST;HAB+PROG;3;SG;INTR;POS
küçük	küçük değil miydi?	ADJ;LGSPEC1;PST;3;SG;NEG;INTR
parçalanmak	parçalanmeliyiz	V;OBLIG;PRS;1;PL;POS;DECL
yoğurmak	yoğurmuyor muydu	V;IND;PST;PROG;3;SG;NEG;INTR
küsmek	küsüyor olmazdık	V;IND;PST;HAB+PROG;1;PL;NEG;DECL
örmek	örmeli miydin	V;OBLIG;PST;2;SG;INTR;POS
emmek	emecek olmayacak	V;IND;FUT;PROSP;3;SG;NEG;DECL
saklamak	saklayacak olmayacaksınız	V;IND;FUT;PROSP;2;PL;NEG;DECL
öğrenci	öğrencileriniz	N;NOM;PL;PSS2P
erimek	erimemişim	V;INFR;PST;1;SG;NEG;DECL
kazmak	kazıyor olmalı mıydık	V;OBLIG;PST;PROG;1;PL;INTR;POS
açılmak	açılmıştık	V;INFR;PST;PFV;1;PL;POS;DECL
bezmek	bezecek	V;IND;FUT;3;SG;POS;DECL
hudut	hudutlarımızda	N;LOC;PL;PSS1P
titremek	titriyor olacaklar	V;IND;FUT;PROG;3;PL;POS;DECL
erimek	erimeli	V;OBLIG;PRS;3;SG;POS;DECL
demek	diyor	V;OBLIG;PRS;PROG;3;SG;POS;DECL
özne	öznesi	N;NOM;SG;PSS3S
açılmak	açılmeliler	V;OBLIG;PRS;3;PL;POS;DECL
öpmek	öpmüşler miymiş	V;INFR;LGSPEC1;PST;3;PL;INTR;POS
içmek	içmeyeceksiniz	V;IND;FUT;2;PL;NEG;DECL
lepistes	lepisteslerimizi	N;ACC;PL;PSS1P
bükmemek	bükeecek olmayacaklar mıymış	V;INFR;FUT;PROSP;3;PL;NEG;INTR
vefat	vefatlar	N;NOM;PL
etkilemek	etkilemiyorlardı	V;IND;PST;PROG;3;PL;NEG;DECL
koklamak	koklar mıyız	V;IND;PRS;HAB;1;PL;INTR;POS
heyet	heyetinizi	N;ACC;SG;PSS2P
dermek	dermemeli miydin	V;OBLIG;PST;2;SG;NEG;INTR
bir avuç toprak olmak	bir avuç toprak oluyor olur muydun	V;IND;PST;HAB+PROG;2;SG;INTR;POS
ummak	umuyor olmalı mıymış	V;OBLIG;INFR;PRS;PROG;3;SG;INTR;POS
depresif	depresifmişiz	ADJ;LGSPEC1;LGSPEC2;1;PL;POS;DECL
kaynaç	kaynacımızın	N;GEN;SG;PSS1P
yedirtmek	yedirtmiş olacak mıyız	V;INFR;FUT;PFV;1;PL;INTR;POS
çıkarmak	çıkaracaklar mı	V;IND;FUT;3;PL;INTR;POS
parlatmak	parlatacak olmayacak	V;IND;FUT;PROSP;3;SG;NEG;DECL
ilerletmek	ilerletecek olacaklar mıymış	V;INFR;FUT;PROSP;3;PL;INTR;POS
devinim	devinimlerimizde	N;LOC;PL;PSS1P
biçim	biçimlerinize	N;DAT;PL;PSS2P
kandil	kandillerine	N;DAT;PL;PSS3S
sürünmek	sürünürler miymiş	V;INFR;PRS;HAB;3;PL;INTR;POS
saklamak	saklıyor olmayacaklar	V;IND;FUT;PROG;3;PL;NEG;DECL
atıştırmak	atıştırmış olacaksınız	V;INFR;FUT;PFV;2;PL;POS;DECL
hastalanmak	hastalanıyor olacaklar mı	V;IND;FUT;PROG;3;PL;INTR;POS
saymak	saymış olacaklar	V;INFR;FUT;PFV;3;PL;POS;DECL
yazmak	yazıyor olmamalıydı	V;OBLIG;PST;PROG;3;SG;NEG;DECL
albatros	albatroslarınıza	N;DAT;PL;PSS2P
artmak	artmalıymışsınız	V;OBLIG;INFR;PST;2;PL;POS;DECL
jelada	jeladalara	N;DAT;PL
pezevenk	pezevenkleriz	N;ARGNO1P;PL;PRS
sihirli	sihirli miymişiz?	ADJ;LGSPEC1;LGSPEC2;1;PL;POS;INTR
kovulmak	kovulmuş olmayacak mı	V;INFR;FUT;PFV;3;SG;NEG;INTR
çıldırtmak	çıldırtır olacaklarmış	V;INFR;FUT;HAB;3;PL;POS;DECL
geciktirmek	geciktiriyordu	V;IND;PST;PROG;3;SG;POS;DECL
coşmak	coşuyor olacak mıymışım	V;INFR;FUT;PROG;1;SG;INTR;POS
vermek	verdilerdi	V;IND;PST;PFV;3;PL;POS;DECL
bilmek	biliyor olmamalıydın	V;OBLIG;PST;PROG;2;SG;NEG;DECL
öldürmek	öldürüyor olacakmışım	V;INFR;FUT;PROG;1;SG;POS;DECL
barışmak	barışıyor olmazdık	V;IND;PST;HAB+PROG;1;PL;NEG;DECL
binmek	binmemeliymiş	V;OBLIG;INFR;PST;3;SG;NEG;DECL
programlanmak	programlanmış olacaktım	V;INFR;PST;PROSP;1;SG;POS;DECL
sahipli yazılım	sahipli yazılımınızda	N;LOC;SG;PSS2P
göndermek	göndermiş miydim	V;INFR;PST;PFV;1;SG;INTR;POS
kanmak	kanmelisiniz	V;OBLIG;PRS;2;PL;POS;DECL
hareket etmek	hareket edecek olacaklar mı	V;IND;FUT;PROSP;3;PL;INTR;POS
verimsizleştirmek	verimsizleştirmemiş miymiş	V;INFR;LGSPEC1;PST;3;SG;NEG;INTR
doğramak	doğradılar	V;IND;PST;3;PL;POS;DECL
yatay asimptot	yatay asimptotumuzda	N;LOC;SG;PSS1P
temsilcilik	temsilciliklerdi	N;ARGNO3P;PL;PST
çarşı	çarşımız	N;NOM;SG;PSS1P
kovdurmak	kovdurmeliyiz	V;OBLIG;PRS;1;PL;POS;DECL
heyecanlandırmak	heyecanlandırıyor olmayacak	V;IND;FUT;PROG;3;SG;NEG;DECL
şey	şeylerinde	N;LOC;PL;PSS3S
ucube	ucubesiniz	N;ARGNO2P;SG;PRS
kaynaştırtılmak	kaynaştırtılıyor olmamalıydım	V;OBLIG;PST;PROG;1;SG;NEG;DECL
ağlamak	ağlamamalıydık	V;OBLIG;PST;1;PL;NEG;DECL
korkmak	korkmayacaklar mıydı	V;IND;PST;PROSP;3;PL;NEG;INTR
gelmek	gelirler	V;IND;PRS;HAB;3;PL;POS;DECL
bir avuç toprak olmak	bir avuç toprak olmuyorlarmış	V;INFR;PRS;PROG;3;PL;NEG;DECL
kalmak	kalmadı mıydınız	V;IND;PST;PFV;2;PL;NEG;INTR
ıslık çalmak	ıslık çalmaz mıyım	V;IND;PRS;HAB;1;SG;NEG;INTR
kakmak	kakmış olmayacağım	V;INFR;FUT;PFV;1;SG;NEG;DECL
portakal	portakalınıza	N;DAT;SG;PSS2P
eskimek	eskimeli miydiniz	V;OBLIG;PST;2;PL;INTR;POS
seks yapmak	seks yapmayacak mıydın	V;IND;PST;PROSP;2;SG;NEG;INTR
piyano	piyano	N;NOM;SG
palikarya	palikaryayız	N;ARGNO1P;SG;PRS
yaptırtmak	yaptırtıyor olmayacak	V;IND;FUT;PROG;3;SG;NEG;DECL
sihirbaz	sihirbazlarınızı	N;ACC;PL;PSS2P
acıktırmak	yaptırıyor olmayacaktın	V;IND;PST;PROSP+PROG;2;SG;NEG;DECL
gazete	gazetelerin	N;GEN;PL
algoritma	algoritmalar	N;NOM;PL
değişiklik	değişikliği	N;ACC;SG
geliştirmek	geliştiriyor olmaz mıydım	V;IND;PST;HAB+PROG;1;SG;NEG;INTR
konmak	konmayacak mıyım	V;IND;FUT;1;SG;NEG;INTR
yapışmak	yapışmaz mıydı	V;IND;PST;HAB;3;SG;NEG;INTR
kuyumcu	kuyumcunuza	N;DAT;SG;PSS2P
sökmek	söküyor olmalı mıymışım	V;OBLIG;INFR;PRS;PROG;1;SG;INTR;POS
otostopçu	otostopçunun	N;GEN;SG;PSS2S
doktor	doktorlarda	N;LOC;PL
yabancı anahtar	yabancı anahtarını	N;ACC;SG;PSS3S
çukur	çukuru	N;ACC;SG
porsuk	porsuğun	N;GEN;SG
sıkıntı	sıkıntıların	N;GEN;PL
tıraş olmak	tıraş oluyor olmalı mıymışsın	V;OBLIG;INFR;PRS;PROG;2;SG;INTR;POS
sönmek	sönmezler mi	V;IND;PRS;HAB;3;PL;NEG;INTR
dokumak	dokuacak olmayacak mıymışım	V;INFR;FUT;PROSP;1;SG;NEG;INTR
akrep	akreplerden	N;ABL;PL
Yahudi	Yahudilermiş	N;ARGNO3S;PL;LGSPEC2
çözelti	çözeltilerinde	N;LOC;PL;PSS3S
bakma	bakmamızda	N;LOC;SG;PSS1P
örmek	örüyor olurlar mıydı	V;IND;PST;HAB+PROG;3;PL;INTR;POS
altdil	altdilin	N;GEN;SG
geciktirtmek	geciktirtmedik	V;IND;PST;1;PL;NEG;DECL
üzmek	üzmeliler	V;OBLIG;PRS;3;PL;POS;DECL
jelatin	jelatininizde	N;LOC;SG;PSS2P
titremek	titremeliymişim	V;OBLIG;INFR;PST;1;SG;POS;DECL
havuç	havucunuzdan	N;ABL;SG;PSS2P
kızmak	kızıyor olmalıyım	V;OBLIG;PRS;PROG;1;SG;POS;DECL
tıkmak	tıkarlar mıymış	V;INFR;PRS;HAB;3;PL;INTR;POS
peder	pederim	N;ARGNO1S;SG;PRS
atışmak	atışmeli miyiz	V;OBLIG;PRS;1;PL;INTR;POS
sürülmek	sürülüyor olacakmışız	V;INFR;FUT;PROG;1;PL;POS;DECL
istemek	istiyor olmalıymış	V;OBLIG;INFR;PRS;PROG;3;SG;POS;DECL
ispatlamak	ispatlamamelisin	V;OBLIG;PRS;2;SG;NEG;DECL
acıtmak	acıtacak olacak mıymışsınız	V;INFR;FUT;PROSP;2;PL;INTR;POS
gizlemek	gizleecek olmayacakmışsın	V;INFR;FUT;PROSP;2;SG;NEG;DECL
gelişmek	gelişmediydiniz	V;IND;PST;PFV;2;PL;NEG;DECL
solumak	solumamalıydın	V;OBLIG;PST;2;SG;NEG;DECL
ölmek	ölecek olacakmışsınız	V;INFR;FUT;PROSP;2;PL;POS;DECL
yaptırmak	yaptırıyor olmamalı mıyım	V;OBLIG;PRS;PROG;1;SG;NEG;INTR
öldürtülmemek	öldürtülür olmayacakmış	V;INFR;FUT;HAB;3;SG;NEG;DECL
canlandırtmak	canlandırtırsın	V;IND;PRS;HAB;2;SG;POS;DECL
depo	deponuz	N;NOM;SG;PSS2P
koklamak	kokluyor olmayacaksın	V;IND;FUT;PROG;2;SG;NEG;DECL
ölmek	ölmeli miyim	V;OBLIG;PRS;1;SG;INTR;POS
büktürtmemek	büktürtüyecek olmayacaklar mı	V;IND;FUT;PROSP;3;PL;NEG;INTR
eşofman	eşofmanını	N;ACC;SG;PSS3S
sınıf	sınıfın	N;GEN;SG
döndürmek	döndürmemiş miydik	V;INFR;PST;PFV;1;PL;NEG;INTR
kese	keselerine	N;DAT;PL;PSS3S
ayılmak	ayılmameli misin	V;OBLIG;PRS;2;SG;NEG;INTR
yetişmek	yetişmemişler miydi	V;INFR;PST;PFV;3;PL;NEG;INTR
dinmek	dinmiş olacaklar mıydı	V;INFR;PST;PROSP;3;PL;INTR;POS
tercih	tercihimizden	N;ABL;SG;PSS1P
sermek	sermez mi	V;IND;PRS;HAB;3;SG;NEG;INTR
kaynaştırtılmak	kaynaştırtılıyor olmayacaklardı	V;IND;PST;PROSP+PROG;3;PL;NEG;DECL
geciktirmek	geciktirmemiştiniz	V;INFR;PST;PFV;2;PL;NEG;DECL
paylaşmak	paylaşmamalıymış	V;OBLIG;INFR;PST;3;SG;NEG;DECL
çavuş	çavuşlardın	N;ARGNO2S;PL;PST
canlandırmamak	canlandırıyorlar	V;IND;PRS;PROG;3;PL;POS;DECL
polinom	polinomunuzda	N;LOC;SG;PSS2P
kanamak	kanamadıydınız	V;IND;PST;PFV;2;PL;NEG;DECL
eklemeli	eklemeli değiliz	ADJ;LGSPEC1;PRS;1;PL;NEG;DECL
delmek	delmemiş miymişim	V;INFR;LGSPEC1;PST;1;SG;NEG;INTR
çıldırtmak	çıldırtıyor olmaz mıydım	V;IND;PST;HAB+PROG;1;SG;NEG;INTR
gelinmek	gelinecek	V;IND;FUT;3;SG;POS;DECL
figüran	figüranlardık	N;ARGNO1P;PL;PST
aşık attırmak	aşık attırıyor olmayacaklardı	V;IND;PST;PROSP+PROG;3;PL;NEG;DECL
pembe dizi	pembe dizilerinizde	N;LOC;PL;PSS2P
kıymak	kıymameli miyiz	V;OBLIG;PRS;1;PL;NEG;INTR
kaçırmak	kaçırmayacağız	V;IND;FUT;1;PL;NEG;DECL
dürmek	dürmüş olmayacak	V;INFR;FUT;PFV;3;SG;NEG;DECL
eskimek	eskiyor olacak mıymışsın	V;INFR;FUT;PROG;2;SG;INTR;POS
pişmek	pişiyor olmayacaktınız	V;IND;PST;PROSP+PROG;2;PL;NEG;DECL
küsmek	küsüyor olmayacak mıydım	V;IND;PST;PROSP+PROG;1;SG;NEG;INTR
büktürülmek	büktürüldüydü	V;IND;PST;PFV;3;SG;POS;DECL
iyileşmek	iyileşir olacakmışız	V;INFR;FUT;HAB;1;PL;POS;DECL
köpük	köpüklerini	N;ACC;PL;PSS3S
arınmak	arınıyor olurlar mıydı	V;IND;PST;HAB+PROG;3;PL;INTR;POS
boşalmak	boşalacak olacakmışsınız	V;INFR;FUT;PROSP;2;PL;POS;DECL
derviş	dervişlerinizde	N;LOC;PL;PSS2P
ayrılmak	ayrılmalıydın	V;OBLIG;PST;2;SG;POS;DECL
fitil	fitilini	N;ACC;SG;PSS2S
çıt	çıtlarını	N;ACC;PL;PSS2S
iç ağ	iç ağımız	N;NOM;SG;PSS1P
yardım	yardımımızı	N;ACC;SG;PSS1P
yaptırmak	yaptırmış olmayacak mıydık	V;INFR;PST;PROSP;1;PL;NEG;INTR
solunum	solunumlarında	N;LOC;PL;PSS2S
çökmek	çökmemeliydim	V;OBLIG;PST;1;SG;NEG;DECL
asıl	asıllarda	N;LOC;PL
girmek	giriyor olmayacak mıymışız	V;INFR;FUT;PROG;1;PL;NEG;INTR
nefes aldırmak	nefes aldırmazlar mıydı	V;IND;PST;HAB;3;PL;NEG;INTR
ayılmak	ayılmış olmayacaktınız	V;INFR;PST;PROSP;2;PL;NEG;DECL
sınamak	sınarlar mıydı	V;IND;PST;HAB;3;PL;INTR;POS
üstesinden gelmek	üstesinden gelmiş miydim	V;INFR;PST;PFV;1;SG;INTR;POS
izlek	izleğiniz	N;NOM;SG;PSS2P
sıkmak	sıkmış olacak mı	V;INFR;FUT;PFV;3;SG;INTR;POS
üzülmek	üzülmeyecekler miydi	V;IND;PST;PROSP;3;PL;NEG;INTR
üşenmek	üşeniyor olmayacaktınız	V;IND;PST;PROSP+PROG;2;PL;NEG;DECL
huzur	huzurunu	N;ACC;SG;PSS3S
gülünçleşmek	gülünçleşiyoruz	V;IND;PRS;PROG;1;PL;POS;DECL
asker	askerinin	N;GEN;SG;PSS2S
taşımak	taşımışmışsınız	V;INFR;LGSPEC1;PST;2;PL;POS;DECL
döndürmek	döndürmez misin	V;IND;PRS;HAB;2;SG;NEG;INTR
yapmak	yapmaz mıymışım	V;INFR;PRS;HAB;1;SG;NEG;INTR
ovmak	ovmamış mıymış	V;INFR;LGSPEC1;PST;3;SG;NEG;INTR
eğmek	eğmemeliler miydi	V;OBLIG;PST;3;PL;NEG;INTR
canlandırtmak	canlandırtmıyor muydu	V;IND;PST;PROG;3;SG;NEG;INTR
benzemek	benzer olmayacakmışım	V;INFR;FUT;HAB;1;SG;NEG;DECL
seks yapmak	seks yapmayacak mıydım	V;IND;PST;PROSP;1;SG;NEG;INTR
kulağını bükmek	büküyor olacak mıymış	V;INFR;FUT;PROG;3;SG;INTR;POS
asmak	asar mıymış	V;INFR;PRS;HAB;3;SG;INTR;POS
şaşılmak	şaşılmışmışsınız	V;INFR;LGSPEC1;PST;2;PL;POS;DECL
kokmak	kokacak olacak mıyım	V;IND;FUT;PROSP;1;SG;INTR;POS
rahatsızlanmak	rahatsızlanmaz mıymışsınız	V;INFR;PRS;HAB;2;PL;NEG;INTR
sıvılaşmak	sıvılaşacak mıydık	V;IND;PST;PROSP;1;PL;INTR;POS
kullanılmak	kullanılmış olmayacak mısın	V;INFR;FUT;PFV;2;SG;NEG;INTR
kakmak	kaktılar mı	V;IND;PST;3;PL;INTR;POS
iletmek	iletmiş olacak mısın	V;INFR;FUT;PFV;2;SG;INTR;POS
karıştırmak	karıştırıyor olmalı mıydık	V;OBLIG;PST;PROG;1;PL;INTR;POS
yummak	yummayacaktınız	V;IND;PST;PROSP;2;PL;NEG;DECL
ağlaşmak	ağlaşır olmayacakmışım	V;INFR;FUT;HAB;1;SG;NEG;DECL
şuur	şuurumuzda	N;LOC;SG;PSS1P
başarmak	başarmış olacak mıydım	V;INFR;PST;PROSP;1;SG;INTR;POS
gözden kaybolmak	gözden kayboluyor olacaktın	V;IND;PST;PROSP+PROG;2;SG;POS;DECL
yırtmak	yırtacak olacak mıymış	V;INFR;FUT;PROSP;3;SG;INTR;POS
koşulmak	koşulmuş olacaksın	V;INFR;FUT;PFV;2;SG;POS;DECL
damat	damadımızın	N;GEN;SG;PSS1P
vilayet	vilayetinde	N;LOC;SG;PSS2S
kararmak	kararmazlar mıymış	V;INFR;PRS;HAB;3;PL;NEG;INTR
yapışmak	yapışmamalı mıymışsınız	V;OBLIG;INFR;PST;2;PL;NEG;INTR
kırılmak	kırılmazmışım	V;INFR;PRS;HAB;1;SG;NEG;DECL
taslak	taslağımızda	N;LOC;SG;PSS1P
yapışmak	yapışmış olmayacağım	V;INFR;FUT;PFV;1;SG;NEG;DECL
ebe	ebelersiniz	N;ARGNO2P;PL;PRS
kırıtmak	kırıtıyor olacak mıymışım	V;INFR;FUT;PROG;1;SG;INTR;POS
kader	kaderinizde	N;LOC;SG;PSS2P
işlemek	işler	V;IND;PRS;HAB;3;SG;POS;DECL
yoldurtmak	yoldurttular	V;IND;PST;3;PL;POS;DECL
bildirmek	bildirmiş miyiz	V;INFR;PST;1;PL;INTR;POS
sıvılaşmak	sıvılaşmış olacak mısınız	V;INFR;FUT;PFV;2;PL;INTR;POS
anmak	anıyor olmamalıyız	V;OBLIG;PRS;PROG;1;PL;NEG;DECL
ayarlanmak	ayarlanırdım	V;IND;PST;HAB;1;SG;POS;DECL
uyanmak	uyanmaz mıydı	V;IND;PST;HAB;3;SG;NEG;INTR
ölmek	ölmezsin	V;IND;PRS;HAB;2;SG;NEG;DECL
sızmak	sızacak olmayacak mıymışsınız	V;INFR;FUT;PROSP;2;PL;NEG;INTR
yarışma	yarışmaları	N;ACC;PL
numaralama	numaralamalarından	N;ABL;PL;PSS2S
sunak	sunaklarında	N;LOC;PL;PSS2S
patlamak	patlar mıymışız	V;INFR;PRS;HAB;1;PL;INTR;POS
içermek	içermişler miymiş	V;INFR;LGSPEC1;PST;3;PL;INTR;POS
bölmek	böler olmayacak mıymışsın	V;INFR;FUT;HAB;2;SG;NEG;INTR
vazo	vazolardım	N;ARGNO1S;PL;PST
cezalandırmak	cezalandırıyor olmalılar mıydı	V;OBLIG;PST;PROG;3;PL;INTR;POS
yormak	yoruyor olacakmış	V;INFR;FUT;PROG;3;SG;POS;DECL
seçilmek	seçiliyor olur muydu	V;IND;PST;HAB+PROG;3;SG;INTR;POS
yetiştirmek	yetiştirmelisin	V;OBLIG;PRS;2;SG;POS;DECL
fal	falımızı	N;ACC;SG;PSS1P
sezmek	sezmeliymişim	V;OBLIG;INFR;PST;1;SG;POS;DECL
sürünmek	sürünüyor olacaklardı	V;IND;PST;PROSP+PROG;3;PL;POS;DECL
Zagrepli	Zagreplilerinizde	N;LOC;PL;PSS2P
ot	otlarımıza	N;DAT;PL;PSS1P
çıkmak	çıkıyor olmamalıyım	V;OBLIG;PRS;PROG;1;SG;NEG;DECL
ezmek	ezmezmişsiniz	V;INFR;PRS;HAB;2;PL;NEG;DECL
uyanmak	uyanmışmışım	V;INFR;LGSPEC1;PST;1;SG;POS;DECL
birleştirmek	birleştirdiydim	V;IND;PST;PFV;1;SG;POS;DECL
referans	referanslardan	N;ABL;PL
doymak	doydunuz	V;IND;PST;2;PL;POS;DECL
kırmak	kırıyor muymuşuz	V;INFR;PRS;PROG;1;PL;INTR;POS
süs	süslere	N;DAT;PL
küçülmek	küçülecek miyiz	V;IND;FUT;1;PL;INTR;POS
tıraş olmak	tıraş olmaz mısınız	V;IND;PRS;HAB;2;PL;NEG;INTR
izlemek	izler olmayacak mıymışsın	V;INFR;FUT;HAB;2;SG;NEG;INTR
onarmak	onardın	V;IND;PST;2;SG;POS;DECL
cezalandırmak	cezalandırmamışmış	V;INFR;LGSPEC1;PST;3;SG;NEG;DECL
geğirmek	geğirmeliydik	V;OBLIG;PST;1;PL;POS;DECL
kapatmak	kapatacak olacaklarmış	V;INFR;FUT;PROSP;3;PL;POS;DECL
gemi	gemilerinde	N;LOC;PL;PSS2S
acımak	acıyor olmamalıydım	V;OBLIG;PST;PROG;1;SG;NEG;DECL
bulmak	bulmuş muydun	V;INFR;PST;PFV;2;SG;INTR;POS
bütünleşmek	bütünleştiydim	V;IND;PST;PFV;1;SG;POS;DECL
davranmak	davranmış mı	V;INFR;PST;3;SG;INTR;POS
yoldurtmak	yoldurtmayacakmışım	V;INFR;FUT;1;SG;NEG;DECL
kırmak	kıracak olmayacakmış	V;INFR;FUT;PROSP;3;SG;NEG;DECL
bir avuç toprak olmak	bir avuç toprak olmadı	V;IND;PST;3;SG;NEG;DECL
interfaz	interfazınız	N;NOM;SG;PSS2P
ılımak	ılımadı mıydınız	V;IND;PST;PFV;2;PL;NEG;INTR
huri	hurisinden	N;ABL;SG;PSS3S
yenici deyim	yenici deyimin	N;NOM;SG;PSS2S
kırdırmak	kırdırdılar	V;IND;PST;3;PL;POS;DECL
sürülmek	sürülüyor olurlardı	V;IND;PST;HAB+PROG;3;PL;POS;DECL
birleştirtmek	birleştirtmişmişim	V;INFR;LGSPEC1;PST;1;SG;POS;DECL
taşmak	taşıyor olmamalıydım	V;OBLIG;PST;PROG;1;SG;NEG;DECL
ikaz	ikazlarına	N;DAT;PL;PSS3S
okumak	okuacak olacakmışım	V;INFR;FUT;PROSP;1;SG;POS;DECL
inanmak	inanıyormuşuz	V;INFR;PRS;PROG;1;PL;POS;DECL
içermek	içeriyor olmalıymışsın	V;OBLIG;INFR;PRS;PROG;2;SG;POS;DECL
kapmak	kapacakmışsın	V;INFR;FUT;2;SG;POS;DECL
seks yapmak	seks yapıyor olmalılar	V;OBLIG;PRS;PROG;3;PL;POS;DECL
diremek	diremezler miydi	V;IND;PST;HAB;3;PL;NEG;INTR
acıktırmak	acıktırmaz mıymışsınız	V;INFR;PRS;HAB;2;PL;NEG;INTR
nalları dikmek	nalları dikmiş miymişsiniz	V;INFR;LGSPEC1;PST;2;PL;INTR;POS
dökmek	dökmezler	V;IND;PRS;HAB;3;PL;NEG;DECL
uyanmak	uyanmadım mı	V;IND;PST;1;SG;NEG;INTR
doğurmak	doğuruyor olacağız	V;IND;FUT;PROG;1;PL;POS;DECL
yermek	yeriyor muymuşsunuz	V;INFR;PRS;PROG;2;PL;INTR;POS
bıkmak	bıkmeliler mi	V;OBLIG;PRS;3;PL;INTR;POS
Zagrepli	Zagrepliymişler	N;ARGNO3P;SG;LGSPEC2
devinmek	deviniyorlar mıymış	V;INFR;PRS;PROG;3;PL;INTR;POS
yetiştirmek	yetiştirmiş olmayacak mı	V;INFR;FUT;PFV;3;SG;NEG;INTR
çökertmek	çökertmeliymişim	V;OBLIG;INFR;PST;1;SG;POS;DECL
bitmek	bitiyor olmayacaktım	V;IND;PST;PROSP+PROG;1;SG;NEG;DECL
kaynamak	kaynamaz mısınız	V;IND;PRS;HAB;2;PL;NEG;INTR
yalvarmak	yalvarmayacak mıydın	V;IND;PST;PROSP;2;SG;NEG;INTR
peri	periydin	N;ARGNO2S;SG;PST
sidik	sidikler	N;NOM;PL
levrek	levreğini	N;ACC;SG;PSS3S
kertenkele	kertenkelelerin	N;GEN;PL
kurum	kurumunun	N;GEN;SG;PSS2S
sürülmek	sürülmeli miydik	V;OBLIG;PST;1;PL;INTR;POS
küsmek	küstü müydü	V;IND;PST;PFV;3;SG;INTR;POS
mikroorganizma	mikroorganizmalarında	N;LOC;PL;PSS2S
geçmek	geçmeliydin	V;OBLIG;PST;2;SG;POS;DECL
şaşırtmak	şaşırtır olmayacak mıymışsınız	V;INFR;FUT;HAB;2;PL;NEG;INTR
gülünçleşmek	gülünçleşiyor musunuz	V;IND;PRS;PROG;2;PL;INTR;POS
göndermek	göndermemeliymişsiniz	V;OBLIG;INFR;PST;2;PL;NEG;DECL
yağlamak	yağlıyorum	V;IND;PRS;PROG;1;SG;POS;DECL
koleksiyon	koleksiyonların	N;GEN;PL
güzelleştirmek	güzelleştirmeyecekmişsiniz	V;INFR;FUT;2;PL;NEG;DECL
acıktırmak	yaptırıyor olmalı mıymışsınız	V;OBLIG;INFR;PRS;PROG;2;PL;INTR;POS
daldırtmak	daldırtacak olmayacakmışız	V;INFR;FUT;PROSP;1;PL;NEG;DECL
tükürmek	tükürmediler	V;IND;PST;3;PL;NEG;DECL
ropdöşambır	ropdöşambırlarının	N;GEN;PL;PSS2S
gözlemek	gözlemez miydiniz	V;IND;PST;HAB;2;PL;NEG;INTR
sugeçirmez yapmak	sugeçirmez yapıyor olacak mısınız	V;IND;FUT;PROG;2;PL;INTR;POS
bitirmek	bitirir olacak mıymışsınız	V;INFR;FUT;HAB;2;PL;INTR;POS
geçmek	geçer olacak mıymış	V;INFR;FUT;HAB;3;SG;INTR;POS
öğütmek	öğütmüştünüz	V;INFR;PST;PFV;2;PL;POS;DECL
ağlaşmak	ağlaşacak olmayacak mıymışız	V;INFR;FUT;PROSP;1;PL;NEG;INTR
tükenmek	tükenecek olacak mıyım	V;IND;FUT;PROSP;1;SG;INTR;POS
lügatçe	lügatçesinin	N;GEN;SG;PSS3S
götürmek	götürüyor olmamalı mı	V;OBLIG;PRS;PROG;3;SG;NEG;INTR
beceriksiz	beceriksiz değil miyim?	ADJ;LGSPEC1;PRS;1;SG;NEG;INTR
şaşmak	şaşmalı mıymışız	V;OBLIG;INFR;PST;1;PL;INTR;POS
şapka	şapkalar	N;NOM;PL
üremek	ürerler mi	V;IND;PRS;HAB;3;PL;INTR;POS
evren	evrenlerinizi	N;ACC;PL;PSS2P
diş	dişimizde	N;LOC;SG;PSS1P
demlemek	demliyor olacak mıymış	V;INFR;FUT;PROG;3;SG;INTR;POS
bulamak	bulamış	V;INFR;PST;3;SG;POS;DECL
doktrin	doktrinlerimizi	N;ACC;PL;PSS1P
onarmak	onarıyor olacak mıydı	V;IND;PST;PROSP+PROG;3;SG;INTR;POS
daldırtmak	daldırtmış olmayacak mıydın	V;INFR;PST;PROSP;2;SG;NEG;INTR
bakmak	bakmışmışız	V;INFR;LGSPEC1;PST;1;PL;POS;DECL
kanmak	kanmış olmayacaktık	V;INFR;PST;PROSP;1;PL;NEG;DECL
götten bacaklı	götten bacaklılarda	N;LOC;PL
bıkmak	bıkar mıydık	V;IND;PST;HAB;1;PL;INTR;POS
roket	roket	N;NOM;SG
kısalık	kısalığından	N;ABL;SG;PSS2S
ıslık çalmak	ıslık çaldın	V;IND;PST;2;SG;POS;DECL
üstesinden gelmek	üstesinden gelmeli miydim	V;OBLIG;PST;1;SG;INTR;POS
doğramak	doğrayacak mıydın	V;IND;PST;PROSP;2;SG;INTR;POS
sözcü	sözcüler	N;ARGNO3S;PL;PRS
motel	motellerinde	N;LOC;PL;PSS3S
bürümek	bürümüşmüş	V;INFR;LGSPEC1;PST;3;SG;POS;DECL
saydırmak	saydırıyor olmayacaklar	V;IND;FUT;PROG;3;PL;NEG;DECL
sümürmek	sümürecek olacaklar mı	V;IND;FUT;PROSP;3;PL;INTR;POS
ettirtmek	ettirtiyor olacak mıydık	V;IND;PST;PROSP+PROG;1;PL;INTR;POS
girmek	girmemeli miyim	V;OBLIG;PRS;1;SG;NEG;INTR
örümcek ağı	örümcek ağı	N;NOM;SG
dizmek	diziyor olmalıymışız	V;OBLIG;INFR;PRS;PROG;1;PL;POS;DECL
öpmek	öpüyor olmayacaktı	V;IND;PST;PROSP+PROG;3;SG;NEG;DECL
kazanmak	kazanıyor muymuşsunuz	V;INFR;PRS;PROG;2;PL;INTR;POS
köpürmek	köpürüyormuşsun	V;INFR;PRS;PROG;2;SG;POS;DECL
bütünleşmek	bütünleşmiş olmayacaklar mı	V;INFR;FUT;PFV;3;PL;NEG;INTR
köpürmek	köpürüyor olmalılarmış	V;OBLIG;INFR;PRS;PROG;3;PL;POS;DECL
satın almak	satın almıştı	V;INFR;PST;PFV;3;SG;POS;DECL
dinmek	diniyor olmayacak mıymışız	V;INFR;FUT;PROG;1;PL;NEG;INTR
vekil sunucu	vekil sunuculardır	N;ARGNO3P;PL;PRS
izleyici	izleyicimize	N;DAT;SG;PSS1P
abadi	abadinizi	N;ACC;SG;PSS2P
dalmak	dalıyor olmalıydı	V;OBLIG;PST;PROG;3;SG;POS;DECL
sıkmak	sıkıyor olacak mıydın	V;IND;PST;PROSP+PROG;2;SG;INTR;POS
ovmak	ovacak olacakmışsınız	V;INFR;FUT;PROSP;2;PL;POS;DECL
kazanmak	kazanıyor olmayacak mıydı	V;IND;PST;PROSP+PROG;3;SG;NEG;INTR
iğrenmek	iğrenmiş olmayacaklar	V;INFR;FUT;PFV;3;PL;NEG;DECL
aldatmak	aldatmış olacaktık	V;INFR;PST;PROSP;1;PL;POS;DECL
dövmek	dövmemeliydim	V;OBLIG;PST;1;SG;NEG;DECL
fortlamak	fortlamıştı	V;INFR;PST;PFV;3;SG;POS;DECL
ilklendirmek	ilklendir	V;IMP;2;SG;POS;DECL
yaramak	yaramalıydınız	V;OBLIG;PST;2;PL;POS;DECL
yıkmak	yıkmıştım	V;INFR;PST;PFV;1;SG;POS;DECL
aşmak	aşmadılar mıydı	V;IND;PST;PFV;3;PL;NEG;INTR
çıkmak	çıkıyor olmalı mıymış	V;OBLIG;INFR;PRS;PROG;3;SG;INTR;POS
mucize	mucizeleri	N;NOM;PL;PSS3S
ayarlanmak	ayarlanıyor olacak mıydı	V;IND;PST;PROSP+PROG;3;SG;INTR;POS
hava atmak	hava atmamalı mıymış	V;OBLIG;INFR;PST;3;SG;NEG;INTR
tek sayı	tek sayılarımızdan	N;ABL;PL;PSS1P
ezmek	ezmiş miydiniz	V;INFR;PST;PFV;2;PL;INTR;POS
bağlamak	bağlamış olmayacaktım	V;INFR;PST;PROSP;1;SG;NEG;DECL
ayrılmak	ayrılmamelisin	V;OBLIG;PRS;2;SG;NEG;DECL
bip	biplerini	N;ACC;PL;PSS3S
kışkırtmak	kışkırtıyor mu	V;IND;PRS;PROG;3;SG;INTR;POS
papaz olmak	papaz oluyor olacak mıyız	V;IND;FUT;PROG;1;PL;INTR;POS
ernek	ernektik	N;ARGNO1P;SG;PST
fevt olmak	fevt olmadıydık	V;IND;PST;PFV;1;PL;NEG;DECL
pişirmek	pişirecek olacak mısın	V;IND;FUT;PROSP;2;SG;INTR;POS
uyarmak	uyarmaz mıydı	V;IND;PST;HAB;3;SG;NEG;INTR
erik	eriğin	N;GEN;SG
heyecanlandırmak	heyecanlandırmadıydınız	V;IND;PST;PFV;2;PL;NEG;DECL
itmek	itmiyor muydum	V;IND;PST;PROG;1;SG;NEG;INTR
yoğurmak	yoğuruyor olmalısın	V;OBLIG;PRS;PROG;2;SG;POS;DECL
cümle	cümlelerinde	N;LOC;PL;PSS2S
yolunmak	yolunmayacaklardı	V;IND;PST;PROSP;3;PL;NEG;DECL
vekil	vekillermişsiniz	N;ARGNO2P;PL;LGSPEC2
mükemmel	mükemmelim	ADJ;LGSPEC1;PRS;1;SG;POS;DECL
heyecanlandırmak	heyecanlandıracak olacak	V;IND;FUT;PROSP;3;SG;POS;DECL
zam	zammının	N;GEN;SG;PSS3S
utandırmak	utandırmalıydık	V;OBLIG;PST;1;PL;POS;DECL
esrarengiz	esrarengizdin	ADJ;LGSPEC1;PST;2;SG;POS;DECL
doymak	doymamalı mıydın	V;OBLIG;PST;2;SG;NEG;INTR
fotoğraf çekmek	fotoğraf çekecek olmayacak mıymışım	V;INFR;FUT;PROSP;1;SG;NEG;INTR
sığmak	sığmamış mıymışsınız	V;INFR;LGSPEC1;PST;2;PL;NEG;INTR
parlatmak	parlattı mıydın	V;IND;PST;PFV;2;SG;INTR;POS
ummak	ummamalı mıydınız	V;OBLIG;PST;2;PL;NEG;INTR
sunulmak	sunuluyor olur muyduk	V;IND;PST;HAB+PROG;1;PL;INTR;POS
verdirmek	verdiriyor olmalılar mıymış	V;OBLIG;INFR;PRS;PROG;3;PL;INTR;POS
ekşitmek	ekşitecek	V;IND;FUT;3;SG;POS;DECL
puan	puanından	N;ABL;SG;PSS2S
atmamak	atmazmışız	V;INFR;PRS;HAB;1;PL;POS;DECL
koyulaşmak	koyulaşmayacaklarmış	V;INFR;FUT;3;PL;NEG;DECL
kovdurtmak	kovdurtuyor olacaktık	V;IND;PST;PROSP+PROG;1;PL;POS;DECL
daldırtmak	daldırtmışmışsın	V;INFR;LGSPEC1;PST;2;SG;POS;DECL
oynatıcı	oynatıcılara	N;DAT;PL
viski	viskilerde	N;LOC;PL
hasta	hastalarınız	N;NOM;PL;PSS2P
dövüşmek	dövüşmeyecektik	V;IND;PST;PROSP;1;PL;NEG;DECL
kamera	kamerayı	N;ACC;SG
kâğıt	kâğıda	N;DAT;SG
ittirmek	ittiriyor olmamalıymışsınız	V;OBLIG;INFR;PRS;PROG;2;PL;NEG;DECL
gücenmek	gücenmiştin	V;INFR;PST;PFV;2;SG;POS;DECL
sahipli yazılım	sahipli yazılımın	N;NOM;SG;PSS2S
okumak	okuyacaklar mı	V;IND;FUT;3;PL;INTR;POS
evcil sinek	evcil sineğimizi	N;ACC;SG;PSS1P
otostop çekmek	otostop çekmiş olmayacak mısın	V;INFR;FUT;PFV;2;SG;NEG;INTR
dermek	derecek olmayacağım	V;IND;FUT;PROSP;1;SG;NEG;DECL
süzmek	süzmeyecekler miymiş	V;INFR;FUT;3;PL;NEG;INTR
salmak	salacak olacak mıymış	V;INFR;FUT;PROSP;3;SG;INTR;POS
germek	germediydin	V;IND;PST;PFV;2;SG;NEG;DECL
görmek	görecek olacaksınız	V;IND;FUT;PROSP;2;PL;POS;DECL
dökmek	dökmeyecek miydik	V;IND;PST;PROSP;1;PL;NEG;INTR
küsmek	küsmediler	V;IND;PST;3;PL;NEG;DECL
kitap kurdu	kitap kurdunu	N;ACC;SG
yapışmak	yapıştıydı	V;IND;PST;PFV;3;SG;POS;DECL
acıkmak	acıkacakmışız	V;INFR;FUT;1;PL;POS;DECL
parçalanmak	parçalanmamalı mıydı	V;OBLIG;PST;3;SG;NEG;INTR
dövmek	dövüyor muyum	V;IND;PRS;PROG;1;SG;INTR;POS
eklemesiz	eklemesizmişler	ADJ;LGSPEC1;LGSPEC2;3;PL;POS;DECL
iletmek	iletiyor olurduk	V;IND;PST;HAB+PROG;1;PL;POS;DECL
ağda yapmak	ağd yapıyor olmamalı mıymışsın	V;OBLIG;INFR;PRS;PROG;2;SG;NEG;INTR
abartmak	abartıyor olur muydun	V;IND;PST;HAB+PROG;2;SG;INTR;POS
ıslık çalmak	ıslık çalmış olmayacak mıydınız	V;INFR;PST;PROSP;2;PL;NEG;INTR
şaşırmak	şaşırmelisiniz	V;OBLIG;PRS;2;PL;POS;DECL
tosbağa	tosbağaların	N;GEN;PL
damat	damatlarına	N;DAT;PL;PSS2S
gri kedi	gri kedilerinden	N;ABL;PL;PSS2S
çökertmek	çökertmemişmişim	V;INFR;LGSPEC1;PST;1;SG;NEG;DECL
mezarlık	mezarlıklarının	N;GEN;PL;PSS3S
verilmek	verilmedim mi	V;IND;PST;1;SG;NEG;INTR
bahçıvan	bahçıvanını	N;ACC;SG;PSS3S
kusmak	kusmadı mıydın	V;IND;PST;PFV;2;SG;NEG;INTR
uzanmak	uzanıyor olmamalıymışız	V;OBLIG;INFR;PRS;PROG;1;PL;NEG;DECL
cavlağı çekmek	cavlağı çekmezlerdi	V;IND;PST;HAB;3;PL;NEG;DECL
İngilizceleştirmek	İngilizceleştirmiş misin	V;INFR;PST;2;SG;INTR;POS
ekşimek	ekşiyor olacak mısın	V;IND;FUT;PROG;2;SG;INTR;POS
taç	taçlarımız	N;NOM;PL;PSS1P
acıktırmak	yaptırır mıymışım	V;INFR;PRS;HAB;1;SG;INTR;POS
süzmek	süzmüş olacak mıydınız	V;INFR;PST;PROSP;2;PL;INTR;POS
yakışıklı	yakışıklı değil miydim?	ADJ;LGSPEC1;PST;1;SG;NEG;INTR
yetmek	yetiyor olmayacakmışsın	V;INFR;FUT;PROG;2;SG;NEG;DECL
dağılmak	dağılır olmayacak mıymışsınız	V;INFR;FUT;HAB;2;PL;NEG;INTR
ulus	uluslarınızda	N;LOC;PL;PSS2P
torun	torunlarmış	N;ARGNO3P;PL;LGSPEC2
